Tm,PF,TotalYds,Ply,Y/Play,TO,FL,1stD,Cmp,PassAtt,PassYds,PassTD,Int,NY/A,1stDpass,RushAtt,RushYds,RushTD,Y/Arun,1stDrun,Pen,PenYds,1stPy,Sc%,TO%,ExpectedPoints,Cmp%,PassTD%,Int%,Y/Apass,AY/A,Y/C,QbRating,Sk,SkYds,ANY/A,Sk%,ExpectedPointsPassing,PuntRet,PrYds,PrTD,Y/PR,KickRet,KrYds,KrTD,Y/KR,APYd,FGA019,FGM019,FGA2029,FGM2029,FGA3039,FGM3039,FGA4049,FGM4049,FGA50Plus,FGM50Plus,TFGA,TFGM,FG%,XPA,XPM,XP%,Pnt,PntYds,PntBlck,Y/Pnt,PF_Defense,TotalYds_Defense,Ply_Defense,Y/Play_Defense,TO_Defense,FL_Defense,1stD_Defense,Cmp_Defense,PassAtt_Defense,PassYds_Defense,PassTD_Defense,Int_Defense,NY/A_Defense,1stDpass_Defense,RushAtt_Defense,RushYds_Defense,RushTD_Defense,Y/Arun_Defense,1stDrun_Defense,Pen_Defense,PenYds_Defense,1stPy_Defense,Sc%_Defense,TO%_Defense,ExpectedPoints_Defense,Cmp%_Defense,PassTD%_Defense,Int%_Defense,Y/Apass_Defense,AY/A_Defense,Y/C_Defense,QbRating_Defense,Sk_Defense,SkYds_Defense,ANY/A_Defense,Sk%_Defense,ExpectedPointsPassing_Defense,PntRet_Defense,PrYds_Defense,PrTD_Defense,Y/PR_Defense,KickRet_Defense,KrYds_Defense,KrTD_Defense,Y/KR_Defense,TFGA_Defense,TFGM_Defense,FG%_Defense,XPA_Defense,XPM_Defense,XP%_Defense,Pnt_Defense,PntYds_Defense,PntBlck_Defense,Y/Pnt_Defense,Fmb,ExpectedPointsRunning,ExpectedPointsRunning_Defense,#Dr,Plays/Drive,Yds/Drive,AvgStartingPosition,AvgDriveTime,Pts/Drive,#Dr_Defense,Plays/Drive_Defense,Yds/Drive_Defense,AvgStartingPosition_Defense,AvgDriveTime_Defense,Pts/Drive_Defense,FmbTD,IntTD,OthTD,AllTD,2PM,2PA,Sfty,FmbTD_Defense,IntTD_Defense,OthTD_Defense,2PM_Defense,2PA_Defense,Sfty_Defense,RawPassYds,TO_Differential,PF_Differential,Yds_Differential,PassPercent,RunPercent,PassYdPercent,RunYdPercent,PassTdPercent,RunTdPercent,PassRun1dRatio,RunPass1dRatio,Penalty1dPercent,YppYprRatio,PassPercent_Defense,RunPercent_Defense,PassYdPercent_Defense,RunYdPercent_Defense,PassTdPercent_Defense,RunTdPercent_Defense,Penalty1dPercent_Defense,YppYprRatio_Defense,FumbleLostPercent,DefensivePtsScored,TimeOfPossession,TimeOfPossession_Defense,AvgFieldPositionDifferential,PF_High_Rank,TotalYds_High_Rank,Ply_High_Rank,Y/Play_High_Rank,1stD_High_Rank,Cmp_High_Rank,PassAtt_High_Rank,PassYds_High_Rank,PassTD_High_Rank,NY/A_High_Rank,1stDpass_High_Rank,RushAtt_High_Rank,RushYds_High_Rank,RushTD_High_Rank,Y/Arun_High_Rank,1stPy_High_Rank,Sc%_High_Rank,1stDrun_High_Rank,Cmp%_High_Rank,PassTD%_High_Rank,Y/Apass_High_Rank,AY/A_High_Rank,Y/C_High_Rank,QbRating_High_Rank,ANY/A_High_Rank,TO_Defense_High_Rank,FL_Defense_High_Rank,Int_Defense_High_Rank,Sk_Defense_High_Rank,SkYds_Defense_High_Rank,Sk%_Defense_High_Rank,Int%_Defense_High_Rank,PuntRet_High_Rank,PrYds_High_Rank,PrTD_High_Rank,Y/PR_High_Rank,KickRet_High_Rank,KrYds_High_Rank,KrTD_High_Rank,Y/KR_High_Rank,APYd_High_Rank,TFGA_High_Rank,TFGM_High_Rank,FG%_High_Rank,XPA_High_Rank,XPM_High_Rank,XP%_High_Rank,Pnt_High_Rank,PntYds_High_Rank,Y/Pnt_High_Rank,TO%_Defense_High_Rank,RawPassYds_High_Rank,TO_Differential_High_Rank,Yds_Differential_High_Rank,PF_Differential_High_Rank,DefensivePtsScored_High_Rank,TO_Low_Rank,FL_Low_Rank,Int_Low_Rank,Pen_Low_Rank,PenYds_Low_Rank,TO%_Low_Rank,Sk_Low_Rank,SkYds_Low_Rank,Sk%_Low_Rank,Int%_Low_Rank,PF_Defense_Low_Rank,TotalYds_Defense_Low_Rank,Ply_Defense_Low_Rank,Y/Play_Defense_Low_Rank,1stD_Defense_Low_Rank,Cmp_Defense_Low_Rank,PassAtt_Defense_Low_Rank,PassYds_Defense_Low_Rank,PassTD_Defense_Low_Rank,NY/A_Defense_Low_Rank,1stDpass_Defense_Low_Rank,RushAtt_Defense_Low_Rank,RushYds_Defense_Low_Rank,RushTD_Defense_Low_Rank,Y/Arun_Defense_Low_Rank,1stPy_Defense_Low_Rank,Sc%_Defense_Low_Rank,1stDrun_Defense_Low_Rank,Cmp%_Defense_Low_Rank,PassTD%_Defense_Low_Rank,Y/Apass_Defense_Low_Rank,AY/A_Defense_Low_Rank,Y/C_Defense_Low_Rank,QbRating_Defense_Low_Rank,ANY/A_Defense_Low_Rank,Pen_Defense_Low_Rank,PenYds_Defense_Low_Rank,PntRet_Defense_Low_Rank,PrYds_Defense_Low_Rank,PrTD_Defense_Low_Rank,Y/PR_Defense_Low_Rank,KickRet_Defense_Low_Rank,KrYds_Defense_Low_Rank,KrTD_Defense_Low_Rank,Y/KR_Defense_Low_Rank,TFGA_Defense_Low_Rank,TFGM_Defense_Low_Rank,FG%_Defense_Low_Rank,XPA_Defense_Low_Rank,XPM_Defense_Low_Rank,XP%_Defense_Low_Rank,Pnt_Defense_Low_Rank,PntYds_Defense_Low_Rank,PntBlck_Defense_Low_Rank,Y/Pnt_Defense_Low_Rank,PntBlck_Low_Rank,FumbleLostPercent_Low_Rank,PassPercent_High_Rank,RunPercent_High_Rank,PassYdPercent_High_Rank,RunYdPercent_High_Rank,PassTdPercent_High_Rank,RunTdPercent_High_Rank,Penalty1dPercent_High_Rank,YppYprRatio_High_Rank,PassPercent_Defense_High_Rank,RunPercent_Defense_High_Rank,PassYdPercent_Defense_High_Rank,RunYdPercent_Defense_High_Rank,PassTdPercent_Defense_High_Rank,RunTdPercent_Defense_High_Rank,Penalty1dPercent_Defense_High_Rank,YppYprRatio_Defense_High_Rank,PassRun1dRatio_High_Rank,RunPass1dRatio_High_Rank,ExpectedPoints_High_Rank,ExpectedPointsPassing_High_Rank,ExpectedPoints_Defense_High_Rank,ExpectedPointsPassing_Defense_High_Rank,ExpectedPointsRunning_High_Rank,ExpectedPointsRunning_Defense_High_Rank,#Dr_High_Rank,Plays/Drive_High_Rank,Yds/Drive_High_Rank,AvgStartingPosition_High_Rank,AvgDriveTime_High_Rank,Pts/Drive_High_Rank,TimeOfPossession_High_Rank,AvgFieldPositionDifferential_High_Rank,#Dr_Defense_Low_Rank,Plays/Drive_Defense_Low_Rank,Yds/Drive_Defense_Low_Rank,AvgStartingPosition_Defense_Low_Rank,Pts/Drive_Defense_Low_Rank,Oscore,Dscore,STscore,ThreePhaseScore,FantasyPassScore,FantasyRushScore,FantasyOffenseScore,FantasyDstScore,GameControlScore,GameControlPlusBalance,GameControlPlusBalance_Rank,Oscore_Rank,Dscore_Rank,STscore_Rank,ThreePhaseScore_Rank,FantasyPassScore_Rank,FantasyRushScore_Rank,FantasyOffenseScore_Rank,FantasyDstScore_Rank,GameControlScore_Rank
Green Bay Packers,560.0,6482.0,988.0,6.6,14.0,6.0,353.0,376.0,552.0,4924.0,51.0,8.0,8.3,230.0,395.0,1558.0,12.0,3.9,89.0,76.0,591.0,34.0,48.3,6.1,246.54,68.1,9.2,1.4,9.3,10.5,13.7,122.6,41.0,237.0,9.4,6.9,273.77,27.0,295.0,1.0,10.9,41.0,1005.0,1.0,24.5,8051.0,1.0,1.0,5.0,4.0,14.0,14.0,5.0,3.0,3.0,2.0,28.0,24.0,85.7,69.0,68.0,98.6,55.0,2506.0,0.0,45.6,359.0,6585.0,1049.0,6.3,38.0,7.0,358.0,390.0,637.0,4796.0,29.0,31.0,7.2,246.0,383.0,1789.0,10.0,4.7,96.0,122.0,948.0,16.0,33.9,20.2,-64.58,61.2,4.6,4.9,7.8,6.6,12.8,80.6,29.0,192.0,6.0,4.4,-64.64,24.0,305.0,1.0,12.7,59.0,1378.0,0.0,23.4,27.0,22.0,81.5,35.0,35.0,100.0,58.0,0.0,0.0,0.0,15.0,-17.44,-6.29,180.0,5.6,36.0,30.8,162.0,2.85,183.0,5.9,35.9,25.5,155.0,1.89,1.0,4.0,0.0,70.0,0.0,1.0,0.0,0.0,0.0,0.0,5.0,0.0,2.0,5161.0,24.0,201.0,-103.0,0.6002024291497976,0.3997975708502024,0.7596420857759949,0.240357914224005,0.8095238095238095,0.19047619047619047,2.5842696629213484,0.3869565217391304,0.09631728045325776,2.3846153846153846,0.6348903717826502,0.3651096282173498,0.7283219438116932,0.2716780561883068,0.7435897435897436,0.2564102564102564,0.0446927374301676,1.6595744680851063,0.4,30.0,29160.0,28365.0,5.300000000000002,1.0,3.0,28.0,2.0,5.0,4.5,14.0,3.0,1.0,1.0,5.0,26.0,27.0,17.0,27.0,3.0,2.0,21.5,2.0,1.0,1.0,1.0,1.5,1.0,1.0,1.5,26.5,1.0,28.5,26.5,32.0,1.0,30.5,21.0,9.5,12.0,19.0,18.0,5.0,11.5,3.0,23.0,19.0,10.0,1.0,1.0,26.0,30.0,30.0,15.0,1.0,3.0,2.0,17.0,2.0,5.5,2.0,6.0,2.0,1.5,2.0,2.0,21.5,17.0,22.0,2.0,19.0,32.0,23.5,31.5,30.0,32.0,32.0,32.0,27.5,30.0,32.0,5.0,14.0,10.0,26.0,2.0,21.0,18.0,19.0,22.0,26.5,13.5,27.0,9.5,19.5,30.5,24.0,2.0,14.0,23.0,28.0,29.0,29.0,12.0,15.0,5.5,7.0,11.5,12.0,12.5,20.0,2.5,16.5,16.5,16.5,12.0,10.0,8.0,25.0,3.0,30.0,3.0,30.0,14.0,2.0,3.0,30.0,2.0,31.0,5.0,28.0,31.0,20.0,3.0,30.0,3.0,2.0,23.0,21.0,12.0,25.0,27.0,13.0,4.0,4.0,7.5,2.0,13.0,2.0,9.0,27.5,31.0,3.0,23.0,6.5,23.083333333333332,15.969135802469136,15.112794612794612,2.25,21.0625,11.65625,17.666666666666668,7.2,11.156397306397306,5.0,3.0,26.5,14.0,11.0,1.0,24.0,9.0,19.0,3.0
New Orleans Saints,547.0,7474.0,1117.0,6.7,19.0,5.0,416.0,472.0,662.0,5347.0,46.0,14.0,7.8,280.0,431.0,2127.0,16.0,4.9,116.0,99.0,851.0,20.0,51.4,10.9,330.95,71.3,6.9,2.1,8.3,8.8,11.7,110.5,24.0,158.0,8.2,3.5,294.47,29.0,294.0,1.0,10.1,42.0,1111.0,0.0,26.5,9052.0,0.0,0.0,11.0,11.0,10.0,10.0,8.0,5.0,5.0,2.0,34.0,28.0,82.4,63.0,63.0,100.0,47.0,2224.0,1.0,47.3,339.0,5895.0,1010.0,5.8,16.0,7.0,326.0,362.0,626.0,4157.0,24.0,9.0,6.3,196.0,351.0,1738.0,11.0,5.0,92.0,109.0,912.0,38.0,34.1,8.8,-68.42,57.8,3.8,1.4,7.0,7.2,12.2,86.4,33.0,256.0,6.4,5.0,-68.83,19.0,118.0,0.0,6.2,36.0,927.0,1.0,25.8,32.0,27.0,84.4,37.0,36.0,97.3,71.0,0.0,0.0,0.0,6.0,43.36,-13.9,175.0,6.6,42.6,28.2,175.0,2.96,182.0,5.7,32.4,25.8,150.0,1.79,2.0,1.0,0.0,66.0,2.0,3.0,0.0,0.0,1.0,0.0,0.0,0.0,0.0,5505.0,-3.0,208.0,1579.0,0.6141450313339302,0.3858549686660698,0.7154134332352154,0.2845865667647845,0.7419354838709677,0.25806451612903225,2.413793103448276,0.4142857142857143,0.04807692307692308,1.6938775510204085,0.6524752475247525,0.3475247524752475,0.7051738761662426,0.2948261238337574,0.6857142857142857,0.3142857142857143,0.1165644171779141,1.4,0.8333333333333334,18.0,30625.0,27300.0,2.3999999999999986,2.0,1.0,1.0,1.0,1.0,1.0,2.0,1.0,2.0,3.0,1.0,20.0,6.0,8.0,4.5,28.5,1.0,6.0,1.0,2.0,4.0,3.0,18.0,2.0,3.0,31.0,26.5,29.0,20.5,13.0,28.5,32.0,27.5,22.0,9.5,17.0,17.5,10.0,21.0,3.0,1.0,10.0,11.5,19.0,2.0,2.0,13.0,31.5,32.0,7.0,29.0,1.0,20.0,2.0,1.0,14.0,4.5,2.5,14.0,14.0,16.0,9.0,2.5,3.0,1.0,6.5,13.0,24.0,17.0,26.0,22.0,26.0,30.0,30.0,17.5,16.5,23.5,1.0,12.0,16.0,30.0,28.0,22.0,13.5,9.0,11.0,14.0,24.0,19.5,22.0,25.0,22.0,22.0,1.0,1.0,9.5,5.0,10.5,12.0,28.0,28.0,19.0,18.0,22.0,16.0,15.0,3.0,10.0,16.5,16.5,16.5,28.0,32.0,4.0,29.0,6.0,27.0,5.0,28.0,31.0,18.0,1.0,32.0,8.0,25.0,12.5,20.5,5.0,29.5,9.0,24.0,1.0,1.0,24.0,22.0,3.0,28.0,30.0,1.0,1.0,17.0,3.0,1.0,6.0,8.0,8.0,22.5,26.5,5.0,20.0,2.6666666666666665,22.75,13.456790123456791,12.912457912457912,3.25,7.625,5.4375,19.75,7.4,10.156228956228956,3.0,1.0,25.0,6.0,6.0,3.0,6.0,1.0,26.0,4.0
New England Patriots,513.0,6848.0,1082.0,6.3,17.0,5.0,399.0,402.0,612.0,5084.0,39.0,12.0,7.9,262.0,438.0,1764.0,18.0,4.0,107.0,87.0,815.0,30.0,47.2,8.3,276.58,65.7,6.4,2.0,8.6,9.0,13.1,105.7,32.0,173.0,8.3,5.0,263.82,38.0,393.0,1.0,10.3,46.0,986.0,0.0,21.4,8393.0,1.0,1.0,13.0,12.0,6.0,5.0,11.0,9.0,2.0,1.0,33.0,28.0,84.8,59.0,59.0,100.0,57.0,2648.0,0.0,46.5,342.0,6577.0,1064.0,6.2,34.0,11.0,370.0,386.0,619.0,4703.0,26.0,23.0,7.1,245.0,405.0,1874.0,13.0,4.6,101.0,115.0,907.0,24.0,32.6,17.1,-84.74,62.4,4.2,3.7,8.0,7.2,12.9,86.1,40.0,274.0,6.4,6.1,-117.25,26.0,220.0,0.0,8.5,60.0,1294.0,0.0,21.6,23.0,20.0,87.0,38.0,38.0,100.0,67.0,0.0,0.0,0.0,13.0,18.27,13.74,180.0,6.2,37.9,29.3,153.0,2.68,181.0,6.0,36.2,24.5,166.0,1.84,1.0,2.0,0.0,61.0,2.0,2.0,0.0,0.0,1.0,0.0,0.0,0.0,2.0,5257.0,17.0,171.0,271.0,0.5951940850277264,0.4048059149722736,0.7424065420560748,0.2575934579439252,0.6842105263157895,0.3157894736842105,2.448598130841121,0.4083969465648855,0.07518796992481203,2.15,0.6193609022556391,0.3806390977443609,0.7150676600273681,0.2849323399726319,0.6666666666666666,0.33333333333333337,0.06486486486486487,1.7391304347826089,0.38461538461538464,18.0,27540.0,30046.0,4.800000000000002,3.0,2.0,2.0,3.0,2.0,3.0,3.0,2.0,4.0,2.0,2.0,17.0,20.0,4.0,23.0,13.0,3.0,8.0,4.0,3.0,2.0,2.0,4.0,3.0,2.0,3.5,10.0,2.5,14.0,10.0,19.5,6.5,13.0,13.0,9.5,16.0,11.5,19.0,21.0,29.0,2.0,11.0,11.5,12.0,3.0,3.0,13.0,29.0,29.0,9.5,3.0,2.0,3.0,10.0,3.0,14.0,3.0,2.5,6.0,6.0,11.0,3.0,10.0,6.5,9.0,5.0,15.0,31.0,28.0,29.5,32.0,31.0,29.0,31.0,22.5,29.0,31.0,9.0,17.0,19.0,24.5,12.0,16.0,20.5,24.0,15.0,29.0,24.0,28.0,20.5,25.0,27.0,20.5,4.5,4.0,9.5,13.0,30.5,27.0,12.0,6.0,1.0,2.0,24.0,19.5,20.0,20.0,5.5,16.5,16.5,16.5,12.0,9.0,13.0,20.0,4.0,29.0,9.0,24.0,25.0,3.0,5.0,28.0,5.0,28.0,17.0,16.0,29.0,15.0,7.0,26.0,2.0,3.0,27.0,29.0,5.0,18.0,27.0,3.5,2.0,8.0,15.5,3.0,27.0,3.0,7.0,31.0,32.0,2.0,21.0,5.833333333333333,22.5,14.728395061728397,14.319865319865322,3.0,12.3125,7.65625,15.583333333333334,9.2,11.75993265993266,8.0,2.0,24.0,9.0,9.0,2.0,9.0,2.0,12.0,7.0
Detroit Lions,474.0,6337.0,1058.0,6.0,23.0,7.0,349.0,423.0,666.0,4814.0,41.0,16.0,6.9,244.0,356.0,1523.0,9.0,4.3,71.0,128.0,1075.0,34.0,37.6,10.7,126.56,63.5,6.2,2.4,7.6,7.8,12.0,97.2,36.0,257.0,7.0,5.1,137.29,38.0,301.0,0.0,7.9,37.0,887.0,0.0,24.0,7809.0,0.0,0.0,9.0,9.0,9.0,8.0,4.0,2.0,7.0,5.0,29.0,24.0,82.8,54.0,54.0,100.0,82.0,3573.0,0.0,43.6,387.0,5881.0,1055.0,5.6,34.0,13.0,325.0,376.0,604.0,3831.0,26.0,21.0,5.9,195.0,410.0,2050.0,10.0,5.0,91.0,119.0,982.0,39.0,32.4,16.2,-12.71,62.3,4.3,3.5,6.8,6.1,10.9,82.1,41.0,271.0,5.3,6.4,-0.29,36.0,484.0,1.0,13.4,49.0,1255.0,1.0,25.6,34.0,30.0,88.2,41.0,41.0,100.0,78.0,0.0,0.0,0.0,20.0,-11.64,-13.89,197.0,5.5,32.2,28.7,147.0,2.14,204.0,5.3,28.8,27.0,141.0,1.68,2.0,5.0,0.0,57.0,3.0,3.0,1.0,1.0,3.0,0.0,1.0,0.0,1.0,5071.0,11.0,87.0,456.0,0.6635160680529301,0.33648393194706994,0.7596654568407764,0.24033454315922365,0.82,0.18000000000000005,3.436619718309859,0.29098360655737704,0.09742120343839544,1.7674418604651163,0.6113744075829384,0.3886255924170616,0.6514198265601088,0.3485801734398912,0.7222222222222222,0.2777777777777778,0.12,1.36,0.35,44.0,28959.0,28764.0,1.6999999999999993,4.0,5.0,4.0,7.5,6.5,2.0,1.0,4.0,3.0,11.0,3.0,31.0,29.0,24.0,13.0,3.0,8.0,30.5,5.0,4.0,12.0,7.0,14.5,5.0,6.5,3.5,3.0,5.0,11.5,11.0,15.5,9.0,13.0,19.0,24.0,26.0,25.5,24.0,21.0,14.5,5.0,19.0,19.0,17.5,4.0,4.0,13.0,13.5,16.0,23.5,4.0,4.0,4.0,9.0,8.0,1.5,13.0,8.5,19.5,30.0,31.0,7.5,17.0,20.0,10.0,11.5,23.0,23.0,25.0,21.5,21.0,29.0,28.0,22.0,22.5,6.5,22.0,10.0,23.0,10.0,30.0,29.0,15.0,12.0,22.0,17.0,8.0,8.0,4.0,12.0,7.0,28.0,29.5,16.5,24.0,23.0,31.0,22.0,25.0,28.0,26.0,23.0,25.5,26.5,24.0,24.0,20.0,16.0,16.5,16.5,16.5,12.0,5.0,1.0,32.0,2.0,31.0,2.0,31.0,12.5,9.0,7.0,26.0,19.0,14.0,6.0,27.0,4.0,32.0,1.0,32.0,5.0,5.0,15.0,7.0,8.0,27.0,7.5,16.0,9.5,14.5,22.5,6.0,17.0,9.5,29.5,7.5,16.0,12.0,15.0,8.75,17.833333333333332,22.203703703703702,15.722222222222223,6.2,23.625,14.9125,14.0,9.5,12.61111111111111,10.0,5.0,17.0,30.0,14.0,5.0,26.0,17.0,9.0,8.0
Carolina Panthers,406.0,6237.0,999.0,6.2,23.0,6.0,345.0,312.0,519.0,3829.0,21.0,17.0,6.9,175.0,445.0,2408.0,26.0,5.4,139.0,113.0,1013.0,31.0,38.5,12.8,131.27,60.1,4.0,3.3,7.9,7.2,13.1,84.8,35.0,260.0,6.3,6.3,71.12,32.0,176.0,0.0,5.5,39.0,926.0,1.0,23.7,7595.0,1.0,1.0,7.0,7.0,9.0,6.0,9.0,8.0,2.0,0.0,28.0,22.0,78.6,45.0,44.0,97.8,66.0,2819.0,0.0,42.7,429.0,6042.0,972.0,6.2,24.0,10.0,329.0,318.0,490.0,3949.0,28.0,14.0,7.6,191.0,451.0,2093.0,18.0,4.6,110.0,98.0,901.0,28.0,42.7,12.9,-127.3,64.9,5.7,2.9,8.4,8.3,13.0,98.3,31.0,170.0,7.4,6.0,-118.82,35.0,466.0,3.0,13.3,30.0,811.0,0.0,27.0,31.0,27.0,87.1,48.0,48.0,100.0,52.0,0.0,0.0,0.0,13.0,66.46,-14.76,179.0,5.7,34.8,27.9,162.0,2.21,171.0,5.9,35.1,28.0,167.0,2.36,0.0,0.0,0.0,48.0,2.0,3.0,2.0,0.0,1.0,0.0,0.0,0.0,0.0,4089.0,1.0,-23.0,195.0,0.5545545545545546,0.4454454454454454,0.6139169472502806,0.3860830527497193,0.44680851063829785,0.5531914893617021,1.2589928057553956,0.7942857142857143,0.08985507246376813,1.4629629629629632,0.5360082304526749,0.4639917695473251,0.6535915259847732,0.3464084740152268,0.6086956521739131,0.3913043478260869,0.0851063829787234,1.8260869565217392,0.4615384615384616,4.0,28998.0,28557.0,-0.10000000000000142,5.5,7.0,23.0,4.5,8.0,18.0,23.0,13.0,15.0,11.0,18.5,14.0,3.0,1.0,1.0,11.0,6.0,1.0,15.5,15.0,7.5,12.0,4.0,13.0,11.0,18.0,16.0,20.5,25.5,31.0,21.5,17.0,22.0,29.0,24.0,30.0,22.0,23.0,5.0,16.0,8.0,23.0,26.5,24.5,7.0,8.0,27.5,26.5,27.0,27.5,17.0,13.0,14.5,11.0,20.0,29.0,13.0,6.0,21.5,26.5,28.0,18.5,15.5,21.0,15.0,22.0,27.0,28.0,5.5,29.5,23.0,12.0,6.0,24.0,25.5,31.5,20.0,21.5,25.0,29.0,24.5,22.0,31.0,25.0,30.0,28.0,32.0,31.0,29.0,30.0,30.5,13.0,19.0,14.0,23.0,32.0,30.0,6.5,8.0,12.0,30.0,17.0,18.0,25.0,27.0,27.0,20.0,1.0,16.5,16.5,16.5,12.0,18.0,23.0,10.0,25.0,8.0,32.0,1.0,19.0,26.0,25.0,8.0,16.0,17.0,22.0,11.0,16.0,7.0,30.0,3.0,4.0,10.0,31.0,30.0,1.0,29.0,29.0,9.5,6.0,18.5,7.5,5.0,16.0,17.0,3.0,27.5,30.0,15.0,31.0,7.583333333333333,25.333333333333332,24.555555555555557,18.666666666666664,14.35,3.75,9.05,25.583333333333332,15.7,17.18333333333333,19.0,4.0,30.0,32.0,23.0,14.0,1.0,3.0,31.0,15.0
San Diego Chargers,406.0,6290.0,1048.0,6.0,28.0,8.0,359.0,366.0,582.0,4426.0,27.0,20.0,7.2,234.0,436.0,1864.0,16.0,4.3,97.0,91.0,753.0,28.0,41.3,16.3,103.68,62.9,4.6,3.4,7.9,7.3,12.6,88.7,30.0,198.0,6.6,4.9,121.12,31.0,264.0,0.0,8.5,43.0,1100.0,1.0,25.6,7928.0,0.0,0.0,11.0,11.0,5.0,4.0,12.0,9.0,7.0,4.0,35.0,28.0,80.0,45.0,44.0,97.8,47.0,2234.0,0.0,47.5,377.0,5546.0,958.0,5.8,21.0,4.0,311.0,299.0,478.0,3591.0,29.0,17.0,7.0,186.0,448.0,1955.0,8.0,4.4,102.0,92.0,760.0,23.0,36.5,12.4,-75.29,62.6,6.1,3.6,7.9,7.5,12.6,92.5,32.0,187.0,6.7,6.3,-79.74,25.0,329.0,0.0,13.2,57.0,1451.0,1.0,25.5,28.0,25.0,89.3,40.0,40.0,100.0,60.0,0.0,0.0,0.0,19.0,-14.23,5.19,172.0,6.3,36.6,27.9,181.0,2.24,170.0,5.8,32.4,26.7,164.0,1.96,1.0,1.0,0.0,46.0,1.0,1.0,0.0,0.0,4.0,0.0,2.0,0.0,0.0,4624.0,-7.0,29.0,744.0,0.583969465648855,0.416030534351145,0.7036565977742448,0.2963434022257552,0.627906976744186,0.37209302325581395,2.4123711340206184,0.41452991452991456,0.07799442896935932,1.8372093023255816,0.5323590814196242,0.4676409185803758,0.64749368914533,0.35250631085466994,0.7837837837837838,0.21621621621621626,0.07395498392282958,1.7954545454545454,0.42105263157894735,12.0,31132.0,27880.0,1.1999999999999993,5.5,6.0,5.0,7.5,3.0,6.0,9.0,6.0,8.0,5.5,4.0,18.0,16.0,8.0,13.0,17.0,4.0,14.5,7.0,10.0,7.5,10.5,10.0,11.0,9.0,23.5,30.5,14.0,23.5,28.0,17.0,8.0,24.0,25.5,24.0,22.0,15.5,11.0,5.0,6.0,4.0,8.5,11.5,20.5,7.0,8.0,27.5,31.5,31.0,5.0,19.0,6.0,25.0,6.0,11.0,19.0,21.0,12.5,25.5,7.5,6.0,28.0,8.0,11.0,8.0,24.0,22.0,16.0,1.0,26.0,17.0,8.0,3.0,13.0,27.5,27.5,15.5,20.0,20.0,4.0,20.0,9.0,26.0,22.0,26.5,30.0,28.0,27.0,26.0,27.0,28.0,6.0,5.0,3.0,17.0,9.5,29.0,27.5,31.0,28.0,25.0,9.5,13.5,28.0,22.5,22.5,20.0,4.0,16.5,16.5,16.5,12.0,12.0,15.0,18.0,8.0,25.0,21.0,12.0,23.0,5.0,27.0,6.0,22.0,11.0,2.0,31.0,24.0,11.0,10.0,23.0,7.0,7.0,25.0,25.0,10.0,23.0,31.0,2.0,3.0,18.5,2.0,4.0,3.0,14.0,2.0,24.0,26.5,9.0,26.0,9.0,21.0,18.024691358024693,15.824915824915825,9.5,13.25,11.375,20.375,11.8,13.812457912457912,13.0,6.0,21.0,24.0,16.0,8.0,12.0,7.0,27.0,11.0
Atlanta Falcons,402.0,6026.0,1073.0,5.6,21.0,8.0,349.0,365.0,594.0,4192.0,29.0,13.0,6.8,215.0,453.0,1834.0,14.0,4.0,100.0,93.0,769.0,34.0,37.4,10.7,66.87,61.4,4.9,2.2,7.3,7.3,12.0,91.1,26.0,173.0,6.8,4.2,113.03,33.0,315.0,0.0,9.5,24.0,563.0,0.0,23.5,7181.0,2.0,2.0,9.0,9.0,9.0,9.0,7.0,5.0,2.0,2.0,29.0,27.0,93.1,45.0,45.0,100.0,71.0,2990.0,1.0,42.1,350.0,5338.0,965.0,5.5,29.0,10.0,292.0,340.0,560.0,3786.0,25.0,19.0,6.4,186.0,372.0,1552.0,10.0,4.2,87.0,101.0,843.0,19.0,32.2,15.0,-18.44,60.7,4.5,3.4,7.2,6.5,11.8,83.3,33.0,231.0,5.8,5.6,-46.31,31.0,150.0,0.0,4.8,60.0,1487.0,0.0,24.8,28.0,23.0,82.1,37.0,37.0,100.0,75.0,0.0,0.0,0.0,12.0,-38.04,24.21,187.0,5.9,32.2,28.5,166.0,2.04,180.0,5.5,29.6,26.9,150.0,1.74,1.0,2.0,0.0,46.0,0.0,1.0,0.0,1.0,2.0,1.0,1.0,0.0,1.0,4365.0,8.0,52.0,688.0,0.5778191985088537,0.4221808014911464,0.6956521739130435,0.3043478260869565,0.6744186046511628,0.32558139534883723,2.15,0.4651162790697674,0.09742120343839544,1.825,0.6145077720207254,0.3854922279792746,0.7092544023979018,0.29074559760209817,0.7142857142857143,0.2857142857142857,0.06506849315068493,1.7142857142857142,0.6666666666666666,18.0,31042.0,27000.0,1.6000000000000014,7.0,10.0,3.0,14.0,6.5,7.5,4.0,8.0,6.5,13.0,9.0,11.0,17.0,13.0,23.0,3.0,9.0,11.5,11.5,6.5,13.5,10.5,14.5,9.0,8.0,10.0,16.0,10.5,20.5,19.0,25.5,10.5,19.0,18.0,24.0,20.0,32.0,32.0,21.0,18.5,17.0,19.0,14.0,1.0,7.0,6.0,13.0,22.5,24.0,30.0,6.0,8.0,5.5,7.0,10.0,14.0,7.5,12.5,9.5,10.0,7.0,7.5,6.0,6.5,4.0,8.5,18.0,12.0,4.0,17.5,11.0,21.5,21.0,20.0,20.5,20.0,15.5,3.0,6.0,10.0,15.0,4.0,14.0,10.0,17.5,20.5,17.0,11.5,9.5,14.0,15.0,17.5,13.0,8.5,2.0,9.5,1.0,30.5,32.0,12.0,22.0,9.5,11.0,15.0,16.0,17.0,20.0,13.5,16.5,16.5,16.5,28.0,30.0,16.0,17.0,11.0,22.0,11.0,22.0,12.5,6.0,6.0,27.0,7.0,26.0,7.0,26.0,28.0,17.0,14.0,19.0,10.0,8.0,17.0,17.0,24.0,16.0,21.0,5.5,9.5,16.0,4.0,7.0,4.0,11.0,5.5,14.5,17.0,11.0,17.5,11.166666666666666,14.333333333333334,16.061728395061728,13.653198653198654,7.7,14.75,11.225,16.583333333333332,7.5,10.576599326599327,4.0,10.0,14.0,15.0,8.0,6.0,14.0,6.0,15.0,5.0
Philadelphia Eagles,396.0,6386.0,1036.0,6.2,38.0,13.0,356.0,330.0,554.0,4110.0,22.0,25.0,7.0,197.0,450.0,2276.0,20.0,5.1,134.0,107.0,853.0,25.0,34.7,17.9,63.46,59.6,4.0,4.5,7.7,6.5,13.0,78.3,32.0,166.0,5.8,5.5,43.86,30.0,212.0,0.0,7.1,39.0,815.0,0.0,20.9,7721.0,0.0,0.0,10.0,10.0,11.0,9.0,4.0,4.0,2.0,1.0,27.0,24.0,88.9,46.0,46.0,100.0,67.0,2830.0,1.0,42.2,328.0,5198.0,982.0,5.3,24.0,9.0,289.0,301.0,518.0,3397.0,27.0,15.0,6.0,173.0,414.0,1801.0,11.0,4.4,84.0,97.0,813.0,32.0,27.7,12.3,20.35,58.1,5.2,2.9,7.2,6.9,12.3,85.7,50.0,316.0,5.7,8.8,-16.49,31.0,176.0,0.0,5.7,51.0,1178.0,0.0,23.1,24.0,16.0,66.7,38.0,38.0,100.0,85.0,0.0,0.0,0.0,23.0,31.28,35.12,190.0,5.6,33.7,28.7,158.0,1.93,195.0,5.2,26.6,28.6,141.0,1.61,3.0,1.0,0.0,46.0,0.0,0.0,1.0,0.0,2.0,0.0,1.0,0.0,0.0,4276.0,-14.0,68.0,1188.0,0.5656370656370656,0.4343629343629344,0.6435953648606326,0.3564046351393674,0.5238095238095238,0.4761904761904762,1.4701492537313432,0.6802030456852792,0.0702247191011236,1.5098039215686276,0.5784114052953157,0.4215885947046844,0.6535205848403232,0.34647941515967684,0.7105263157894737,0.2894736842105263,0.11072664359861592,1.6363636363636362,0.5652173913043478,26.0,30020.0,27495.0,0.09999999999999787,8.0,4.0,7.5,4.5,4.0,14.0,13.0,9.0,11.5,8.0,11.0,12.0,5.0,2.0,3.0,22.0,12.5,2.0,19.0,15.0,11.0,16.5,6.0,19.0,15.0,18.0,21.0,18.0,1.5,3.0,1.0,17.0,25.5,28.0,24.0,27.5,22.0,28.0,21.0,31.0,7.0,26.5,19.0,5.0,5.0,5.0,13.0,24.5,26.0,29.0,20.5,10.0,30.5,4.0,9.0,7.5,31.0,27.0,31.5,22.0,18.0,30.0,10.0,4.0,12.0,32.0,10.0,8.0,9.0,12.0,8.0,9.5,12.0,10.0,24.0,10.0,9.0,12.0,16.0,16.0,20.0,25.5,4.0,9.0,10.0,26.5,17.0,19.5,22.5,19.0,11.5,10.5,10.0,8.5,3.0,9.5,3.0,23.0,22.0,12.0,13.5,2.0,1.0,1.0,19.5,20.0,20.0,22.5,16.5,16.5,16.5,28.0,25.0,19.0,14.0,20.0,13.0,30.0,3.0,28.0,25.0,16.0,17.0,17.0,16.0,8.0,25.0,7.0,23.0,27.0,6.0,11.0,15.0,10.0,10.0,4.0,10.0,15.0,13.0,7.0,14.5,10.5,9.5,8.0,16.0,23.0,3.5,8.0,18.0,12.5,9.666666666666666,12.333333333333334,17.97530864197531,12.902356902356901,14.05,7.25,10.65,12.166666666666666,13.5,13.20117845117845,12.0,8.0,10.0,22.0,5.0,13.0,4.0,5.0,8.0,13.0
New York Giants,394.0,6161.0,1028.0,6.0,24.0,8.0,331.0,359.0,589.0,4734.0,29.0,16.0,7.7,216.0,411.0,1427.0,17.0,3.5,84.0,94.0,795.0,31.0,32.5,11.5,106.83,61.0,4.9,2.7,8.4,8.1,13.7,92.9,28.0,199.0,7.4,4.5,174.08,28.0,171.0,0.0,6.1,52.0,1209.0,0.0,23.3,7808.0,0.0,0.0,12.0,12.0,4.0,3.0,5.0,3.0,3.0,1.0,24.0,19.0,79.2,43.0,43.0,100.0,82.0,3745.0,0.0,45.7,400.0,6022.0,1072.0,5.6,31.0,11.0,338.0,361.0,589.0,4082.0,28.0,20.0,6.4,210.0,435.0,1940.0,15.0,4.5,103.0,110.0,933.0,25.0,34.7,14.8,-60.46,61.3,4.8,3.4,7.5,6.9,12.2,86.1,48.0,335.0,5.9,7.5,-89.01,41.0,407.0,0.0,9.9,46.0,1053.0,0.0,22.9,31.0,25.0,80.6,45.0,45.0,100.0,75.0,0.0,0.0,0.0,18.0,-63.61,12.82,200.0,5.3,30.7,26.4,142.0,1.9,196.0,5.6,30.8,28.7,149.0,1.92,1.0,0.0,0.0,47.0,4.0,4.0,2.0,0.0,3.0,0.0,1.0,0.0,1.0,4933.0,7.0,-6.0,139.0,0.6001945525291829,0.3998054474708171,0.7683817562084078,0.23161824379159224,0.6304347826086957,0.3695652173913043,2.5714285714285716,0.3888888888888889,0.09365558912386708,2.4,0.5942164179104478,0.4057835820895522,0.6778478910660911,0.322152108933909,0.6511627906976745,0.34883720930232553,0.07396449704142012,1.6666666666666667,0.4444444444444444,10.0,28400.0,29204.0,-2.3000000000000007,9.0,8.0,11.0,7.5,10.0,9.0,6.0,5.0,6.5,4.0,8.0,22.0,32.0,6.0,32.0,11.0,16.5,24.0,13.0,6.5,3.0,4.0,1.5,6.0,4.0,7.0,10.0,7.5,3.5,2.0,7.0,10.5,29.0,30.0,24.0,29.0,6.5,7.0,21.0,21.0,6.0,31.5,30.5,22.5,10.0,10.0,13.0,13.5,15.0,13.5,7.5,5.0,7.5,12.0,19.0,23.0,16.5,12.5,19.5,11.0,9.0,13.0,7.0,12.0,5.5,15.0,25.0,27.0,30.0,21.5,26.0,25.0,24.0,29.0,25.5,20.0,29.0,16.5,19.0,24.5,22.5,15.5,23.0,23.0,20.0,23.0,21.5,19.5,19.5,20.5,17.5,23.5,23.0,21.5,20.0,9.5,17.0,17.5,17.0,12.0,11.0,17.0,13.5,9.0,26.0,26.0,20.0,13.5,16.5,16.5,16.5,12.0,16.0,9.0,24.0,1.0,32.0,20.0,13.0,16.0,1.0,12.0,21.0,11.0,22.0,18.0,15.0,23.0,19.0,5.0,28.0,6.0,4.0,22.0,27.0,32.0,20.0,3.0,24.5,13.0,27.5,26.5,11.0,22.0,24.0,25.5,19.0,22.0,19.0,25.0,13.25,21.25,18.802469135802472,17.673400673400675,7.75,20.8125,14.28125,17.333333333333332,16.9,17.286700336700335,20.0,12.0,22.0,27.5,19.0,7.0,22.0,14.0,16.5,18.0
Houston Texans,381.0,5954.0,1046.0,5.7,20.0,11.0,321.0,288.0,467.0,3506.0,20.0,9.0,7.0,176.0,546.0,2448.0,18.0,4.5,131.0,99.0,852.0,14.0,37.2,10.5,46.86,61.7,4.3,1.9,7.9,7.9,12.8,92.7,33.0,190.0,7.0,6.6,69.3,51.0,529.0,1.0,10.4,29.0,730.0,0.0,25.2,7387.0,0.0,0.0,14.0,14.0,11.0,10.0,8.0,4.0,5.0,4.0,38.0,32.0,84.2,40.0,39.0,97.5,74.0,3256.0,0.0,44.0,278.0,4571.0,960.0,4.8,27.0,10.0,270.0,279.0,538.0,3035.0,18.0,17.0,5.2,166.0,378.0,1536.0,8.0,4.1,73.0,88.0,686.0,31.0,29.8,13.8,99.11,51.9,3.3,3.2,6.2,5.4,11.9,69.0,44.0,287.0,4.5,7.6,50.93,32.0,307.0,0.0,9.6,46.0,1030.0,0.0,22.4,36.0,30.0,83.3,22.0,22.0,100.0,83.0,0.0,0.0,0.0,20.0,-13.04,36.26,191.0,5.7,31.1,30.3,164.0,1.93,188.0,5.3,24.3,27.9,140.0,1.45,1.0,1.0,0.0,41.0,0.0,1.0,0.0,1.0,0.0,0.0,2.0,0.0,0.0,3696.0,7.0,103.0,1383.0,0.4780114722753346,0.5219885277246654,0.5888478333893181,0.4111521666106819,0.5263157894736842,0.4736842105263158,1.3435114503816794,0.7443181818181818,0.04361370716510903,1.7555555555555555,0.60625,0.39375,0.6639684970465981,0.3360315029534019,0.6923076923076923,0.3076923076923077,0.1148148148148148,1.5121951219512195,0.55,12.0,31324.0,26320.0,2.400000000000002,10.0,13.0,6.0,12.5,13.0,26.0,30.0,18.0,20.0,8.0,17.0,1.5,2.0,4.0,7.5,32.0,10.0,3.0,9.0,11.5,7.5,6.0,8.0,7.0,6.5,12.0,16.0,14.0,6.0,6.0,5.0,13.5,2.0,5.0,9.5,14.5,31.0,30.0,21.0,7.0,12.0,5.5,4.5,15.0,12.5,13.5,29.0,19.0,21.0,20.0,12.0,18.0,7.5,3.0,6.0,19.0,6.0,22.5,3.0,14.0,17.0,6.0,12.5,9.5,20.0,4.0,4.0,2.0,2.0,3.0,5.0,4.0,16.5,3.0,6.5,2.0,4.0,4.0,4.0,4.0,12.0,24.0,10.0,2.5,1.0,5.5,2.0,2.0,13.0,2.0,1.5,4.0,2.0,10.5,15.0,9.5,15.5,17.5,15.0,12.0,7.0,26.5,25.5,18.5,3.0,3.0,20.0,20.0,16.5,16.5,16.5,12.0,24.0,31.0,2.0,29.0,4.0,28.5,4.5,32.0,10.5,8.0,25.0,14.0,19.0,10.0,23.0,6.0,27.0,29.0,4.0,12.0,12.0,2.0,2.0,9.0,9.0,14.0,9.5,12.0,5.0,5.0,9.5,1.0,7.0,15.5,7.5,2.0,14.0,5.0,9.583333333333334,6.166666666666667,13.734567901234568,9.473063973063972,13.35,5.8125,9.58125,10.083333333333334,4.9,7.186531986531986,1.0,7.0,3.0,7.0,1.0,11.0,2.0,4.0,4.0,1.0
San Francisco 49ers,380.0,4974.0,993.0,5.0,10.0,5.0,282.0,277.0,451.0,2930.0,18.0,5.0,5.9,150.0,498.0,2044.0,14.0,4.1,101.0,113.0,1014.0,31.0,39.6,5.2,-9.07,61.4,4.0,1.1,7.1,7.4,11.5,91.4,44.0,263.0,6.2,8.9,35.66,44.0,544.0,1.0,12.4,39.0,1060.0,1.0,27.2,6856.0,2.0,2.0,16.0,16.0,14.0,13.0,11.0,6.0,9.0,7.0,52.0,44.0,84.6,34.0,34.0,100.0,79.0,3970.0,1.0,50.3,229.0,4931.0,974.0,5.1,38.0,15.0,267.0,333.0,579.0,3695.0,20.0,23.0,6.0,190.0,353.0,1236.0,3.0,3.5,53.0,98.0,867.0,24.0,23.3,18.7,95.67,57.5,3.5,4.0,6.9,5.8,11.9,73.6,42.0,283.0,4.9,6.8,14.86,39.0,315.0,0.0,8.1,46.0,1061.0,0.0,23.1,27.0,22.0,81.5,21.0,21.0,100.0,87.0,0.0,0.0,0.0,14.0,-36.86,72.08,192.0,5.4,25.9,33.5,161.0,1.85,193.0,5.2,25.5,24.3,140.0,1.18,0.0,1.0,0.0,35.0,1.0,1.0,1.0,0.0,0.0,0.0,1.0,0.0,1.0,3193.0,28.0,151.0,43.0,0.4984894259818731,0.5015105740181269,0.5890631282669884,0.4109368717330116,0.5625,0.4375,1.4851485148514851,0.6733333333333333,0.1099290780141844,1.7317073170731707,0.6375770020533881,0.3624229979466119,0.7493409044818495,0.2506590955181505,0.8695652173913043,0.13043478260869568,0.0898876404494382,1.9714285714285715,0.35714285714285715,8.0,30912.0,27020.0,9.2,11.0,26.0,24.5,24.0,23.0,29.0,31.0,29.0,24.5,20.0,30.0,3.0,8.0,13.0,19.5,11.0,5.0,10.0,11.5,15.0,16.5,9.0,21.5,8.0,12.0,1.5,1.5,2.5,8.0,7.5,11.5,4.0,7.5,4.0,9.5,5.0,22.0,12.0,5.0,1.0,24.0,1.0,1.0,13.5,20.5,20.0,13.0,15.0,9.0,2.0,2.0,30.0,1.0,14.0,4.0,25.5,1.0,2.5,1.0,26.5,29.0,1.0,25.5,22.0,27.5,1.0,2.0,4.0,7.0,7.5,2.0,18.5,23.0,16.0,8.0,10.0,19.0,2.0,1.0,1.0,1.5,12.0,1.0,1.0,8.0,8.5,11.5,6.0,13.0,5.0,4.5,13.0,15.0,20.0,16.0,9.5,11.0,17.5,19.0,12.0,13.5,5.5,7.0,11.5,1.5,1.5,20.0,25.5,16.5,16.5,16.5,28.0,6.0,30.0,3.0,28.0,5.0,25.5,7.5,4.0,13.0,2.0,31.0,1.0,32.0,1.0,32.0,13.0,2.0,26.0,7.0,17.0,16.0,3.0,5.0,22.0,1.0,13.0,19.5,23.5,1.0,9.0,12.0,5.0,1.0,21.0,3.5,5.0,1.0,1.0,16.75,3.5,9.141975308641976,9.856902356902356,18.45,9.625,14.0375,8.166666666666666,5.0,7.428451178451178,2.0,16.0,1.0,1.0,2.0,22.0,7.0,13.0,2.0,2.0
Baltimore Ravens,378.0,5419.0,1036.0,5.2,24.0,12.0,312.0,314.0,544.0,3423.0,21.0,12.0,5.9,181.0,459.0,1996.0,15.0,4.3,98.0,92.0,742.0,33.0,35.5,11.8,27.37,57.7,3.9,2.2,6.7,6.5,11.6,81.7,33.0,206.0,5.7,5.7,69.52,36.0,345.0,1.0,9.6,42.0,1047.0,0.0,24.9,7070.0,1.0,1.0,9.0,9.0,12.0,10.0,11.0,9.0,6.0,1.0,39.0,30.0,76.9,40.0,40.0,100.0,73.0,3393.0,0.0,46.5,266.0,4622.0,1002.0,4.6,26.0,11.0,269.0,288.0,535.0,3140.0,11.0,15.0,5.4,166.0,419.0,1482.0,10.0,3.5,79.0,103.0,1032.0,24.0,26.6,13.8,133.31,53.8,2.1,2.8,6.4,5.6,11.9,68.8,48.0,290.0,4.6,8.2,77.51,33.0,392.0,2.0,11.9,36.0,1050.0,1.0,29.2,31.0,28.0,90.3,26.0,26.0,100.0,86.0,0.0,0.0,0.0,24.0,-32.7,45.09,186.0,5.8,29.1,28.9,158.0,1.84,188.0,5.5,24.5,29.3,150.0,1.27,3.0,1.0,0.0,41.0,1.0,1.0,0.0,0.0,1.0,0.0,0.0,0.0,0.0,3629.0,2.0,112.0,797.0,0.556949806949807,0.44305019305019294,0.6316663591068463,0.3683336408931537,0.5833333333333334,0.4166666666666666,1.846938775510204,0.5414364640883977,0.10576923076923077,1.5581395348837208,0.5818363273453094,0.41816367265469057,0.6793595845954132,0.3206404154045868,0.5238095238095238,0.4761904761904762,0.08921933085501857,1.8285714285714287,0.5,24.0,29388.0,28200.0,-0.4000000000000021,12.0,15.0,7.5,18.5,15.5,17.0,18.0,19.0,15.0,20.0,14.0,8.0,10.0,10.5,13.0,5.5,11.0,13.0,22.0,18.5,21.5,16.5,20.0,15.0,16.0,14.0,10.0,18.0,3.5,5.0,3.0,19.5,16.0,15.0,9.5,19.0,17.5,14.0,21.0,9.0,19.0,3.5,8.0,26.0,12.5,12.0,13.0,20.5,20.0,9.5,12.0,19.0,11.5,5.0,5.0,9.5,16.5,24.5,6.0,9.0,4.0,16.0,12.5,13.0,13.0,8.5,3.0,3.0,13.5,2.0,4.0,5.0,15.0,4.0,1.0,3.0,4.0,13.0,2.0,10.0,1.5,12.0,3.0,6.0,2.0,1.0,3.5,3.5,13.0,1.0,3.0,19.0,32.0,12.0,19.0,29.5,24.0,10.5,16.0,28.0,31.0,17.0,20.5,29.0,4.0,4.0,20.0,24.0,16.5,16.5,16.5,12.0,22.0,21.0,12.0,23.0,10.0,23.0,10.0,6.0,23.0,14.0,19.0,10.0,23.0,31.0,2.0,15.0,6.0,19.0,14.0,13.0,11.0,1.0,1.0,20.0,6.0,22.5,7.0,15.0,12.0,10.5,13.0,11.0,18.0,15.5,14.5,3.0,20.0,2.0,15.333333333333334,4.75,18.802469135802472,12.430976430976433,13.5,12.4375,12.96875,7.916666666666667,10.1,11.265488215488215,6.0,15.0,2.0,27.5,4.0,12.0,10.0,10.0,1.0,9.0
New York Jets,377.0,4989.0,1030.0,4.8,34.0,16.0,301.0,310.0,547.0,3297.0,26.0,18.0,5.6,173.0,443.0,1692.0,14.0,3.8,92.0,102.0,849.0,36.0,29.6,13.8,-66.18,56.7,4.8,3.3,6.5,5.9,11.4,78.4,40.0,245.0,5.1,6.8,-33.0,44.0,426.0,0.0,9.7,62.0,1633.0,1.0,26.3,7299.0,0.0,0.0,6.0,5.0,6.0,6.0,7.0,5.0,6.0,3.0,25.0,19.0,76.0,44.0,44.0,100.0,92.0,3926.0,0.0,42.7,363.0,4993.0,993.0,5.0,31.0,12.0,272.0,275.0,507.0,3216.0,15.0,19.0,5.9,167.0,451.0,1777.0,17.0,3.9,83.0,110.0,966.0,22.0,29.3,13.9,89.9,54.2,3.0,3.7,6.7,5.6,12.4,69.6,35.0,198.0,4.9,6.5,32.92,32.0,241.0,0.0,7.5,61.0,1291.0,0.0,21.2,30.0,29.0,96.7,38.0,38.0,100.0,92.0,0.0,0.0,0.0,25.0,-31.61,47.65,203.0,5.2,24.4,30.9,146.0,1.69,208.0,4.9,24.0,29.5,135.0,1.5,1.0,2.0,1.0,45.0,0.0,1.0,3.0,4.0,3.0,0.0,1.0,0.0,1.0,3542.0,-3.0,14.0,-4.0,0.5699029126213592,0.4300970873786408,0.6608538785327721,0.3391461214672279,0.65,0.35,1.880434782608696,0.5317919075144508,0.11960132890365448,1.7105263157894737,0.5458207452165156,0.4541792547834844,0.6441017424394152,0.3558982575605848,0.46875,0.53125,0.08088235294117647,1.717948717948718,0.64,30.0,29638.0,28080.0,1.3999999999999986,13.0,25.0,10.0,28.0,17.0,19.0,17.0,21.0,9.0,25.5,20.5,16.0,22.0,13.0,29.5,1.0,22.0,18.0,24.5,8.0,25.5,22.0,24.0,18.0,19.5,7.0,5.0,10.5,17.5,25.0,13.5,6.5,7.5,11.0,24.0,18.0,1.0,1.0,5.0,4.0,15.0,29.0,30.5,27.5,9.0,8.0,13.0,5.5,11.0,27.5,10.0,20.0,20.0,15.0,15.0,5.5,29.0,30.5,23.5,18.0,15.0,21.0,20.0,18.0,21.0,22.0,20.0,5.0,12.0,4.5,6.0,3.0,8.5,5.0,2.5,6.5,6.0,21.5,13.0,27.5,7.0,8.0,8.0,8.0,4.0,4.0,5.5,3.5,24.5,3.0,4.5,23.5,27.0,10.5,7.0,9.5,9.5,32.0,26.0,12.0,4.0,15.0,22.5,32.0,19.5,20.0,20.0,29.0,16.5,16.5,16.5,12.0,29.0,18.0,15.0,15.0,18.0,14.0,19.0,1.0,16.0,23.0,10.0,24.0,9.0,32.0,1.0,18.0,16.0,17.0,16.0,23.0,24.0,4.0,3.0,17.0,5.0,2.0,28.5,29.5,3.0,24.5,18.0,9.0,12.5,32.0,1.0,1.0,21.5,6.0,23.166666666666668,8.583333333333334,15.469135802469136,15.764309764309763,17.05,20.5,18.775,10.166666666666666,14.3,15.032154882154881,14.0,25.0,6.0,12.0,15.0,18.0,20.0,22.0,5.0,14.0
Buffalo Bills,372.0,5624.0,992.0,5.7,30.0,5.0,313.0,356.0,578.0,3703.0,24.0,25.0,6.2,180.0,391.0,1921.0,12.0,4.9,100.0,86.0,743.0,33.0,31.2,15.9,13.19,61.6,4.2,4.3,6.7,5.6,10.8,77.0,23.0,154.0,5.1,3.8,9.49,26.0,329.0,1.0,12.7,37.0,853.0,0.0,23.1,6953.0,0.0,0.0,12.0,11.0,7.0,5.0,8.0,5.0,4.0,2.0,31.0,23.0,74.2,41.0,41.0,100.0,73.0,3472.0,1.0,47.6,434.0,5938.0,1003.0,5.9,31.0,11.0,340.0,321.0,507.0,3714.0,30.0,20.0,6.9,196.0,467.0,2224.0,19.0,4.8,120.0,85.0,871.0,24.0,37.0,15.3,-87.55,63.3,5.9,3.9,7.7,7.1,12.2,90.4,29.0,210.0,6.4,5.4,-70.47,43.0,494.0,0.0,11.5,56.0,1144.0,0.0,20.4,25.0,21.0,84.0,52.0,51.0,98.1,68.0,0.0,0.0,0.0,16.0,5.5,-15.35,189.0,5.4,29.8,26.2,153.0,1.7,189.0,5.4,31.4,29.5,151.0,2.15,2.0,4.0,0.0,43.0,1.0,2.0,1.0,0.0,3.0,1.0,1.0,0.0,0.0,3857.0,1.0,-62.0,-314.0,0.6058467741935484,0.3941532258064516,0.6584281650071123,0.3415718349928877,0.6666666666666666,0.33333333333333337,1.8,0.5555555555555556,0.10543130990415336,1.3673469387755102,0.5343968095712861,0.4656031904287139,0.625463118895251,0.374536881104749,0.6122448979591837,0.3877551020408163,0.07058823529411765,1.6041666666666667,0.3125,38.0,28917.0,28539.0,-3.3000000000000007,14.0,14.0,26.0,12.5,14.0,10.0,10.0,15.0,10.0,15.0,15.5,27.0,13.0,17.0,4.5,5.5,20.0,11.5,10.0,13.0,21.5,26.0,28.0,21.0,19.5,7.0,10.0,7.5,28.5,22.0,27.0,5.0,32.0,16.0,9.5,3.5,25.5,26.0,21.0,23.0,21.0,14.5,23.5,31.5,11.0,11.0,13.0,20.5,19.0,4.0,5.0,16.0,14.5,19.0,22.0,3.0,26.0,2.5,31.5,5.0,5.0,27.0,1.0,1.0,2.0,30.0,30.0,26.0,15.0,28.0,27.0,14.0,8.5,19.0,29.5,26.0,23.5,24.0,28.0,30.5,27.5,12.0,27.0,28.0,28.0,29.0,25.0,21.5,19.5,26.0,25.0,2.5,16.0,23.5,25.0,9.5,20.5,26.0,21.0,12.0,1.0,3.0,3.5,21.0,30.0,30.0,5.5,7.5,16.5,16.5,16.5,28.0,3.0,7.0,26.0,16.0,17.0,12.0,21.0,7.0,29.0,26.0,7.0,27.0,6.0,21.0,12.0,25.0,24.0,21.0,12.0,15.0,18.0,28.0,23.0,6.0,30.0,17.0,19.5,14.0,29.0,15.5,17.0,18.0,26.5,18.0,11.0,24.0,21.5,29.0,14.583333333333334,23.916666666666668,15.358024691358024,18.18855218855219,15.85,13.1875,14.51875,19.25,20.0,19.094276094276097,21.0,14.0,28.0,10.0,21.0,16.0,11.0,16.0,24.0,22.0
Dallas Cowboys,369.0,6008.0,1017.0,5.9,21.0,9.0,327.0,376.0,570.0,4201.0,33.0,12.0,6.9,219.0,408.0,1807.0,5.0,4.4,91.0,114.0,816.0,17.0,37.8,11.4,78.92,66.0,5.8,2.1,7.8,8.0,11.8,100.1,39.0,252.0,7.1,6.4,126.31,41.0,293.0,0.0,7.1,33.0,768.0,0.0,23.3,7315.0,1.0,1.0,9.0,8.0,11.0,11.0,12.0,10.0,4.0,2.0,37.0,32.0,86.5,39.0,39.0,100.0,71.0,3047.0,1.0,42.9,347.0,5491.0,972.0,5.6,25.0,10.0,305.0,336.0,545.0,3906.0,24.0,15.0,6.7,199.0,385.0,1585.0,10.0,4.1,78.0,85.0,650.0,28.0,33.3,13.3,-24.08,61.7,4.4,2.8,7.6,7.3,12.3,88.4,42.0,243.0,6.3,7.2,-59.21,30.0,278.0,0.0,9.3,52.0,1114.0,0.0,21.4,33.0,26.0,78.8,35.0,35.0,100.0,72.0,0.0,0.0,0.0,24.0,-33.68,32.47,185.0,5.7,32.4,29.0,163.0,1.96,180.0,5.6,30.4,25.9,158.0,1.76,0.0,1.0,0.0,39.0,0.0,0.0,0.0,1.0,2.0,1.0,2.0,0.0,1.0,4453.0,4.0,22.0,517.0,0.5988200589970502,0.40117994100294985,0.6992343541944075,0.3007656458055925,0.8684210526315791,0.13157894736842102,2.4065934065934065,0.4155251141552511,0.051987767584097865,1.7727272727272725,0.6039094650205762,0.3960905349794238,0.7113458386450555,0.2886541613549445,0.7058823529411765,0.2941176470588235,0.0918032786885246,1.8536585365853653,0.375,6.0,30155.0,28440.0,3.1000000000000014,15.0,11.0,14.5,10.5,12.0,4.5,11.5,7.0,5.0,11.0,7.0,24.0,18.0,30.5,10.0,31.0,7.0,19.0,3.0,5.0,10.0,5.0,16.0,4.0,5.0,16.0,16.0,18.0,8.0,15.0,9.0,19.5,10.0,23.0,24.0,27.5,28.0,29.0,21.0,21.0,13.0,7.0,4.5,9.0,14.5,13.5,13.0,22.5,22.0,26.0,14.5,7.0,10.0,8.0,12.0,27.5,7.5,18.0,6.0,28.0,12.0,12.0,18.5,19.0,17.0,6.5,16.0,14.0,5.5,21.5,14.0,20.0,20.0,23.0,17.5,23.5,26.5,7.0,7.0,10.0,12.0,22.0,19.5,5.0,21.0,19.0,24.0,26.0,22.5,25.0,23.0,2.5,1.0,7.0,12.0,9.5,14.0,24.5,20.0,12.0,5.0,20.5,15.5,6.5,12.0,12.5,20.0,11.0,16.5,16.5,16.5,28.0,7.5,10.0,23.0,10.0,23.0,1.0,32.0,30.0,8.0,10.0,23.0,6.0,27.0,9.0,24.0,12.0,4.0,11.0,22.0,8.0,6.0,18.0,19.0,21.0,11.0,24.0,9.5,8.0,11.0,6.0,8.0,7.0,6.0,5.5,19.0,20.0,6.0,19.0,11.083333333333334,15.916666666666666,16.95679012345679,14.442760942760943,5.8,21.0,13.4,17.916666666666668,8.6,11.521380471380471,7.0,9.0,15.0,18.0,10.0,4.0,23.0,11.0,20.5,6.0
Oakland Raiders,359.0,6072.0,1015.0,6.0,30.0,7.0,328.0,315.0,524.0,3962.0,20.0,23.0,7.2,186.0,466.0,2110.0,16.0,4.5,110.0,163.0,1358.0,32.0,34.7,15.5,23.79,60.1,3.8,4.4,7.9,6.6,13.1,79.4,25.0,157.0,6.1,4.6,52.12,32.0,264.0,0.0,8.3,43.0,1011.0,1.0,23.5,7503.0,1.0,1.0,8.0,8.0,5.0,5.0,11.0,10.0,10.0,7.0,35.0,31.0,88.6,36.0,36.0,100.0,78.0,3960.0,0.0,50.8,433.0,6201.0,1070.0,5.8,26.0,8.0,369.0,324.0,601.0,4023.0,31.0,18.0,6.3,206.0,430.0,2178.0,15.0,5.1,105.0,120.0,982.0,58.0,35.6,12.8,-101.71,53.9,5.2,3.0,7.1,6.8,13.2,81.3,39.0,239.0,6.0,6.1,-82.79,44.0,593.0,2.0,13.5,47.0,1210.0,1.0,25.7,29.0,21.0,72.4,53.0,52.0,98.1,68.0,0.0,0.0,0.0,16.0,-16.75,-25.3,193.0,5.4,31.4,27.2,149.0,1.79,188.0,5.9,32.9,26.4,154.0,2.05,1.0,0.0,0.0,38.0,0.0,2.0,1.0,1.0,3.0,0.0,0.0,0.0,0.0,4119.0,-4.0,-74.0,-129.0,0.5408866995073892,0.4591133004926108,0.6525032938076416,0.3474967061923584,0.5555555555555556,0.4444444444444444,1.690909090909091,0.5913978494623656,0.0975609756097561,1.7555555555555555,0.5981308411214953,0.4018691588785047,0.6487663280116109,0.3512336719883889,0.6739130434782609,0.32608695652173914,0.15718157181571815,1.392156862745098,0.4375,8.0,28757.0,28952.0,0.8000000000000007,16.0,9.0,17.0,7.5,11.0,16.0,22.0,11.0,20.0,5.5,12.0,7.0,7.0,8.0,7.5,8.0,12.5,7.0,15.5,22.5,7.5,15.0,4.0,17.0,13.5,14.0,24.5,12.0,15.5,17.0,19.5,15.0,22.0,25.5,24.0,24.0,15.5,17.0,5.0,18.5,10.0,8.5,6.5,6.0,17.5,17.5,13.0,16.5,10.0,1.0,18.0,11.0,22.0,18.0,23.0,25.5,26.0,8.5,27.5,32.0,32.0,24.0,4.5,2.0,7.0,31.0,29.0,29.0,29.0,26.0,31.0,15.5,27.0,27.0,31.0,16.5,28.0,15.0,27.0,24.5,32.0,32.0,24.0,24.0,3.0,26.5,15.0,17.5,30.5,11.0,19.5,29.0,29.5,25.0,31.0,29.5,32.0,20.0,23.0,28.0,27.0,13.0,3.5,2.0,31.0,31.0,5.5,7.5,16.5,16.5,16.5,12.0,14.0,25.0,8.0,19.0,14.0,27.0,6.0,11.0,10.5,11.0,22.0,21.0,12.0,16.0,17.0,1.0,31.0,24.0,9.0,14.0,13.0,30.0,26.0,11.0,32.0,12.0,19.5,11.0,21.0,19.5,15.0,20.0,15.0,15.5,27.5,28.0,8.0,27.0,12.5,25.25,18.0,18.636363636363637,15.6,7.5,11.55,22.375,19.6,19.118181818181817,22.0,11.0,29.0,23.0,22.0,15.0,5.0,8.0,29.0,21.0
Chicago Bears,353.0,5026.0,978.0,5.1,29.0,9.0,271.0,268.0,473.0,3011.0,18.0,20.0,5.8,153.0,456.0,2015.0,10.0,4.4,97.0,104.0,800.0,21.0,28.6,14.6,-92.58,56.7,3.8,4.2,7.1,5.9,12.5,73.8,49.0,335.0,4.7,9.4,-53.11,30.0,470.0,2.0,15.7,57.0,1238.0,1.0,21.7,7096.0,0.0,0.0,10.0,10.0,6.0,6.0,10.0,6.0,6.0,6.0,32.0,28.0,87.5,37.0,37.0,100.0,89.0,3903.0,0.0,43.9,341.0,5607.0,1048.0,5.4,31.0,11.0,291.0,383.0,631.0,4065.0,22.0,20.0,6.1,199.0,384.0,1542.0,10.0,4.0,75.0,98.0,719.0,17.0,30.5,14.3,61.1,60.7,3.5,3.2,6.8,6.0,11.2,79.3,33.0,208.0,5.4,5.0,-7.67,41.0,223.0,0.0,5.4,35.0,855.0,0.0,24.4,36.0,30.0,83.3,33.0,33.0,100.0,85.0,0.0,0.0,0.0,26.0,-27.11,57.07,199.0,5.1,25.2,27.0,147.0,1.44,203.0,5.3,27.6,30.8,142.0,1.55,3.0,4.0,0.0,38.0,1.0,1.0,1.0,1.0,3.0,0.0,0.0,0.0,1.0,3346.0,2.0,12.0,-581.0,0.5337423312883436,0.4662576687116564,0.5990847592518902,0.4009152407481098,0.6428571428571429,0.3571428571428571,1.577319587628866,0.6339869281045751,0.07749077490774907,1.6136363636363635,0.6335877862595419,0.3664122137404581,0.7249866238630284,0.27501337613697163,0.6875,0.3125,0.0584192439862543,1.7,0.3461538461538461,44.0,29253.0,28826.0,-3.8000000000000007,17.0,24.0,30.0,21.5,28.0,30.0,27.0,26.0,24.5,23.5,28.5,9.0,9.0,21.5,10.0,27.0,24.0,14.5,24.5,22.5,16.5,22.0,11.5,24.0,26.0,7.0,10.0,7.5,20.5,23.0,28.5,13.5,25.5,9.0,2.5,1.0,2.0,6.0,5.0,28.0,18.0,12.5,11.5,7.0,16.0,16.0,13.0,9.5,12.0,21.5,9.0,24.0,11.5,26.0,16.0,1.5,23.5,18.0,25.5,19.5,10.0,23.0,27.5,29.0,31.0,28.5,14.0,17.0,22.0,15.0,9.5,30.0,31.0,28.0,13.5,13.0,26.5,6.0,5.0,10.0,9.5,3.0,11.0,4.0,17.5,8.5,8.0,7.0,6.0,8.0,8.0,13.0,3.0,21.5,6.0,9.5,2.0,8.0,9.0,12.0,19.0,26.5,25.5,18.5,9.5,9.5,20.0,22.5,16.5,16.5,16.5,12.0,4.0,26.0,7.0,27.0,6.0,17.0,16.0,24.0,21.0,4.0,29.0,3.0,30.0,11.0,22.0,30.0,18.0,25.0,8.0,27.0,27.0,5.0,8.0,16.0,3.0,4.5,31.0,26.0,23.5,22.5,25.0,12.0,28.0,28.0,7.5,10.0,28.5,7.5,21.0,11.666666666666666,12.981481481481481,15.419191919191917,23.0,14.0625,18.53125,11.25,18.7,17.05959595959596,17.0,21.0,9.0,5.0,13.0,31.0,13.0,21.0,7.0,20.0
Cincinnati Bengals,344.0,5118.0,1015.0,5.0,22.0,8.0,285.0,308.0,535.0,3340.0,21.0,14.0,6.0,160.0,455.0,1778.0,10.0,3.9,93.0,99.0,874.0,32.0,32.5,9.6,-34.31,57.6,3.9,2.6,6.6,6.2,11.4,79.6,25.0,167.0,5.6,4.5,13.03,53.0,610.0,1.0,11.5,45.0,1026.0,0.0,22.8,6985.0,0.0,0.0,14.0,14.0,8.0,5.0,16.0,14.0,0.0,0.0,38.0,33.0,86.8,34.0,33.0,97.1,91.0,4023.0,0.0,44.2,323.0,5060.0,1009.0,5.0,22.0,12.0,284.0,319.0,539.0,3385.0,21.0,10.0,5.8,170.0,425.0,1675.0,14.0,3.9,94.0,101.0,878.0,20.0,28.5,11.0,32.41,59.2,3.9,1.9,6.8,6.7,11.5,85.0,45.0,277.0,5.7,7.7,-12.06,38.0,273.0,1.0,7.2,44.0,916.0,0.0,20.8,27.0,22.0,81.5,35.0,35.0,100.0,98.0,0.0,0.0,0.0,17.0,-39.47,28.67,197.0,5.3,26.0,30.1,148.0,1.6,200.0,5.2,25.0,26.1,142.0,1.56,2.0,1.0,0.0,35.0,0.0,1.0,1.0,0.0,1.0,0.0,0.0,0.0,0.0,3507.0,0.0,21.0,58.0,0.5517241379310345,0.4482758620689655,0.6525986713559985,0.34740132864400153,0.6774193548387096,0.3225806451612904,1.7204301075268815,0.58125,0.11228070175438597,1.6923076923076923,0.578790882061447,0.4212091179385529,0.6689723320158103,0.3310276679841897,0.6,0.4,0.07042253521126761,1.7435897435897436,0.4705882352941176,20.0,29156.0,28400.0,4.0,18.0,20.0,17.0,24.0,22.0,20.0,20.0,20.0,15.0,16.5,25.0,10.0,19.0,21.5,27.0,8.0,16.5,17.0,23.0,18.5,23.5,18.0,24.0,16.0,17.5,22.0,5.0,26.5,5.0,9.0,4.0,26.0,1.0,2.0,9.5,7.0,14.0,15.0,21.0,24.0,20.0,5.5,2.5,8.0,20.5,22.5,31.0,7.0,8.0,19.0,23.0,21.0,17.0,13.0,13.0,11.0,9.5,12.5,14.0,14.0,20.0,4.0,4.5,5.0,5.5,13.5,9.0,7.0,16.0,4.5,7.0,13.0,18.0,9.0,10.5,4.0,8.0,14.0,10.0,21.0,7.0,6.0,5.0,15.0,12.0,12.0,8.0,15.5,7.0,17.0,11.5,17.5,17.0,19.0,11.0,23.0,7.0,15.0,11.0,12.0,2.5,5.5,7.0,11.5,12.0,12.5,20.0,32.0,16.5,16.5,16.5,12.0,19.5,24.0,9.0,18.0,15.0,10.0,23.0,2.0,19.5,15.0,18.0,12.0,21.0,23.5,9.5,26.0,14.0,22.0,11.0,19.0,17.0,9.0,9.0,26.0,13.0,7.5,24.5,21.5,6.0,21.0,20.0,14.0,5.0,27.0,3.5,4.0,7.0,9.0,18.833333333333332,9.333333333333334,11.537037037037038,13.388888888888888,16.6,18.4375,17.51875,10.416666666666666,12.4,12.894444444444444,11.0,18.0,7.5,3.0,7.0,17.0,19.0,20.0,6.0,12.0
Minnesota Vikings,340.0,5275.0,1007.0,5.2,26.0,9.0,297.0,286.0,510.0,2957.0,20.0,17.0,5.3,159.0,448.0,2318.0,18.0,5.2,118.0,109.0,908.0,20.0,31.7,13.2,-28.14,56.1,3.9,3.3,6.4,5.7,11.4,74.6,49.0,298.0,4.6,8.8,-64.13,33.0,277.0,0.0,8.4,53.0,1428.0,1.0,26.9,7312.0,0.0,0.0,7.0,7.0,8.0,7.0,10.0,6.0,3.0,2.0,28.0,22.0,78.6,39.0,38.0,97.4,77.0,3517.0,0.0,45.7,449.0,5731.0,1027.0,5.6,23.0,15.0,332.0,367.0,538.0,4019.0,34.0,8.0,6.8,213.0,439.0,1712.0,10.0,3.9,92.0,97.0,834.0,27.0,41.1,10.8,-81.04,68.2,6.3,1.5,8.1,8.7,11.9,107.6,50.0,342.0,7.4,8.5,-136.38,43.0,532.0,1.0,12.4,57.0,1403.0,1.0,24.6,35.0,32.0,91.4,49.0,49.0,100.0,67.0,0.0,0.0,0.0,20.0,43.75,50.98,189.0,5.5,27.9,29.1,146.0,1.76,185.0,5.7,30.9,30.0,163.0,2.18,0.0,0.0,0.0,39.0,0.0,0.0,1.0,1.0,3.0,0.0,1.0,0.0,1.0,3255.0,-3.0,-109.0,-456.0,0.5551142005958292,0.4448857994041708,0.560568720379147,0.4394312796208529,0.5263157894736842,0.4736842105263158,1.347457627118644,0.7421383647798742,0.06734006734006734,1.2307692307692308,0.572541382667965,0.4274586173320351,0.7012737742104345,0.29872622578956554,0.7727272727272727,0.2272727272727273,0.08132530120481928,2.0769230769230766,0.45,2.0,27594.0,30155.0,-0.8999999999999986,19.0,18.0,20.0,18.5,18.0,27.0,24.0,28.0,20.0,27.5,26.5,13.0,4.0,4.0,2.0,28.5,18.0,5.0,27.5,18.5,27.0,24.5,24.0,22.0,29.0,20.5,1.5,31.5,1.5,1.0,2.0,31.0,19.0,24.0,24.0,23.0,5.0,2.0,5.0,2.0,14.0,23.0,26.5,24.5,14.5,15.0,30.0,18.0,18.0,13.5,24.0,28.0,20.0,24.0,28.0,30.0,19.0,18.0,21.5,23.0,23.0,20.0,27.5,26.0,25.0,22.0,31.0,21.0,18.0,21.5,24.0,27.0,16.5,26.0,32.0,25.0,30.0,19.0,11.0,10.0,7.0,20.0,30.0,13.5,31.0,32.0,30.0,32.0,13.0,32.0,30.5,10.5,11.5,23.5,26.0,23.0,27.0,27.5,30.0,28.0,20.5,25.0,29.5,30.0,28.5,28.5,20.0,5.5,16.5,16.5,16.5,12.0,17.0,22.0,11.0,30.0,3.0,28.5,4.5,29.0,32.0,18.0,15.0,9.0,24.0,3.0,30.0,17.0,1.0,28.0,5.0,18.0,29.0,26.0,31.0,2.0,4.0,17.0,16.0,19.0,9.5,24.5,16.0,26.0,20.0,11.0,22.5,23.0,26.0,30.0,17.25,21.416666666666668,18.728395061728396,19.16835016835017,22.0,6.75,14.375,19.5,23.6,21.384175084175084,26.0,17.0,23.0,26.0,26.0,28.0,3.0,15.0,25.0,25.0
Miami Dolphins,329.0,5078.0,990.0,5.1,25.0,12.0,287.0,280.0,469.0,3091.0,20.0,13.0,5.9,166.0,469.0,1987.0,11.0,4.2,89.0,85.0,779.0,32.0,32.8,12.8,-37.03,59.7,4.3,2.8,7.3,6.9,12.2,84.9,52.0,334.0,5.6,10.0,4.5,46.0,526.0,0.0,11.4,39.0,942.0,0.0,24.2,6845.0,0.0,0.0,15.0,14.0,7.0,6.0,13.0,11.0,4.0,2.0,39.0,33.0,84.6,32.0,32.0,100.0,78.0,3810.0,0.0,48.8,313.0,5522.0,1043.0,5.3,19.0,3.0,310.0,350.0,590.0,3992.0,24.0,16.0,6.3,198.0,412.0,1530.0,8.0,3.7,88.0,112.0,975.0,24.0,29.7,8.7,10.24,59.3,4.1,2.7,7.2,6.8,12.1,83.7,41.0,241.0,5.9,6.5,-31.18,46.0,442.0,0.0,9.6,41.0,937.0,0.0,22.9,33.0,26.0,78.8,31.0,31.0,100.0,95.0,0.0,0.0,0.0,28.0,-37.96,31.65,195.0,5.3,25.9,29.5,151.0,1.62,195.0,5.5,28.3,28.1,147.0,1.55,0.0,1.0,1.0,33.0,0.0,1.0,0.0,0.0,1.0,0.0,1.0,0.0,2.0,3425.0,-6.0,16.0,-444.0,0.5262626262626262,0.4737373737373738,0.6087042142575817,0.3912957857424183,0.6451612903225806,0.3548387096774194,1.8651685393258424,0.536144578313253,0.11149825783972124,1.738095238095238,0.6049856184084372,0.3950143815915628,0.7229264759145237,0.27707352408547625,0.75,0.25,0.07741935483870968,1.9459459459459456,0.42857142857142855,12.0,29445.0,28665.0,1.3999999999999986,20.0,22.0,27.0,21.5,19.0,28.0,28.5,23.0,20.0,20.0,23.0,6.0,11.0,19.5,16.5,8.0,15.0,21.5,18.0,11.5,13.5,13.0,13.0,12.0,17.5,26.5,32.0,16.0,11.5,16.0,13.5,21.0,5.5,6.0,24.0,8.0,22.0,22.0,21.0,13.0,25.0,3.5,2.5,13.5,24.0,24.0,13.0,16.5,13.0,3.0,30.0,23.0,24.0,22.0,14.0,19.0,18.0,24.5,9.5,4.0,8.0,18.5,30.0,28.0,32.0,17.0,6.0,15.0,21.0,12.0,15.5,23.0,25.0,25.0,17.5,16.5,25.0,11.0,3.0,4.0,3.0,12.0,9.0,11.0,13.0,13.5,17.0,17.5,17.0,15.5,17.5,26.0,28.0,27.0,22.0,9.5,15.5,13.0,13.0,12.0,11.0,20.5,15.5,6.5,5.5,6.0,20.0,31.0,16.5,16.5,16.5,12.0,13.0,27.0,6.0,26.0,7.0,15.5,17.5,3.0,12.0,9.0,24.0,4.0,29.0,4.0,29.0,21.0,3.0,18.0,15.0,20.0,19.0,11.0,13.0,23.0,12.0,10.0,24.5,23.5,7.0,17.0,19.0,10.0,12.5,23.0,14.5,13.0,16.0,7.5,19.25,13.75,11.635802469135802,15.173400673400671,17.7,16.1875,16.94375,15.333333333333334,16.5,15.836700336700336,15.0,19.5,12.0,4.0,12.0,21.0,16.0,19.0,11.0,17.0
Tennessee Titans,325.0,5361.0,984.0,5.4,22.0,8.0,281.0,353.0,584.0,3923.0,22.0,14.0,6.5,185.0,376.0,1438.0,8.0,3.8,71.0,104.0,960.0,25.0,31.4,11.7,-0.23,60.4,3.8,2.4,7.0,6.7,11.7,84.4,24.0,190.0,6.1,3.9,51.28,47.0,490.0,1.0,10.4,32.0,832.0,1.0,26.0,6875.0,0.0,0.0,5.0,5.0,10.0,9.0,10.0,9.0,7.0,6.0,32.0,29.0,90.6,34.0,34.0,100.0,86.0,3747.0,0.0,43.6,317.0,5682.0,1080.0,5.3,23.0,12.0,324.0,369.0,591.0,3629.0,21.0,11.0,5.9,187.0,461.0,2053.0,10.0,4.5,111.0,99.0,812.0,26.0,31.0,12.3,-2.54,62.4,3.6,1.9,6.4,6.3,10.3,85.1,28.0,180.0,5.7,4.5,-36.84,36.0,221.0,0.0,6.1,30.0,680.0,0.0,22.7,28.0,27.0,96.4,32.0,32.0,100.0,83.0,0.0,0.0,0.0,17.0,-51.37,27.52,188.0,5.4,28.5,27.4,142.0,1.58,187.0,5.9,30.3,25.7,165.0,1.59,0.0,1.0,1.0,34.0,0.0,0.0,0.0,0.0,3.0,0.0,0.0,0.0,0.0,4113.0,1.0,8.0,-321.0,0.6178861788617886,0.38211382113821135,0.7317664614810669,0.26823353851893306,0.7333333333333333,0.2666666666666667,2.605633802816901,0.3837837837837838,0.08896797153024913,1.842105263157895,0.5731481481481482,0.4268518518518518,0.6386835621260121,0.361316437873988,0.6774193548387096,0.3225806451612904,0.08024691358024691,1.4222222222222225,0.4705882352941176,12.0,26696.0,30855.0,1.6999999999999993,21.5,17.0,29.0,15.0,24.0,11.0,8.0,12.0,11.5,14.0,13.0,30.0,31.0,27.0,29.5,22.0,19.0,30.5,14.0,22.5,18.0,14.0,18.0,14.0,13.5,20.5,5.0,24.5,31.0,30.0,31.0,26.0,3.5,7.0,9.5,14.5,29.0,27.0,5.0,5.0,23.0,12.5,9.0,4.0,20.5,20.0,13.0,12.0,14.0,23.5,20.5,12.0,14.5,20.0,17.0,19.0,9.5,12.5,14.0,19.5,25.0,15.0,2.5,9.5,3.0,11.5,8.0,18.5,31.0,12.0,20.0,28.0,26.0,14.0,10.5,6.5,17.0,23.0,24.0,10.0,22.5,18.0,12.0,26.0,24.0,10.0,3.5,9.5,1.5,18.0,11.5,15.5,9.0,16.5,5.0,9.5,4.0,6.5,6.0,12.0,8.0,9.5,18.0,31.0,7.5,8.0,20.0,20.0,16.5,16.5,16.5,12.0,19.5,3.0,30.0,5.0,28.0,6.0,27.0,20.0,4.0,17.0,16.0,25.0,8.0,15.0,18.0,19.0,28.0,2.0,31.0,16.0,14.0,14.0,16.0,30.0,14.0,19.5,19.5,17.0,20.0,26.5,21.0,31.0,9.5,13.0,27.5,19.0,4.0,10.5,19.25,16.0,11.037037037037036,15.828282828282829,11.45,27.3125,19.38125,19.0,18.4,17.114141414141415,18.0,19.5,16.0,2.0,17.0,10.0,32.0,25.0,23.0,19.0
Pittsburgh Steelers,325.0,5957.0,1015.0,5.9,28.0,13.0,341.0,341.0,539.0,4054.0,21.0,15.0,7.0,221.0,434.0,1903.0,13.0,4.4,96.0,101.0,854.0,24.0,33.9,16.7,68.04,63.3,3.9,2.8,8.0,7.6,12.7,89.7,42.0,279.0,6.5,7.2,95.51,33.0,347.0,1.0,10.5,35.0,877.0,0.0,25.1,7468.0,2.0,2.0,8.0,8.0,8.0,6.0,11.0,6.0,2.0,1.0,31.0,23.0,74.2,36.0,36.0,100.0,60.0,2683.0,1.0,44.7,227.0,4348.0,964.0,4.5,15.0,4.0,264.0,289.0,530.0,2751.0,15.0,11.0,4.9,156.0,399.0,1597.0,7.0,4.0,82.0,96.0,777.0,26.0,26.0,8.3,35.32,54.5,2.8,2.1,5.6,5.3,10.3,71.7,35.0,230.0,4.5,6.2,3.08,29.0,245.0,0.0,8.4,43.0,1018.0,0.0,23.7,27.0,22.0,81.5,21.0,21.0,100.0,87.0,0.0,0.0,0.0,16.0,-17.78,25.84,168.0,6.2,35.4,26.8,186.0,1.83,169.0,5.9,25.6,27.6,156.0,1.3,1.0,0.0,0.0,36.0,0.0,0.0,2.0,1.0,0.0,0.0,1.0,0.0,0.0,4333.0,-13.0,98.0,1609.0,0.5724137931034483,0.4275862068965517,0.6805438979352023,0.3194561020647977,0.6176470588235294,0.38235294117647056,2.302083333333333,0.4343891402714932,0.07038123167155426,1.8181818181818181,0.5860995850622407,0.4139004149377593,0.6327046918123275,0.3672953081876725,0.6818181818181818,0.31818181818181823,0.09848484848484848,1.4,0.8125,10.0,31248.0,26364.0,-0.8000000000000007,21.5,12.0,17.0,10.5,9.0,13.0,19.0,10.0,15.0,8.0,6.0,19.0,14.0,15.0,10.0,24.0,14.0,16.0,6.0,18.5,5.0,8.0,9.0,10.0,10.0,32.0,30.5,24.5,17.5,20.0,18.0,24.0,19.0,14.0,9.5,13.0,27.0,25.0,21.0,8.0,11.0,14.5,23.5,31.5,17.5,17.5,13.0,28.0,28.0,18.0,31.0,9.0,28.5,1.0,7.0,23.0,21.0,27.0,17.5,16.5,19.0,29.0,23.5,24.0,23.0,17.0,1.0,1.0,3.0,1.0,1.0,6.0,13.0,1.0,2.5,1.0,2.0,8.0,8.0,2.0,9.5,18.0,2.0,7.0,5.0,2.0,1.0,1.0,1.5,4.0,1.5,8.5,6.0,6.0,8.0,9.5,12.0,14.0,14.0,12.0,16.0,5.5,7.0,11.5,1.5,1.5,20.0,25.5,16.5,16.5,16.5,28.0,31.0,17.0,16.0,13.0,20.0,22.0,11.0,27.0,7.0,13.0,20.0,26.0,7.0,14.0,19.0,9.0,29.5,12.0,21.0,9.0,9.0,8.0,6.0,13.0,15.0,32.0,3.5,5.0,25.0,1.0,14.0,2.0,19.0,1.0,27.5,6.5,13.0,3.0,13.583333333333334,7.583333333333333,16.425925925925927,12.176767676767678,10.85,16.25,13.55,15.666666666666666,11.5,11.83838383838384,9.0,13.0,4.0,16.0,3.0,9.0,17.0,12.0,13.0,10.0
Seattle Seahawks,321.0,4861.0,1003.0,4.8,23.0,9.0,265.0,299.0,509.0,3105.0,15.0,14.0,5.6,153.0,444.0,1756.0,15.0,4.0,89.0,138.0,1047.0,23.0,27.8,11.6,-73.36,58.7,2.9,2.8,6.8,6.1,11.5,77.6,50.0,339.0,5.0,8.9,-12.21,42.0,464.0,0.0,11.0,46.0,1142.0,0.0,24.8,6833.0,2.0,2.0,6.0,5.0,10.0,9.0,8.0,7.0,4.0,2.0,30.0,25.0,83.3,34.0,34.0,100.0,95.0,4431.0,0.0,46.6,315.0,5315.0,1049.0,5.1,31.0,9.0,310.0,324.0,543.0,3518.0,18.0,22.0,6.1,174.0,473.0,1797.0,10.0,3.8,96.0,96.0,907.0,40.0,28.6,14.8,54.83,59.7,3.3,4.1,6.9,5.7,11.6,74.8,33.0,232.0,5.0,5.7,23.44,47.0,541.0,2.0,11.5,48.0,1249.0,1.0,26.0,37.0,28.0,75.7,32.0,31.0,96.9,81.0,0.0,0.0,0.0,22.0,-39.1,37.74,198.0,5.2,24.4,31.3,138.0,1.44,196.0,5.5,27.1,26.8,158.0,1.43,0.0,4.0,1.0,35.0,0.0,1.0,1.0,1.0,1.0,0.0,1.0,0.0,0.0,3444.0,8.0,6.0,-454.0,0.5573280159521435,0.4426719840478565,0.63875745731331,0.3612425426866901,0.5,0.5,1.7191011235955056,0.5816993464052288,0.08679245283018867,1.7,0.5490943755958055,0.4509056244041945,0.6619002822201318,0.33809971777986825,0.6428571428571429,0.3571428571428571,0.12903225806451613,1.8157894736842104,0.4090909090909091,32.0,27324.0,30968.0,4.5,23.0,28.0,21.0,28.0,30.0,23.5,25.0,22.0,28.0,25.5,28.5,15.0,21.0,10.5,23.0,25.5,25.0,21.5,20.0,26.5,20.0,19.5,21.5,20.0,21.0,7.0,21.0,4.0,20.5,18.0,23.5,3.0,9.0,10.0,24.0,10.5,11.5,8.0,21.0,10.0,26.0,16.5,16.0,16.0,20.5,20.0,13.0,4.0,3.0,8.0,7.5,22.0,5.5,23.0,18.0,4.0,13.0,18.0,14.0,31.0,30.0,14.0,29.0,30.0,27.5,17.0,7.0,9.0,23.5,7.5,15.5,15.5,19.0,11.0,6.5,13.0,10.5,25.0,15.0,10.0,4.5,30.0,6.0,18.0,14.0,5.5,11.5,5.0,8.0,6.0,6.0,8.5,20.5,28.0,27.0,29.5,20.5,21.0,24.0,28.0,29.0,28.5,20.5,4.0,7.5,6.0,1.0,17.5,16.5,16.5,16.5,12.0,11.0,20.0,13.0,21.0,12.0,31.0,2.0,21.0,17.0,22.0,11.0,15.0,18.0,19.0,14.0,2.0,8.5,23.0,10.0,24.0,20.0,6.0,4.0,25.0,7.0,6.0,28.5,29.5,2.0,30.0,25.0,29.0,4.0,25.5,14.5,9.0,10.0,4.0,23.75,9.333333333333334,15.790123456790125,16.33670033670034,20.3,17.5625,18.93125,9.416666666666666,15.9,16.11835016835017,16.0,26.0,7.5,13.0,18.0,25.0,18.0,23.0,3.0,16.0
Arizona Cardinals,312.0,5192.0,993.0,5.2,32.0,9.0,286.0,307.0,550.0,3567.0,21.0,23.0,5.9,175.0,389.0,1625.0,12.0,4.2,83.0,106.0,1004.0,28.0,26.1,15.6,-44.97,55.8,3.8,4.2,7.2,6.1,12.9,73.9,54.0,387.0,4.9,8.9,-29.51,46.0,696.0,4.0,15.1,52.0,1246.0,0.0,24.0,7521.0,0.0,0.0,9.0,9.0,6.0,4.0,7.0,5.0,2.0,1.0,24.0,19.0,79.2,33.0,33.0,100.0,92.0,4141.0,0.0,45.0,348.0,5682.0,1095.0,5.2,19.0,9.0,333.0,340.0,578.0,3696.0,17.0,10.0,6.0,174.0,475.0,1986.0,15.0,4.2,118.0,122.0,950.0,41.0,32.8,9.3,-0.21,58.8,2.9,1.7,6.9,6.7,11.8,82.5,42.0,304.0,5.8,6.8,-33.2,50.0,610.0,1.0,12.2,52.0,1300.0,0.0,25.0,48.0,35.0,72.9,33.0,33.0,100.0,92.0,0.0,0.0,0.0,24.0,-9.59,11.67,199.0,5.1,26.0,25.6,138.0,1.45,204.0,5.6,27.7,31.0,153.0,1.61,0.0,0.0,0.0,37.0,0.0,2.0,0.0,0.0,1.0,0.0,0.0,0.0,3.0,3954.0,-13.0,-36.0,-490.0,0.6082578046324271,0.3917421953675729,0.6870184899845917,0.3129815100154083,0.6363636363636364,0.3636363636363637,2.108433734939759,0.4742857142857143,0.0979020979020979,1.7142857142857142,0.5662100456621004,0.4337899543378996,0.6504751847940866,0.3495248152059134,0.53125,0.46875,0.12312312312312312,1.6428571428571428,0.375,0.0,27462.0,31212.0,-5.399999999999999,24.0,19.0,24.5,18.5,20.5,21.0,15.0,17.0,15.0,20.0,18.5,28.0,24.0,17.0,16.5,17.0,26.0,25.0,29.0,22.5,15.0,19.5,7.0,23.0,22.5,26.5,21.0,26.5,8.0,4.0,11.5,28.5,5.5,1.0,1.0,2.0,6.5,4.0,21.0,14.5,9.0,31.5,30.5,22.5,23.0,22.5,13.0,5.5,5.0,17.0,26.0,15.0,28.5,25.0,21.0,31.5,28.0,18.0,27.5,21.0,26.0,25.5,31.0,31.0,27.5,28.5,17.0,18.5,32.0,10.0,25.0,21.5,22.0,17.0,5.0,10.0,10.5,26.0,21.0,24.5,15.0,31.0,17.0,27.0,11.0,3.0,11.5,15.5,9.5,13.0,15.0,30.5,25.0,31.0,32.0,23.0,25.0,24.5,28.0,12.0,23.0,32.0,32.0,3.0,9.5,9.5,20.0,29.0,16.5,16.5,16.5,12.0,7.5,6.0,27.0,12.0,21.0,18.5,14.5,10.0,15.0,19.0,14.0,20.0,13.0,30.0,3.0,3.0,21.0,15.0,18.0,22.0,23.0,13.0,14.0,7.0,21.0,4.5,31.0,21.5,30.0,30.0,23.0,28.0,30.0,29.5,19.0,11.5,30.5,12.5,21.333333333333332,18.666666666666668,17.271604938271608,19.25589225589226,17.45,21.1875,19.31875,17.333333333333332,26.5,22.87794612794613,29.0,23.0,19.0,19.0,28.0,20.0,25.0,24.0,16.5,29.0
Denver Broncos,309.0,5066.0,1017.0,5.0,30.0,17.0,286.0,217.0,429.0,2434.0,20.0,13.0,5.2,130.0,546.0,2632.0,11.0,4.8,129.0,101.0,843.0,27.0,24.5,14.2,-93.02,50.6,4.7,3.0,6.3,5.9,12.5,73.5,42.0,274.0,4.8,8.9,-68.25,47.0,596.0,2.0,12.7,39.0,956.0,0.0,24.5,6906.0,0.0,0.0,6.0,5.0,8.0,8.0,7.0,3.0,4.0,3.0,25.0,19.0,76.0,30.0,30.0,100.0,101.0,4783.0,0.0,47.4,390.0,5725.0,1063.0,5.4,18.0,9.0,315.0,333.0,534.0,3704.0,24.0,9.0,6.4,182.0,488.0,2021.0,11.0,4.1,101.0,99.0,845.0,32.0,33.0,7.8,-47.98,62.4,4.5,1.7,7.5,7.6,12.0,93.1,41.0,283.0,6.6,7.1,-71.37,51.0,585.0,1.0,11.5,20.0,491.0,0.0,24.6,39.0,32.0,82.1,40.0,40.0,100.0,92.0,0.0,0.0,0.0,30.0,-19.17,13.07,204.0,5.1,24.8,26.7,140.0,1.34,206.0,5.3,27.7,28.3,149.0,1.69,0.0,3.0,0.0,36.0,3.0,6.0,0.0,2.0,4.0,0.0,0.0,0.0,1.0,2708.0,-12.0,-81.0,-659.0,0.4631268436578171,0.5368731563421829,0.4804579549940782,0.5195420450059218,0.6451612903225806,0.3548387096774194,1.007751937984496,0.9923076923076924,0.0944055944055944,1.3125,0.5409219190968956,0.4590780809031044,0.6469868995633188,0.3530131004366812,0.6857142857142857,0.3142857142857143,0.1015873015873016,1.829268292682927,0.5666666666666667,18.0,28560.0,30694.0,-1.6000000000000014,25.0,23.0,14.5,24.0,20.5,32.0,32.0,31.0,20.0,29.0,31.0,1.5,1.0,19.5,6.0,19.0,27.0,4.0,32.0,9.0,28.0,22.0,11.5,26.0,24.0,28.5,21.0,29.0,11.5,7.5,10.0,28.5,3.5,3.0,2.5,3.5,22.0,21.0,21.0,11.5,22.0,29.0,30.5,27.5,25.0,25.0,13.0,2.0,1.0,6.0,32.0,31.0,26.5,27.0,25.0,14.0,26.0,32.0,9.5,16.5,13.0,22.0,23.5,23.0,27.5,19.0,24.0,20.0,27.0,15.0,19.0,18.5,14.0,18.0,17.5,20.0,14.0,27.0,22.0,16.0,12.0,25.5,18.0,20.5,24.0,20.5,21.5,28.0,16.0,28.0,27.0,15.5,14.0,32.0,30.0,23.0,20.5,2.0,1.0,12.0,20.5,30.0,29.5,15.0,22.5,22.5,20.0,29.0,16.5,16.5,16.5,12.0,26.0,32.0,1.0,32.0,1.0,15.5,17.5,15.0,31.0,24.0,9.0,23.0,10.0,12.5,20.5,8.0,5.0,32.0,1.0,28.0,30.0,20.0,24.0,14.0,19.0,1.0,31.0,27.0,26.0,28.0,27.0,21.0,23.0,31.0,7.5,11.5,17.0,16.0,21.583333333333332,20.583333333333332,15.382716049382717,19.52861952861953,22.15,10.5625,16.35625,18.333333333333332,24.5,22.014309764309765,28.0,24.0,20.0,11.0,29.0,29.0,8.0,18.0,22.0,28.0
Washington Redskins,288.0,5387.0,1032.0,5.2,35.0,11.0,312.0,346.0,591.0,3773.0,19.0,24.0,6.0,204.0,400.0,1614.0,8.0,4.0,79.0,91.0,897.0,29.0,30.9,18.6,-43.52,58.5,3.2,4.1,6.9,5.7,11.7,73.3,41.0,285.0,4.9,6.5,-14.58,37.0,328.0,0.0,8.9,56.0,1239.0,0.0,22.1,7234.0,0.0,0.0,15.0,14.0,9.0,5.0,11.0,8.0,6.0,4.0,41.0,31.0,75.6,26.0,25.0,96.2,66.0,2842.0,0.0,43.1,367.0,5437.0,988.0,5.5,21.0,8.0,295.0,308.0,509.0,3553.0,22.0,13.0,6.5,180.0,438.0,1884.0,15.0,4.3,95.0,123.0,1006.0,20.0,37.4,10.5,-24.19,60.5,4.3,2.6,7.5,7.2,12.4,87.4,41.0,251.0,6.2,7.5,-56.02,34.0,255.0,0.0,7.5,36.0,749.0,0.0,20.8,41.0,34.0,82.9,38.0,37.0,97.4,70.0,0.0,0.0,0.0,25.0,-22.34,18.43,188.0,5.7,28.6,29.1,155.0,1.5,190.0,5.4,28.6,30.7,152.0,1.9,0.0,1.0,0.0,28.0,1.0,2.0,0.0,1.0,0.0,0.0,0.0,0.0,0.0,4058.0,-14.0,-79.0,-50.0,0.6124031007751938,0.3875968992248062,0.7003898273621681,0.29961017263783185,0.7037037037037037,0.2962962962962963,2.5822784810126582,0.3872549019607843,0.09294871794871797,1.725,0.5566801619433198,0.4433198380566802,0.65348537796579,0.34651462203421,0.5945945945945946,0.4054054054054054,0.06779661016949153,1.744186046511628,0.44,6.0,29140.0,28880.0,-1.599999999999998,26.0,16.0,9.0,18.5,15.5,12.0,5.0,14.0,23.0,16.5,10.0,25.0,25.0,27.0,23.0,14.5,21.0,26.5,21.0,25.0,19.0,24.5,18.0,27.0,22.5,23.5,24.5,22.0,11.5,14.0,7.0,22.0,15.0,17.0,24.0,21.0,3.0,5.0,21.0,27.0,16.0,2.0,6.5,29.0,26.0,26.0,32.0,26.5,25.0,25.0,25.0,14.0,30.5,16.0,24.0,27.5,30.0,22.5,29.5,7.5,21.0,31.0,21.5,25.0,19.0,26.5,21.0,13.0,10.0,17.5,12.0,11.0,10.0,12.0,13.5,22.0,13.0,18.0,18.0,24.5,17.5,6.0,28.0,16.0,15.5,17.0,21.5,24.0,24.5,24.0,22.0,32.0,31.0,13.0,9.0,9.5,9.5,10.5,7.0,12.0,2.5,31.0,31.0,17.0,19.5,17.0,4.0,9.0,16.5,16.5,16.5,12.0,15.0,5.0,28.0,9.0,24.0,8.0,25.0,17.0,14.0,20.0,13.0,18.0,15.0,25.0,8.0,27.0,13.0,4.0,29.0,21.0,21.0,19.0,18.0,15.0,17.0,19.5,9.5,16.0,9.5,13.0,22.0,15.0,22.0,19.0,11.0,15.0,27.0,24.0,21.166666666666668,18.166666666666668,17.419753086419753,19.053872053872055,17.1,25.125,21.1125,17.916666666666668,21.5,20.276936026936028,24.0,22.0,18.0,20.0,25.0,19.0,28.0,27.0,20.5,24.0
Tampa Bay Buccaneers,287.0,5108.0,966.0,5.3,40.0,16.0,277.0,365.0,588.0,3650.0,17.0,24.0,5.9,180.0,346.0,1458.0,9.0,4.2,74.0,123.0,1007.0,23.0,28.7,20.4,-94.67,62.1,2.9,4.1,6.5,5.3,10.5,73.6,32.0,188.0,4.7,5.2,-58.95,29.0,231.0,0.0,8.0,46.0,1024.0,0.0,22.3,6539.0,0.0,0.0,5.0,5.0,6.0,6.0,14.0,13.0,3.0,2.0,28.0,26.0,92.9,23.0,23.0,100.0,67.0,3023.0,0.0,45.1,494.0,6311.0,1002.0,6.3,24.0,10.0,356.0,301.0,481.0,3814.0,30.0,14.0,7.6,188.0,498.0,2497.0,26.0,5.0,135.0,95.0,786.0,33.0,42.9,13.0,-160.0,62.6,6.2,2.9,8.2,8.2,13.2,97.2,23.0,148.0,7.5,4.6,-140.77,36.0,266.0,0.0,7.4,25.0,570.0,1.0,22.8,29.0,23.0,79.3,60.0,59.0,98.3,58.0,0.0,0.0,0.0,30.0,-31.99,-22.28,181.0,5.5,28.0,27.0,154.0,1.44,184.0,5.6,34.3,31.0,162.0,2.51,1.0,3.0,0.0,30.0,2.0,7.0,1.0,2.0,2.0,0.0,0.0,0.0,0.0,3838.0,-16.0,-207.0,-1203.0,0.6418219461697723,0.3581780538302277,0.7145653876272514,0.2854346123727486,0.6538461538461539,0.3461538461538461,2.4324324324324325,0.4111111111111111,0.08303249097472924,1.5476190476190474,0.5029940119760479,0.4970059880239521,0.6043416257328474,0.39565837426715256,0.5357142857142857,0.4642857142857143,0.09269662921348316,1.64,0.5333333333333333,26.0,27874.0,29808.0,-4.0,27.0,21.0,31.0,16.0,26.5,7.5,7.0,16.0,26.0,20.0,15.5,32.0,30.0,24.0,16.5,25.5,23.0,29.0,8.0,26.5,25.5,30.5,30.5,25.0,26.0,18.0,16.0,20.5,32.0,32.0,30.0,17.0,27.5,27.0,24.0,25.0,11.5,16.0,21.0,26.0,28.0,23.0,15.0,2.0,29.0,29.0,13.0,24.5,23.0,16.0,16.0,17.0,32.0,31.0,31.0,7.5,32.0,30.5,29.5,29.0,27.0,32.0,10.0,8.0,11.0,26.5,32.0,30.0,13.5,31.5,29.0,9.5,4.0,21.0,29.5,31.5,18.0,28.0,32.0,32.0,30.0,27.0,32.0,31.0,26.5,31.0,31.0,30.0,30.5,29.0,32.0,7.0,7.0,16.5,10.0,9.5,8.0,3.5,2.0,28.0,9.0,13.0,11.0,8.0,32.0,32.0,7.0,2.5,16.5,16.5,16.5,12.0,23.0,2.0,31.0,7.0,26.0,13.0,20.0,22.0,24.0,29.0,4.0,29.0,4.0,29.0,4.0,11.0,22.0,8.0,25.0,29.0,28.0,32.0,32.0,19.0,31.0,25.0,16.0,18.0,23.5,14.0,25.0,25.0,29.0,10.0,19.0,29.0,30.5,32.0,23.833333333333332,28.416666666666668,14.481481481481481,22.94949494949495,18.85,27.0,22.925,23.5,29.6,26.27474747474748,31.0,27.0,32.0,8.0,30.0,24.0,31.0,30.0,30.0,31.0
Jacksonville Jaguars,243.0,4149.0,1002.0,4.1,23.0,8.0,251.0,240.0,469.0,2179.0,12.0,15.0,4.2,122.0,489.0,1970.0,9.0,4.0,103.0,77.0,680.0,26.0,22.7,11.3,-154.34,51.2,2.6,3.2,5.4,4.4,10.5,62.2,44.0,331.0,3.4,8.6,-107.82,34.0,148.0,0.0,4.4,47.0,1055.0,0.0,22.4,5668.0,1.0,1.0,5.0,5.0,5.0,5.0,8.0,7.0,6.0,5.0,25.0,23.0,92.0,24.0,24.0,100.0,99.0,4147.0,0.0,41.9,329.0,5008.0,979.0,5.1,28.0,11.0,268.0,326.0,513.0,3341.0,21.0,17.0,6.1,175.0,435.0,1667.0,14.0,3.8,73.0,105.0,895.0,20.0,29.2,13.3,53.14,63.5,4.1,3.3,6.9,6.3,10.9,83.7,31.0,213.0,5.5,5.7,-16.58,48.0,333.0,0.0,6.9,26.0,632.0,0.0,24.3,29.0,22.0,75.9,36.0,35.0,97.2,89.0,0.0,0.0,0.0,27.0,-46.04,69.01,194.0,5.3,20.8,28.8,149.0,1.11,195.0,5.2,25.6,29.8,148.0,1.59,3.0,0.0,1.0,25.0,0.0,1.0,0.0,2.0,0.0,0.0,1.0,0.0,2.0,2510.0,5.0,-86.0,-859.0,0.5119760479041916,0.4880239520958084,0.5251867919980718,0.4748132080019282,0.5714285714285714,0.4285714285714286,1.1844660194174756,0.8442622950819673,0.10358565737051792,1.35,0.5556690500510725,0.4443309499489275,0.667132587859425,0.332867412140575,0.6,0.4,0.07462686567164177,1.8157894736842104,0.2962962962962963,24.0,28906.0,28860.0,-1.0,28.5,32.0,22.0,32.0,32.0,31.0,28.5,32.0,31.0,32.0,32.0,4.0,12.0,24.0,23.0,20.0,30.0,9.0,31.0,30.0,32.0,32.0,30.5,32.0,32.0,11.0,10.0,14.0,25.5,21.0,23.5,12.0,17.0,31.0,24.0,31.0,9.0,13.0,21.0,25.0,31.0,29.0,23.5,3.0,27.5,27.5,13.0,3.0,4.0,31.0,14.5,32.0,9.0,29.0,26.0,9.5,13.0,12.5,17.5,3.0,3.0,11.0,25.5,27.0,24.0,20.0,11.0,6.0,8.0,7.5,3.0,17.0,11.0,8.0,10.5,13.0,12.0,16.5,9.0,21.0,4.5,6.0,7.0,2.5,29.0,13.5,11.5,9.5,4.0,15.5,9.0,20.0,18.0,29.5,18.0,9.5,6.0,5.0,5.0,12.0,18.0,13.0,7.0,5.0,14.0,12.5,2.0,27.0,16.5,16.5,16.5,12.0,2.0,29.0,4.0,31.0,2.0,24.0,9.0,8.0,30.0,21.0,12.0,13.0,20.0,23.5,9.5,22.0,8.5,31.0,2.0,31.0,32.0,7.0,11.0,28.0,2.0,11.0,24.5,32.0,13.0,19.5,30.0,19.0,21.0,23.0,3.5,6.5,25.0,10.5,26.75,8.083333333333334,18.40740740740741,17.68686868686869,25.85,15.0625,20.45625,14.166666666666666,20.8,19.243434343434345,23.0,32.0,5.0,25.0,20.0,32.0,15.0,26.0,10.0,23.0
Indianapolis Colts,243.0,4589.0,951.0,4.8,29.0,15.0,258.0,302.0,534.0,2995.0,14.0,14.0,5.3,170.0,382.0,1594.0,8.0,4.2,69.0,76.0,549.0,19.0,24.2,15.6,-97.92,56.6,2.6,2.6,6.0,5.4,10.7,72.2,35.0,228.0,4.6,6.2,-46.34,32.0,108.0,0.0,3.4,31.0,578.0,0.0,18.6,5546.0,0.0,0.0,7.0,7.0,7.0,6.0,10.0,8.0,3.0,2.0,27.0,23.0,85.2,24.0,24.0,100.0,89.0,4102.0,1.0,46.1,430.0,5935.0,1062.0,5.6,17.0,9.0,343.0,351.0,493.0,3632.0,25.0,8.0,7.0,193.0,540.0,2303.0,19.0,4.3,136.0,84.0,804.0,14.0,39.2,9.1,-89.35,71.2,5.1,1.6,7.8,8.0,10.9,103.9,29.0,192.0,7.2,5.6,-101.27,48.0,554.0,1.0,11.5,19.0,584.0,0.0,30.7,34.0,29.0,85.3,49.0,49.0,100.0,74.0,0.0,0.0,0.0,24.0,-41.92,9.4,186.0,5.3,24.6,23.5,135.0,1.2,186.0,5.9,31.9,30.8,174.0,2.12,1.0,2.0,0.0,25.0,0.0,1.0,0.0,2.0,1.0,1.0,0.0,0.0,0.0,3223.0,-12.0,-187.0,-1346.0,0.5983175604626709,0.4016824395373291,0.6526476356504685,0.34735236434953154,0.6363636363636364,0.3636363636363637,2.4637681159420293,0.4058823529411765,0.07364341085271317,1.4285714285714286,0.4915254237288136,0.5084745762711864,0.6119629317607413,0.38803706823925865,0.5681818181818182,0.43181818181818177,0.040816326530612235,1.8139534883720927,0.625,18.0,25110.0,32364.0,-7.300000000000002,28.5,30.0,32.0,28.0,31.0,22.0,21.0,27.0,29.0,27.5,22.0,29.0,26.0,27.0,16.5,30.0,29.0,32.0,26.0,30.0,29.0,28.5,29.0,30.0,29.0,30.0,21.0,31.5,28.5,26.5,25.5,30.0,22.0,32.0,24.0,32.0,30.0,31.0,21.0,32.0,32.0,26.5,23.5,11.0,27.5,27.5,13.0,9.5,6.0,11.0,27.0,29.0,26.5,32.0,30.0,14.0,23.5,29.0,14.0,1.5,1.0,25.5,15.5,16.0,14.0,13.5,28.0,25.0,26.0,21.5,28.0,24.0,7.0,15.0,20.5,27.5,21.0,32.0,29.0,30.5,17.5,1.0,29.0,32.0,32.0,24.5,26.5,29.0,4.0,31.0,29.0,1.0,8.0,29.5,29.0,23.0,20.5,1.0,3.0,12.0,32.0,23.0,22.5,23.0,28.5,28.5,20.0,12.0,16.5,16.5,16.5,28.0,28.0,11.0,22.0,17.0,16.0,18.5,14.5,26.0,28.0,30.0,3.0,28.0,5.0,27.0,6.0,32.0,10.0,6.0,27.0,30.0,26.0,29.0,28.0,27.0,22.0,22.5,24.5,28.0,32.0,32.0,28.0,32.0,32.0,12.0,27.5,25.0,28.5,28.0,26.166666666666668,26.0,22.34567901234568,25.063973063973062,21.25,26.5625,23.90625,26.166666666666668,30.5,27.781986531986533,32.0,31.0,31.0,31.0,32.0,26.5,30.0,32.0,32.0,32.0
Cleveland Browns,218.0,4621.0,1024.0,4.5,19.0,6.0,278.0,320.0,570.0,3090.0,16.0,13.0,5.1,173.0,415.0,1531.0,4.0,3.7,77.0,95.0,847.0,28.0,24.4,10.0,-74.13,56.1,2.8,2.3,5.8,5.3,10.3,72.8,39.0,210.0,4.6,6.4,-35.92,38.0,423.0,1.0,11.1,48.0,1134.0,0.0,23.6,6387.0,0.0,0.0,9.0,7.0,4.0,3.0,8.0,7.0,8.0,7.0,29.0,24.0,82.8,20.0,20.0,100.0,89.0,3570.0,0.0,40.1,307.0,5318.0,1035.0,5.1,20.0,11.0,301.0,265.0,469.0,2959.0,16.0,9.0,5.9,149.0,534.0,2359.0,12.0,4.4,124.0,90.0,726.0,28.0,33.3,11.5,-17.46,56.5,3.4,1.9,6.7,6.6,11.9,80.6,32.0,199.0,5.7,6.4,-20.82,26.0,303.0,1.0,11.7,46.0,1055.0,1.0,22.9,34.0,30.0,88.2,31.0,31.0,100.0,76.0,0.0,0.0,0.0,22.0,-31.94,-0.77,180.0,5.9,25.6,27.1,156.0,1.18,174.0,6.1,30.5,29.7,171.0,1.64,0.0,0.0,0.0,21.0,0.0,1.0,0.0,0.0,1.0,0.0,0.0,0.0,0.0,3300.0,1.0,-89.0,-697.0,0.5947265625,0.4052734375,0.6686864315083315,0.3313135684916685,0.8,0.2,2.2467532467532467,0.44508670520231214,0.10071942446043164,1.5675675675675675,0.4840579710144928,0.5159420289855072,0.5564121850319669,0.4435878149680331,0.5714285714285714,0.4285714285714286,0.09302325581395347,1.5227272727272727,0.2727272727272727,0.0,28080.0,29754.0,-2.599999999999998,30.0,29.0,12.0,30.5,25.0,15.0,11.5,24.0,27.0,30.0,20.5,21.0,28.0,32.0,31.0,17.0,28.0,28.0,27.5,28.0,31.0,30.5,32.0,29.0,29.0,25.0,10.0,29.0,23.5,24.0,15.5,26.0,13.0,12.0,9.5,9.0,8.0,9.0,21.0,17.0,30.0,19.0,19.0,17.5,30.5,30.5,13.0,9.5,17.0,32.0,22.0,25.0,14.5,28.0,27.0,31.5,4.5,6.0,9.5,12.0,14.0,5.0,18.5,15.0,17.0,10.0,5.0,10.0,20.0,7.5,13.0,2.0,2.0,2.0,4.0,6.5,1.0,31.0,30.0,18.0,20.0,22.0,19.5,30.0,6.0,7.0,5.5,13.5,13.0,9.5,11.5,5.0,4.0,4.5,13.0,23.0,23.0,17.5,18.0,28.0,11.0,23.0,25.5,26.5,5.5,6.0,20.0,15.0,16.5,16.5,16.5,12.0,1.0,14.0,19.0,14.0,19.0,4.0,29.0,9.0,22.0,32.0,1.0,32.0,1.0,26.0,7.0,10.0,26.0,13.0,20.0,25.0,25.0,16.0,12.0,18.0,24.0,27.0,5.5,25.0,22.0,12.0,29.0,24.0,25.0,4.0,32.0,21.0,23.5,14.0,24.916666666666668,13.25,17.635802469135804,18.68855218855219,18.8,25.75,22.275,17.583333333333332,23.7,21.194276094276095,25.0,28.0,11.0,21.0,24.0,23.0,29.0,29.0,18.0,26.0
Kansas City Chiefs,212.0,4973.0,1021.0,4.9,28.0,10.0,277.0,299.0,500.0,3080.0,13.0,18.0,5.8,163.0,487.0,1893.0,5.0,3.9,89.0,110.0,916.0,25.0,22.2,12.7,-91.84,59.8,2.6,3.6,6.6,5.5,11.0,73.0,34.0,208.0,4.7,6.4,-24.13,40.0,475.0,0.0,11.9,46.0,979.0,0.0,21.3,6628.0,1.0,1.0,7.0,7.0,7.0,6.0,12.0,7.0,3.0,3.0,30.0,24.0,80.0,20.0,20.0,100.0,89.0,4084.0,0.0,45.9,338.0,5333.0,991.0,5.4,26.0,6.0,291.0,257.0,454.0,3221.0,23.0,20.0,6.7,169.0,508.0,2112.0,14.0,4.2,96.0,108.0,834.0,26.0,31.9,13.8,9.95,56.6,5.1,4.4,7.5,6.5,13.3,79.1,29.0,186.0,5.8,6.0,-35.14,36.0,411.0,1.0,11.4,25.0,605.0,0.0,24.2,28.0,23.0,82.1,37.0,37.0,100.0,83.0,0.0,0.0,0.0,17.0,-56.34,37.53,189.0,5.6,26.3,24.6,150.0,1.05,188.0,5.4,28.4,31.5,159.0,1.74,0.0,2.0,0.0,20.0,0.0,0.0,0.0,0.0,0.0,0.0,1.0,0.0,1.0,3288.0,-2.0,-126.0,-360.0,0.5230166503428012,0.4769833496571988,0.6193444600844561,0.3806555399155439,0.7222222222222222,0.2777777777777778,1.831460674157304,0.5460122699386503,0.09025270758122744,1.6923076923076923,0.4873864783047427,0.5126135216952573,0.6039752484530283,0.3960247515469717,0.6216216216216216,0.3783783783783784,0.08934707903780069,1.7857142857142856,0.5882352941176471,12.0,28350.0,29892.0,-6.899999999999999,31.0,27.0,13.0,26.0,26.5,23.5,26.0,25.0,30.0,23.5,24.0,5.0,15.0,30.5,27.0,22.0,31.0,21.5,17.0,30.0,23.5,27.0,27.0,28.0,26.0,14.0,28.5,7.5,28.5,29.0,21.5,2.0,11.0,8.0,24.0,6.0,11.5,20.0,21.0,30.0,27.0,16.5,19.0,20.5,30.5,30.5,13.0,9.5,7.0,12.0,12.0,26.0,18.0,21.0,29.0,19.0,21.0,21.0,23.5,24.0,24.0,17.0,14.0,14.0,17.0,25.0,12.0,11.0,11.0,15.0,9.5,1.0,1.0,6.0,15.0,23.5,7.0,29.0,26.0,21.0,15.0,18.0,13.0,18.0,7.0,24.5,21.5,11.5,32.0,7.0,15.0,21.0,11.5,16.5,21.0,23.0,18.0,3.5,4.0,12.0,17.0,9.5,11.0,15.0,16.0,17.0,20.0,20.0,16.5,16.5,16.5,12.0,27.0,28.0,5.0,24.0,9.0,7.0,26.0,18.0,19.5,31.0,2.0,30.0,3.0,20.0,13.0,14.0,12.0,20.0,13.0,26.0,22.0,12.0,15.0,31.0,8.0,17.0,13.0,20.0,31.0,18.0,31.0,23.0,31.0,15.5,11.0,14.0,32.0,17.5,26.0,14.166666666666666,16.77777777777778,19.181818181818183,22.95,20.6875,21.81875,16.416666666666668,24.4,21.79090909090909,27.0,30.0,13.0,17.0,27.0,30.0,21.0,28.0,14.0,27.0
St. Louis Rams,193.0,4537.0,1013.0,4.5,23.0,13.0,267.0,292.0,549.0,2870.0,9.0,10.0,4.8,159.0,409.0,1667.0,7.0,4.1,79.0,112.0,899.0,29.0,18.9,11.2,-171.88,53.2,1.6,1.8,5.9,5.4,11.2,69.0,55.0,388.0,4.3,9.1,-101.65,27.0,297.0,1.0,11.0,55.0,1280.0,0.0,23.3,6485.0,0.0,0.0,7.0,7.0,7.0,6.0,12.0,8.0,2.0,0.0,28.0,21.0,75.0,18.0,18.0,100.0,106.0,4652.0,1.0,43.9,407.0,5734.0,1033.0,5.6,18.0,6.0,313.0,293.0,484.0,3301.0,21.0,12.0,6.3,166.0,510.0,2433.0,17.0,4.8,122.0,111.0,951.0,25.0,35.9,8.9,-51.0,60.5,4.3,2.5,7.4,7.1,12.2,87.3,39.0,261.0,6.1,7.5,-59.27,45.0,552.0,2.0,12.3,36.0,902.0,0.0,25.1,37.0,31.0,83.8,44.0,44.0,100.0,81.0,0.0,0.0,0.0,27.0,-50.48,-7.09,196.0,5.3,23.0,26.4,138.0,0.89,192.0,5.6,29.8,29.7,160.0,1.87,0.0,1.0,0.0,18.0,0.0,0.0,2.0,4.0,0.0,1.0,0.0,0.0,0.0,3258.0,-5.0,-214.0,-1197.0,0.596248766041461,0.40375123395853896,0.6325765924619793,0.3674234075380207,0.5625,0.4375,2.0126582278481013,0.4968553459119497,0.10861423220973784,1.4390243902439026,0.5062923523717329,0.4937076476282671,0.5756888733868155,0.4243111266131845,0.5526315789473685,0.4473684210526315,0.07987220447284345,1.5416666666666667,0.4814814814814815,10.0,27048.0,30720.0,-3.3000000000000007,32.0,31.0,19.0,30.5,29.0,25.0,16.0,30.0,32.0,31.0,26.5,23.0,23.0,29.0,19.5,14.5,32.0,26.5,30.0,32.0,30.0,28.5,26.0,31.0,31.0,28.5,28.5,23.0,15.5,12.0,7.0,23.0,30.5,20.0,9.5,10.5,4.0,3.0,21.0,21.0,29.0,23.0,28.0,30.0,32.0,32.0,13.0,1.0,2.0,21.5,28.0,27.0,23.0,30.0,32.0,23.0,13.0,27.0,4.0,25.0,22.0,10.0,32.0,32.0,30.0,3.0,26.0,22.0,19.0,21.5,18.0,7.0,5.0,7.0,10.5,16.5,4.0,30.0,31.0,27.5,27.5,15.5,25.0,29.0,15.5,17.0,19.0,21.5,19.5,23.0,21.0,25.0,26.0,26.0,28.0,29.5,26.0,10.5,10.0,12.0,24.0,28.5,28.0,20.0,25.0,25.0,20.0,17.5,16.5,16.5,16.5,28.0,21.0,12.0,21.0,22.0,11.0,25.5,7.5,5.0,27.0,28.0,5.0,31.0,2.0,28.0,5.0,20.0,25.0,16.0,17.0,32.0,31.0,21.0,20.0,29.0,26.0,9.0,24.5,31.0,27.5,30.0,32.0,30.0,26.5,20.0,19.0,18.0,23.5,22.0,25.916666666666668,23.083333333333332,20.901234567901238,23.51851851851852,21.25,25.0,23.125,21.083333333333332,28.3,25.909259259259258,30.0,29.0,26.5,29.0,31.0,26.5,27.0,31.0,28.0,30.0
Avg Team,354.9,5549.3,1017.8,5.5,25.3,9.5,311.3,327.0,544.1,3675.0,23.3,15.8,6.3,187.2,436.6,1874.3,12.5,4.3,96.7,102.75,867.28125,27.3,32.99375000000001,12.784375,15.74124999999999,60.1,4.3,2.9,7.2,6.7,12.0,82.5,37.1,241.5,5.9,6.4,42.80249999999997,36.7,363.7,0.6,9.9,43.0,1021.3,0.3,23.8,7195.3,0.5,0.5,9.3,8.9,8.1,7.0,9.4,6.9,4.4,2.8,31.6,26.2,82.9,37.7,37.5,99.4,77.8,3501.6,0.3,45.0,354.9,5549.3,1017.8,5.5,25.3,9.5,311.3,327.0,544.1,3675.0,23.3,15.8,6.3,187.2,436.6,1874.3,12.5,4.3,96.7,102.75,867.25,27.3,32.896875,12.771875,-15.74125,60.1,4.3,2.9,7.2,6.7,12.0,82.5,37.1,241.5,5.9,6.4,-42.8025,36.7,363.7,0.6,9.9,43.0,1021.3,0.3,23.8,31.6,26.2,82.9,37.7,37.5,99.4,77.8,3501.6,0.3,45.0,20.3,-19.5,19.5,189.0625,5.565624999999999,29.43125,28.2,153.53125,1.7543750000000002,189.0625,5.556250000000001,29.378125,28.190625,153.5,1.7493749999999997,1.0,1.5,0.2,39.34375,0.8,1.6,0.7,1.0,1.5,0.2,0.8,1.6,0.7,3916.5,0.0,0.0,0.0,0.5710355669090196,0.4289644330909804,0.6622456886454147,0.3377543113545853,0.6508379888268158,0.34916201117318424,1.9358841778697,0.5165598290598291,0.08769675554127851,1.6744186046511629,0.5710355669090196,0.4289644330909804,0.6622456886454147,0.3377543113545853,0.6508379888268158,0.34916201117318424,0.08769675554127851,1.6744186046511629,0.4679802955665025,17.599999999999994,29027.001953125,29021.09375,0.009374999999998579,16.5,16.5,16.5,16.5,16.5,16.5,16.5,16.5,16.5,16.5,16.5,16.5,16.5,16.5,16.5,16.5,16.5,16.5,16.5,16.5,16.5,16.5,16.5,16.5,16.5,16.5,16.5,16.5,16.5,16.5,16.5,16.5,16.5,16.5,16.5,16.5,16.5,16.5,16.5,16.5,16.5,16.5,16.5,16.5,16.5,16.5,16.5,16.5,16.5,16.5,16.5,16.5,16.5,16.5,16.5,16.5,16.5,16.5,16.5,16.5,16.5,16.5,16.5,16.5,16.5,16.5,16.5,16.5,16.5,16.5,16.5,16.5,16.5,16.5,16.5,16.5,16.5,16.5,16.5,16.5,16.5,16.5,16.5,16.5,16.5,16.5,16.5,16.5,16.5,16.5,16.5,16.5,16.5,16.5,16.5,16.5,16.5,16.5,16.5,16.5,16.5,16.5,16.5,16.5,16.5,16.5,16.5,16.5,16.5,16.5,16.5,16.5,16.5,16.5,16.5,16.5,16.5,16.5,16.5,16.5,16.5,16.5,16.5,16.5,16.5,16.5,16.5,16.5,16.5,16.5,16.5,16.5,16.5,16.5,16.5,16.5,16.5,16.5,16.5,16.5,16.5,16.5,16.5,16.5,16.5,16.5,16.5,16.5,16.5,16.5,16.5,16.5,16.5,16.5,16.5,16.5,16.5,16.5,16.5,16.5,16.5,16.5,16.5,16.5,16.5,16.5,16.5,16.5,16.5,16.5
