#Dr,#Dr_Defense,#Dr_Defense_Low_Rank,#Dr_High_Rank,1stD,1stD_Defense,1stD_Defense_Low_Rank,1stD_High_Rank,1stDpass,1stDpass_Defense,1stDpass_Defense_Low_Rank,1stDpass_High_Rank,1stDrun,1stDrun_Defense,1stDrun_Defense_Low_Rank,1stDrun_High_Rank,1stPy,1stPy_Defense,1stPy_Defense_Low_Rank,1stPy_High_Rank,2PA,2PA_Defense,2PM,2PM_Defense,ANY/A,ANY/A_Defense,ANY/A_Defense_Low_Rank,ANY/A_High_Rank,APYd,APYd_High_Rank,AY/A,AY/A_Defense,AY/A_Defense_Low_Rank,AY/A_High_Rank,AllTD,AvgDriveTime,AvgDriveTime_Defense,AvgDriveTime_Defense_Low_Rank,AvgDriveTime_High_Rank,AvgFieldPositionDifferential,AvgFieldPositionDifferential_High_Rank,AvgStartingPosition,AvgStartingPosition_Defense,AvgStartingPosition_Defense_Low_Rank,AvgStartingPosition_High_Rank,Cmp,Cmp%,Cmp%_Defense,Cmp%_Defense_Low_Rank,Cmp%_High_Rank,Cmp_Defense,Cmp_Defense_Low_Rank,Cmp_High_Rank,DefensivePtsScored,DefensivePtsScored_High_Rank,Dscore,Dscore_Rank,ExpectedPoints,ExpectedPointsPassing,ExpectedPointsPassing_Defense,ExpectedPointsPassing_Defense_High_Rank,ExpectedPointsPassing_High_Rank,ExpectedPointsRunning,ExpectedPointsRunning_Defense,ExpectedPointsRunning_Defense_High_Rank,ExpectedPointsRunning_High_Rank,ExpectedPoints_Defense,ExpectedPoints_Defense_High_Rank,ExpectedPoints_High_Rank,FG%,FG%_Defense,FG%_Defense_Low_Rank,FG%_High_Rank,FGA019,FGA2029,FGA3039,FGA4049,FGA50Plus,FGM019,FGM2029,FGM3039,FGM4049,FGM50Plus,FL,FL_Defense,FL_Defense_High_Rank,FL_Low_Rank,FantasyDstScore,FantasyDstScore_Rank,FantasyOffenseScore,FantasyOffenseScore_Rank,FantasyPassScore,FantasyPassScore_Rank,FantasyRushScore,FantasyRushScore_Rank,Fmb,FmbTD,FmbTD_Defense,Fmb_Low_Rank,FumbleLostPercent,FumbleLostPercent_Low_Rank,GameControlPlusBalance,GameControlPlusBalance_Rank,GameControlScore,GameControlScore_Rank,Int,Int%,Int%_Defense,Int%_Defense_High_Rank,Int%_Low_Rank,IntTD,IntTD_Defense,Int_Defense,Int_Defense_High_Rank,Int_Low_Rank,KickRet,KickRet_Defense,KickRet_Defense_Low_Rank,KickRet_High_Rank,KrTD,KrTD_Defense,KrTD_Defense_Low_Rank,KrTD_High_Rank,KrYds,KrYds_Defense,KrYds_Defense_Low_Rank,KrYds_High_Rank,NY/A,NY/A_Defense,NY/A_Defense_Low_Rank,NY/A_High_Rank,Oscore,Oscore_Rank,OthTD,OthTD_Defense,PF,PF_Defense,PF_Defense_Low_Rank,PF_Differential,PF_Differential_High_Rank,PF_High_Rank,PassAtt,PassAtt_Defense,PassAtt_Defense_Low_Rank,PassAtt_High_Rank,PassPercent,PassPercent_Defense,PassPercent_Defense_High_Rank,PassPercent_High_Rank,PassRun1dRatio,PassRun1dRatio_High_Rank,PassTD,PassTD%,PassTD%_Defense,PassTD%_Defense_Low_Rank,PassTD%_High_Rank,PassTD_Defense,PassTD_Defense_Low_Rank,PassTD_High_Rank,PassTdPercent,PassTdPercent_Defense,PassTdPercent_Defense_High_Rank,PassTdPercent_High_Rank,PassYdPercent,PassYdPercent_Defense,PassYdPercent_Defense_High_Rank,PassYdPercent_High_Rank,PassYds,PassYds_Defense,PassYds_Defense_Low_Rank,PassYds_High_Rank,Pen,PenYds,PenYds_Defense,PenYds_Defense_Low_Rank,PenYds_Low_Rank,Pen_Defense,Pen_Defense_Low_Rank,Pen_Low_Rank,Penalty1dPercent,Penalty1dPercent_Defense,Penalty1dPercent_Defense_High_Rank,Penalty1dPercent_High_Rank,Plays/Drive,Plays/Drive_Defense,Plays/Drive_Defense_Low_Rank,Plays/Drive_High_Rank,Ply,Ply_Defense,Ply_Defense_Low_Rank,Ply_High_Rank,Pnt,PntBlck,PntBlck_Defense,PntBlck_Defense_Low_Rank,PntBlck_Low_Rank,PntRet_Defense,PntRet_Defense_Low_Rank,PntYds,PntYds_Defense,PntYds_Defense_Low_Rank,PntYds_High_Rank,Pnt_Defense,Pnt_Defense_Low_Rank,Pnt_High_Rank,PrTD,PrTD_Defense,PrTD_Defense_Low_Rank,PrTD_High_Rank,PrYds,PrYds_Defense,PrYds_Defense_Low_Rank,PrYds_High_Rank,Pts/Drive,Pts/Drive_Defense,Pts/Drive_Defense_Low_Rank,Pts/Drive_High_Rank,PuntRet,PuntRet_High_Rank,QbRating,QbRating_Defense,QbRating_Defense_Low_Rank,QbRating_High_Rank,RawPassYds,RawPassYds_High_Rank,RunPass1dRatio,RunPass1dRatio_High_Rank,RunPercent,RunPercent_Defense,RunPercent_Defense_High_Rank,RunPercent_High_Rank,RunTdPercent,RunTdPercent_Defense,RunTdPercent_Defense_High_Rank,RunTdPercent_High_Rank,RunYdPercent,RunYdPercent_Defense,RunYdPercent_Defense_High_Rank,RunYdPercent_High_Rank,RushAtt,RushAtt_Defense,RushAtt_Defense_Low_Rank,RushAtt_High_Rank,RushTD,RushTD_Defense,RushTD_Defense_Low_Rank,RushTD_High_Rank,RushYds,RushYds_Defense,RushYds_Defense_Low_Rank,RushYds_High_Rank,STscore,STscore_Rank,Sc%,Sc%_Defense,Sc%_Defense_Low_Rank,Sc%_High_Rank,Sfty,Sfty_Defense,Sk,Sk%,Sk%_Defense,Sk%_Defense_High_Rank,Sk%_Low_Rank,SkYds,SkYds_Defense,SkYds_Defense_High_Rank,SkYds_Low_Rank,Sk_Defense,Sk_Defense_High_Rank,Sk_Low_Rank,TFGA,TFGA_Defense,TFGA_Defense_Low_Rank,TFGA_High_Rank,TFGM,TFGM_Defense,TFGM_Defense_Low_Rank,TFGM_High_Rank,TO,TO%,TO%_Defense,TO%_Defense_High_Rank,TO%_Low_Rank,TO_Defense,TO_Defense_High_Rank,TO_Differential,TO_Differential_High_Rank,TO_Low_Rank,ThreePhaseScore,ThreePhaseScore_Rank,TimeOfPossession,TimeOfPossession_Defense,TimeOfPossession_High_Rank,Tm,TotalYds,TotalYds_Defense,TotalYds_Defense_Low_Rank,TotalYds_High_Rank,XP%,XP%_Defense,XP%_Defense_Low_Rank,XP%_High_Rank,XPA,XPA_Defense,XPA_Defense_Low_Rank,XPA_High_Rank,XPM,XPM_Defense,XPM_Defense_Low_Rank,XPM_High_Rank,Y/Apass,Y/Apass_Defense,Y/Apass_Defense_Low_Rank,Y/Apass_High_Rank,Y/Arun,Y/Arun_Defense,Y/Arun_Defense_Low_Rank,Y/Arun_High_Rank,Y/C,Y/C_Defense,Y/C_Defense_Low_Rank,Y/C_High_Rank,Y/KR,Y/KR_Defense,Y/KR_Defense_Low_Rank,Y/KR_High_Rank,Y/PR,Y/PR_Defense,Y/PR_Defense_Low_Rank,Y/PR_High_Rank,Y/Play,Y/Play_Defense,Y/Play_Defense_Low_Rank,Y/Play_High_Rank,Y/Pnt,Y/Pnt_Defense,Y/Pnt_Defense_Low_Rank,Y/Pnt_High_Rank,Yds/Drive,Yds/Drive_Defense,Yds/Drive_Defense_Low_Rank,Yds/Drive_High_Rank,Yds_Differential,Yds_Differential_High_Rank,YppYprRatio,YppYprRatio_Defense,YppYprRatio_Defense_High_Rank,YppYprRatio_High_Rank
169.0,175.0,5.5,32.0,356.0,339.0,27.0,7.5,222.0,196.0,19.5,8.0,104.0,116.0,30.0,9.5,30.0,27.0,8.5,19.0,3.0,0.0,1.0,0.0,8.4,5.5,9.0,1.0,7287.0,13.0,9.2,6.4,9.0,1.0,58.0,173.0,162.0,23.5,5.0,1.0,14.0,28.5,27.5,15.0,13.0,349.0,65.1,59.0,7.0,9.0,333.0,7.0,16.0,26.0,5.0,15.666666666666666,15.0,195.16,231.61,-45.84,10.0,1.0,-27.01,5.5,27.0,16.0,-30.73,17.0,1.0,81.8,87.5,25.5,23.0,0.0,7.0,12.0,7.0,7.0,0.0,7.0,11.0,5.0,4.0,7.0,9.0,19.0,7.0,11.75,6.0,7.86875,1.0,5.05,2.0,10.6875,7.5,19.0,1.0,1.0,13.0,0.3684210526315789,8.0,10.163468013468014,4.0,7.8,5.0,6.0,1.1,3.2,8.0,1.0,3.0,0.0,18.0,8.5,1.5,29.0,58.0,31.0,27.0,0.0,1.0,29.5,19.0,555.0,1421.0,31.0,29.0,7.5,6.0,8.5,2.5,4.916666666666667,1.0,0.0,0.0,486.0,348.0,13.5,138.0,3.0,1.0,536.0,564.0,22.0,20.0,0.5654345654345654,0.5740037950664136,20.0,22.0,2.1346153846153846,16.0,38.0,7.1,4.6,17.5,2.0,26.0,18.0,3.0,0.7307692307692307,0.7027027027027027,14.0,10.0,0.6897054062803496,0.6537351136773728,25.0,17.0,4261.0,3623.0,10.0,8.0,92.0,775.0,945.0,25.0,7.0,104.0,14.0,7.0,0.08426966292134831,0.07964601769911504,25.0,25.0,6.1,6.2,30.5,5.5,1001.0,1054.0,25.0,24.0,51.0,2.0,0.0,16.5,31.0,22.0,2.0,2159.0,2691.0,4.0,32.0,62.0,4.0,32.0,2.0,1.0,26.0,2.0,333.0,191.0,5.0,7.0,2.63,1.84,18.0,1.0,29.0,22.0,109.9,82.0,7.0,2.0,4447.0,9.0,0.4684684684684685,17.0,0.4345654345654346,0.4259962049335864,13.0,11.0,0.2692307692307693,0.2972972972972973,19.0,23.0,0.3102945937196504,0.3462648863226272,8.0,16.0,435.0,449.0,23.0,14.0,14.0,11.0,15.0,11.0,1917.0,1919.0,23.0,11.0,18.487654320987655,20.0,46.7,33.1,16.0,1.0,1.0,3.0,30.0,5.3,6.8,12.0,14.0,186.0,261.0,12.0,10.0,41.0,10.5,10.5,33.0,24.0,6.5,13.0,27.0,21.0,6.5,14.0,13.0,7.1,14.9,4.0,2.0,27.0,8.5,14.0,1.0,1.5,12.526936026936028,5.0,29237.0,28350.0,15.0,Green Bay Packers,6178.0,5542.0,15.0,6.0,96.4,100.0,20.0,31.0,55.0,37.0,13.0,3.0,53.0,37.0,13.5,4.0,8.3,6.9,10.5,2.0,4.4,4.3,21.5,11.0,12.7,11.7,20.0,2.0,19.1,24.5,21.0,31.0,11.5,8.7,14.0,5.0,6.2,5.3,11.0,1.5,42.3,43.4,6.0,30.0,36.5,31.6,26.0,3.0,636.0,6.0,1.8863636363636365,1.604651162790698,25.0,10.0
198.0,195.0,25.5,3.5,360.0,311.0,14.5,6.0,227.0,219.0,29.0,6.0,98.0,60.0,2.0,13.5,35.0,32.0,17.5,11.5,2.0,0.0,2.0,0.0,7.7,5.0,3.0,4.0,7674.0,5.0,8.1,5.7,3.5,4.0,58.0,149.0,146.0,4.0,24.5,0.5999999999999979,16.0,28.9,28.3,22.0,9.5,399.0,65.7,62.2,14.0,8.0,399.0,32.0,5.0,20.0,11.0,9.333333333333334,5.0,130.29,161.99,-45.39,9.0,5.0,-29.0,52.59,7.0,17.0,13.81,5.0,7.0,82.8,82.1,14.0,21.0,2.0,9.0,8.0,7.0,3.0,2.0,9.0,7.0,5.0,1.0,5.0,7.0,24.5,4.0,12.166666666666666,10.0,9.3125,3.0,6.25,4.0,12.375,11.0,16.0,1.0,1.0,7.0,0.3125,4.5,10.50858585858586,5.0,9.3,7.0,15.0,2.5,2.8,12.0,17.5,2.0,1.0,18.0,8.5,17.0,32.0,35.0,13.0,24.5,0.0,0.0,13.5,19.0,802.0,905.0,16.0,20.0,7.5,5.3,1.0,2.5,7.083333333333333,3.0,0.0,0.0,482.0,354.0,16.5,128.0,4.0,2.0,607.0,641.0,32.0,9.5,0.584817244611059,0.6614936954413191,1.0,19.0,2.3163265306122454,13.0,40.0,6.6,4.5,15.5,3.0,29.0,26.0,2.0,0.7272727272727273,0.7631578947368421,6.0,11.0,0.7230840831523425,0.7386852344869957,2.0,11.0,4661.0,3607.0,9.0,4.0,120.0,1045.0,816.0,9.0,29.0,103.0,12.0,28.0,0.09722222222222222,0.10289389067524116,16.0,16.0,5.5,5.4,4.0,23.0,1067.0,1031.0,20.0,7.0,69.0,0.0,0.0,16.5,6.5,33.0,19.5,3048.0,4035.0,31.0,25.0,88.0,29.5,21.5,0.0,1.0,26.0,21.5,296.0,371.0,26.0,11.0,2.31,1.72,12.5,4.0,41.0,5.0,101.3,82.4,8.0,4.0,4779.0,4.0,0.4317180616740088,20.0,0.415182755388941,0.3385063045586809,32.0,14.0,0.2727272727272727,0.23684210526315785,27.0,22.0,0.2769159168476575,0.26131476551300425,31.0,22.0,443.0,349.0,1.0,12.0,15.0,9.0,9.0,9.5,1785.0,1276.0,2.0,15.0,21.074074074074076,29.0,39.9,31.3,9.5,6.0,1.0,0.0,17.0,2.7,6.0,21.5,1.0,118.0,252.0,14.0,2.0,41.0,10.5,1.0,29.0,28.0,10.5,22.5,24.0,23.0,11.0,23.5,20.0,9.6,11.8,21.0,7.0,25.0,16.5,5.0,11.5,7.5,11.71717171717172,3.0,29502.0,28470.0,13.0,Denver Broncos,6446.0,4883.0,3.0,4.0,100.0,100.0,20.0,13.5,56.0,37.0,13.0,1.5,56.0,37.0,13.5,1.5,7.9,6.0,1.0,5.0,4.0,3.7,4.5,20.5,12.0,9.7,1.0,10.5,25.1,25.9,24.0,8.0,7.2,11.2,29.0,20.5,6.0,4.7,2.0,4.5,44.2,45.9,25.5,22.0,32.6,24.9,1.0,7.0,1563.0,2.0,1.975,1.6216216216216215,24.0,6.0
203.0,212.0,32.0,2.0,356.0,338.0,26.0,7.5,218.0,211.0,27.5,9.5,109.0,88.0,13.0,6.0,29.0,39.0,28.0,20.5,0.0,0.0,0.0,0.0,6.1,6.7,23.5,15.5,8049.0,2.0,6.7,7.9,27.0,21.5,54.0,126.0,151.0,8.0,32.0,3.6000000000000014,5.0,30.0,26.4,10.0,6.0,384.0,61.8,58.4,3.0,21.0,345.0,15.0,9.0,42.0,1.0,17.916666666666668,22.0,46.41,89.05,-97.59,22.0,11.0,-33.02,70.1,3.0,20.0,-11.84,12.0,13.0,88.9,81.5,12.0,7.5,0.0,10.0,16.0,6.0,4.0,0.0,10.0,14.0,4.0,4.0,15.0,16.0,1.0,31.5,11.583333333333334,3.5,12.1,9.0,12.95,14.0,11.25,9.0,25.0,2.0,1.0,25.0,0.6,28.0,15.180976430976433,15.0,16.5,16.5,21.0,3.4,2.0,24.5,29.5,2.0,2.0,12.0,22.5,32.0,32.0,52.0,28.0,24.5,2.0,0.0,13.5,1.0,874.0,1183.0,27.0,16.0,6.7,6.6,20.0,10.0,12.0,10.5,3.0,0.0,474.0,400.0,22.5,74.0,8.0,3.0,621.0,591.0,27.0,5.0,0.5794143744454303,0.5750224618149147,19.0,20.0,2.0,21.5,27.0,4.3,5.1,25.5,16.0,30.0,28.5,13.0,0.627906976744186,0.6818181818181818,16.0,23.5,0.6862003780718336,0.7052754202030288,7.0,18.0,4356.0,4238.0,31.0,6.0,115.0,995.0,1089.0,30.0,25.0,121.0,28.0,21.0,0.08146067415730338,0.1153846153846154,7.0,26.0,5.7,5.4,4.0,19.0,1127.0,1113.0,31.0,1.0,76.0,0.0,0.0,16.5,6.5,29.0,12.0,3331.0,3984.0,30.0,15.0,91.0,32.0,13.5,2.0,1.0,26.0,2.0,531.0,238.0,11.0,2.0,1.96,1.76,14.0,12.0,41.0,5.0,84.8,91.6,21.0,23.0,4581.0,6.0,0.5,11.5,0.4205856255545697,0.4249775381850853,14.0,13.0,0.372093023255814,0.31818181818181823,17.0,9.5,0.31379962192816635,0.2947245797969712,26.0,15.0,474.0,473.0,28.0,7.0,16.0,14.0,22.0,6.5,1992.0,1771.0,15.0,9.0,10.938271604938274,3.0,36.9,31.1,8.0,12.0,0.0,0.0,32.0,4.9,7.7,5.0,11.0,225.0,357.0,2.0,17.0,49.0,2.5,15.0,36.0,27.0,9.0,7.0,32.0,22.0,9.0,3.5,36.0,17.2,12.7,17.0,31.5,28.0,6.5,-8.0,26.5,32.0,13.861952861952863,9.0,25578.0,32012.0,32.0,Philadelphia Eagles,6348.0,6009.0,28.0,5.0,100.0,97.9,6.0,13.5,54.0,47.0,28.5,4.0,54.0,46.0,27.5,3.0,7.4,7.8,27.5,11.5,4.2,3.7,4.5,14.5,11.9,13.3,32.0,12.0,27.3,22.8,12.5,5.0,13.0,8.2,13.0,2.5,5.6,5.4,16.0,11.0,43.8,43.8,12.0,23.0,31.1,28.2,7.0,12.0,339.0,11.0,1.761904761904762,2.108108108108108,2.0,17.0
181.0,182.0,16.5,17.0,361.0,329.0,22.5,4.5,228.0,196.0,19.5,5.0,96.0,88.0,13.0,15.0,37.0,45.0,32.0,7.0,1.0,0.0,0.0,0.0,6.9,5.9,12.0,6.0,7164.0,15.0,7.5,6.8,13.0,7.0,52.0,157.0,160.0,20.5,16.5,5.100000000000001,1.0,30.6,25.5,1.5,2.0,392.0,64.4,59.6,8.0,12.0,342.0,12.0,8.0,24.0,7.0,13.833333333333334,8.0,169.27,190.36,-61.0,18.0,3.0,-6.34,20.24,18.0,6.0,-27.24,15.0,3.0,94.6,78.4,5.0,2.0,1.0,11.0,11.0,13.0,1.0,1.0,11.0,10.0,12.0,1.0,4.0,9.0,19.0,2.0,12.333333333333334,12.0,10.68125,7.0,7.05,5.0,14.3125,17.0,13.0,2.0,1.0,2.0,0.3076923076923077,3.0,9.574242424242424,2.0,7.3,4.0,9.0,1.5,2.8,12.0,3.5,0.0,1.0,16.0,12.5,4.0,31.0,45.0,24.5,26.0,0.0,0.0,13.5,19.0,693.0,955.0,19.0,26.0,6.5,6.2,13.5,16.0,10.083333333333334,8.0,2.0,0.0,468.0,313.0,8.0,155.0,1.0,4.0,609.0,574.0,24.0,7.5,0.5917986952469712,0.5943852855759922,11.0,16.0,2.375,12.0,34.0,5.6,4.2,12.0,5.0,24.0,13.0,5.0,0.7234042553191491,0.8,4.0,12.0,0.7046853625170999,0.6968761351253179,13.0,15.0,4121.0,3837.0,17.0,9.0,120.0,1080.0,752.0,4.0,30.0,92.0,4.0,28.0,0.10249307479224376,0.13677811550151975,2.0,13.0,6.1,5.9,23.0,5.5,1073.0,1033.0,21.0,5.0,67.0,1.0,0.0,16.5,21.0,29.0,12.0,3060.0,2847.0,7.0,24.0,65.0,7.0,24.5,1.0,0.0,10.0,7.0,431.0,267.0,17.0,5.0,2.4,1.63,8.0,3.0,41.0,5.0,97.5,84.0,10.0,5.0,4291.0,11.0,0.42105263157894735,21.0,0.4082013047530289,0.40561471442400776,22.0,17.0,0.276595744680851,0.2,29.0,21.0,0.2953146374829001,0.3031238648746821,20.0,18.0,438.0,419.0,12.0,13.0,13.0,6.0,2.5,12.5,1727.0,1669.0,9.0,18.0,11.555555555555555,7.0,45.3,32.4,13.0,2.0,0.0,0.0,26.0,4.1,6.5,18.5,3.0,170.0,282.0,7.0,6.0,40.0,14.0,4.5,37.0,37.0,26.0,5.0,35.0,29.0,20.5,1.0,13.0,7.2,13.2,12.5,3.0,25.0,16.5,12.0,2.5,1.5,11.84848484848485,4.0,28417.0,29120.0,22.0,New England Patriots,5848.0,5506.0,13.0,11.0,100.0,100.0,20.0,13.5,51.0,28.0,4.5,5.0,51.0,28.0,4.5,5.0,7.0,7.2,15.5,22.0,3.9,4.0,9.5,23.5,10.9,12.0,23.5,25.5,22.4,21.2,5.0,21.0,10.5,9.2,17.0,10.0,5.5,5.3,11.0,12.5,45.7,43.8,12.0,12.5,32.3,30.2,14.5,8.0,342.0,10.0,1.794871794871795,1.8,13.0,15.0
179.0,179.0,10.5,21.5,342.0,315.0,17.0,11.0,205.0,195.0,17.0,13.0,106.0,86.0,11.0,8.0,31.0,34.0,21.5,17.0,0.0,0.0,0.0,0.0,8.0,6.2,16.5,2.0,7434.0,6.0,8.9,6.8,13.0,2.0,56.0,176.0,150.0,7.0,3.0,2.0,9.5,28.9,26.9,11.5,9.5,328.0,68.9,66.5,28.5,2.0,371.0,28.0,18.0,18.0,15.5,16.166666666666668,16.0,172.14,196.41,-102.27,24.0,2.0,-17.9,21.31,16.0,11.0,-68.86,24.0,2.0,86.2,88.9,28.0,13.0,0.0,6.0,7.0,9.0,7.0,0.0,6.0,6.0,8.0,5.0,14.0,13.0,5.0,29.5,16.333333333333332,16.0,8.46875,2.0,9.25,8.5,7.6875,3.0,21.0,1.0,1.0,17.0,0.6666666666666666,30.0,9.71010101010101,3.0,6.4,2.0,11.0,2.3,3.2,8.0,13.5,2.0,1.0,18.0,8.5,7.0,33.0,43.0,21.0,22.5,0.0,0.0,13.5,19.0,790.0,921.0,18.0,22.0,7.5,6.9,27.5,2.5,8.25,4.0,0.0,1.0,467.0,352.0,15.0,115.0,5.0,5.0,476.0,558.0,18.0,31.0,0.4990138067061144,0.5991820040899796,8.0,30.0,1.9339622641509435,23.0,37.0,7.8,3.9,9.5,1.0,22.0,8.0,4.0,0.6981132075471698,0.55,30.0,14.0,0.6164874551971327,0.7095581763773984,6.0,27.0,3784.0,4031.0,26.0,16.0,105.0,839.0,861.0,14.0,12.0,104.0,14.0,14.5,0.09064327485380116,0.10793650793650794,11.0,21.0,5.8,5.6,13.5,14.0,1014.0,978.0,5.0,18.0,58.0,1.0,0.0,16.5,21.0,25.0,5.5,2586.0,3007.0,8.0,31.0,67.0,8.0,30.5,0.0,0.0,10.0,21.5,275.0,240.0,12.0,15.0,2.49,1.83,16.5,2.0,30.0,19.0,110.9,88.5,13.0,1.0,4008.0,15.0,0.5170731707317073,10.0,0.5009861932938856,0.4008179959100204,25.0,3.0,0.30188679245283023,0.45,3.0,19.0,0.38351254480286734,0.2904418236226016,27.0,6.0,508.0,392.0,6.0,3.0,16.0,18.0,31.0,6.5,2354.0,1650.0,8.0,2.0,15.185185185185185,12.0,43.6,31.3,9.5,3.0,0.0,1.0,30.0,5.9,4.8,28.0,16.0,224.0,156.0,30.0,16.0,28.0,28.0,10.5,29.0,18.0,1.0,22.5,25.0,16.0,2.0,19.0,25.0,12.8,16.8,1.0,21.5,31.0,2.0,6.0,9.5,20.0,13.02020202020202,7.0,31504.0,26850.0,1.0,Dallas Cowboys,6138.0,5681.0,19.0,7.0,100.0,97.6,4.0,13.5,56.0,41.0,20.0,1.5,56.0,40.0,19.0,1.5,8.4,7.5,20.5,1.0,4.6,4.2,16.5,4.0,12.2,11.3,13.0,8.0,23.9,21.4,6.0,13.0,9.2,9.6,20.5,13.0,6.1,5.8,25.5,3.0,44.6,44.9,18.0,19.5,34.1,31.7,27.0,6.0,457.0,7.0,1.8260869565217392,1.7857142857142856,14.0,12.0
205.0,199.0,30.5,1.0,371.0,309.0,10.0,3.0,251.0,175.0,3.5,2.0,80.0,103.0,22.5,23.0,40.0,31.0,14.5,3.0,3.0,0.0,0.0,0.0,7.3,6.3,19.0,5.0,8093.0,1.0,7.8,7.2,18.5,6.0,53.0,149.0,136.0,1.0,24.5,3.2,7.0,28.7,25.5,1.5,11.5,410.0,62.0,58.9,6.0,20.0,320.0,3.5,4.0,12.0,24.5,15.0,11.0,86.38,150.92,-18.88,5.0,7.0,-56.98,-0.48,28.0,29.0,-9.6,11.0,9.0,96.8,78.9,7.0,1.0,0.0,10.0,10.0,8.0,3.0,0.0,10.0,10.0,7.0,3.0,15.0,14.0,3.0,31.5,14.5,14.0,14.4,14.0,5.3,3.0,23.5,26.0,31.0,1.0,2.0,31.5,0.4838709677419355,21.0,10.81986531986532,7.0,9.0,6.0,16.0,2.4,2.2,22.0,15.5,1.0,3.0,12.0,22.5,21.0,38.0,26.0,5.5,15.5,0.0,0.0,13.5,19.0,1065.0,587.0,5.5,12.0,7.1,6.3,17.0,5.0,11.666666666666666,9.0,0.0,0.0,458.0,369.0,19.0,89.0,7.0,6.0,661.0,543.0,11.5,1.0,0.6244343891402715,0.579940417080437,16.0,6.0,3.1375,1.0,42.0,6.4,5.0,23.0,4.0,27.0,20.5,1.0,0.8235294117647058,0.6585365853658537,19.0,3.0,0.7522287119581924,0.669159219405435,20.0,2.0,4894.0,3669.0,12.0,1.0,105.0,848.0,866.0,15.0,14.0,101.0,11.0,14.5,0.1078167115902965,0.10032362459546926,17.0,10.0,5.5,5.2,1.0,23.0,1105.0,1007.0,11.5,2.0,69.0,0.0,0.0,16.5,6.5,35.0,21.5,3221.0,4271.0,32.0,18.0,90.0,31.0,21.5,0.0,0.0,10.0,21.5,312.0,205.0,8.0,9.0,2.18,1.67,9.5,7.0,45.0,2.0,96.8,88.7,14.0,7.0,5062.0,1.0,0.3187250996015936,32.0,0.3755656108597285,0.42005958291956297,17.0,27.0,0.17647058823529416,0.3414634146341463,14.0,30.0,0.2477712880418076,0.330840780594565,13.0,31.0,415.0,423.0,16.0,17.0,9.0,14.0,22.0,24.5,1612.0,1814.0,18.0,22.0,10.790123456790125,2.0,39.5,28.1,4.0,8.0,0.0,1.0,29.0,4.2,7.0,9.0,4.0,168.0,263.0,11.0,5.0,41.0,10.5,8.0,31.0,19.0,2.0,18.5,30.0,15.0,1.0,6.5,31.0,14.6,12.6,18.0,27.0,26.0,11.5,-5.0,23.0,29.5,12.63973063973064,6.0,30545.0,27064.0,5.0,Indianapolis Colts,6506.0,5483.0,11.0,3.0,100.0,100.0,20.0,13.5,50.0,46.0,27.0,6.0,50.0,46.0,27.5,6.0,7.7,7.2,15.5,6.5,3.9,4.3,21.5,23.5,12.3,12.3,28.0,5.5,28.0,22.6,10.0,2.5,6.9,5.9,3.0,26.5,5.9,5.4,16.0,6.5,46.7,47.5,31.5,4.0,31.6,27.5,5.0,10.0,1023.0,3.0,1.9743589743589745,1.6744186046511629,20.0,7.0
174.0,174.0,4.0,29.0,379.0,314.0,16.0,2.0,243.0,193.0,12.5,3.0,98.0,88.0,13.0,13.5,38.0,33.0,20.0,4.5,4.0,0.0,4.0,0.0,7.8,7.2,30.0,3.0,7811.0,3.0,8.5,8.0,28.0,3.0,49.0,179.0,152.0,9.0,1.0,-1.8000000000000007,25.0,25.7,27.5,15.0,28.5,411.0,67.2,64.5,23.0,3.0,350.0,18.0,3.0,32.0,4.0,21.583333333333332,25.0,162.53,189.59,-113.35,26.0,4.0,-29.11,22.78,14.0,18.0,-80.8,27.0,4.0,90.6,93.8,30.0,4.5,0.0,13.0,6.0,10.0,3.0,0.0,12.0,6.0,10.0,1.0,11.0,10.0,16.5,21.0,17.583333333333332,20.0,10.7875,8.0,3.7,1.0,17.875,19.0,16.0,1.0,0.0,7.0,0.6875,32.0,13.294444444444444,11.0,11.7,9.0,10.0,1.6,2.0,24.5,5.0,4.0,0.0,11.0,25.5,5.5,35.0,54.0,29.5,21.0,0.0,1.0,29.5,19.0,758.0,1249.0,29.0,25.0,7.5,7.0,29.0,2.5,6.833333333333333,2.0,0.0,0.0,436.0,368.0,18.0,68.0,10.0,7.0,612.0,543.0,11.5,6.0,0.6039325842696629,0.6101694915254238,4.0,13.0,2.479591836734694,10.0,33.0,5.4,5.5,29.0,6.5,30.0,28.5,6.5,0.7674418604651163,0.7692307692307693,5.0,7.0,0.7336171506766003,0.7161301733286171,4.0,6.0,4825.0,4049.0,27.0,2.0,103.0,834.0,835.0,10.0,9.5,97.0,6.5,13.0,0.10026385224274406,0.10509554140127388,13.0,14.0,6.3,5.6,13.5,2.0,1068.0,944.0,2.0,6.0,62.0,1.0,0.0,16.5,21.0,27.0,8.0,2667.0,3078.0,9.0,30.0,68.0,9.0,26.5,1.0,0.0,10.0,7.0,321.0,220.0,9.0,8.0,2.23,2.09,25.0,6.0,32.0,16.0,103.2,98.3,28.0,3.0,4997.0,2.0,0.4032921810699589,23.0,0.3960674157303371,0.3898305084745762,29.0,20.0,0.2325581395348837,0.23076923076923075,28.0,26.0,0.2663828493233997,0.28386982667138305,29.0,27.0,423.0,368.0,3.0,15.0,10.0,9.0,9.0,22.0,1752.0,1605.0,6.0,16.0,16.703703703703706,16.0,41.4,39.7,28.0,4.0,1.0,0.0,33.0,5.1,5.7,25.5,12.5,172.0,194.0,25.0,7.0,33.0,26.0,16.0,32.0,32.0,17.0,16.0,29.0,30.0,24.0,10.5,21.0,11.5,11.5,23.0,14.0,21.0,23.0,0.0,16.5,10.0,14.888888888888888,14.0,31146.0,26448.0,3.0,Pittsburgh Steelers,6577.0,5654.0,18.0,2.0,100.0,100.0,20.0,13.5,45.0,38.0,15.0,8.0,45.0,38.0,15.0,8.0,8.2,7.8,27.5,3.5,4.1,4.4,25.5,17.5,12.2,12.1,25.0,8.0,21.7,23.1,14.5,26.5,10.0,8.1,11.5,11.0,6.2,6.0,29.5,1.5,43.0,45.3,20.0,28.0,37.5,32.4,29.0,2.0,923.0,4.0,2.0,1.7727272727272725,15.0,5.0
182.0,180.0,13.5,15.0,345.0,311.0,14.5,10.0,194.0,205.0,23.5,15.5,113.0,75.0,5.0,4.0,38.0,31.0,14.5,4.5,3.0,0.0,1.0,0.0,6.7,6.1,14.5,9.5,7420.0,8.0,7.2,7.2,18.5,12.5,46.0,156.0,162.0,23.5,18.0,1.3999999999999986,13.0,28.7,27.3,13.0,11.5,344.0,62.1,64.2,22.0,19.0,382.0,29.0,17.0,14.0,19.5,11.166666666666666,7.0,128.84,153.58,-91.25,21.0,6.0,-18.6,66.68,4.0,13.0,-21.36,14.0,8.0,85.3,83.3,16.0,15.0,0.0,10.0,11.0,4.0,9.0,0.0,10.0,11.0,4.0,4.0,8.0,11.0,12.5,10.5,11.583333333333334,3.5,9.925,5.0,12.1,13.0,7.75,4.0,16.0,0.0,0.0,7.0,0.5,23.0,11.663804713804714,8.0,12.9,12.0,12.0,2.2,1.8,26.0,11.0,1.0,0.0,11.0,25.5,10.0,38.0,26.0,5.5,15.5,1.0,0.0,13.5,3.5,1077.0,601.0,7.0,11.0,6.7,6.2,13.5,10.0,9.166666666666666,7.0,1.0,0.0,409.0,302.0,6.0,107.0,6.0,8.0,554.0,595.0,29.0,17.0,0.5612144955925563,0.6228239845261122,3.0,24.0,1.7168141592920354,26.0,27.0,4.9,3.7,6.5,10.0,22.0,8.0,13.0,0.627906976744186,0.7333333333333333,11.0,23.5,0.6541623843782117,0.7380819884993508,3.0,22.0,3819.0,3979.0,23.0,13.0,111.0,870.0,1007.0,28.0,15.0,110.0,24.0,18.0,0.11014492753623188,0.09967845659163987,19.0,8.0,5.8,5.9,23.0,14.0,1021.0,1034.0,22.0,14.5,60.0,0.0,0.0,16.5,6.5,23.0,3.0,2841.0,3489.0,18.0,26.0,76.0,18.0,28.0,0.0,0.0,10.0,21.5,292.0,166.0,2.0,12.0,2.13,1.67,9.5,8.5,32.0,16.0,91.0,90.6,19.0,14.0,3986.0,17.0,0.5824742268041238,7.0,0.4387855044074437,0.3771760154738878,30.0,9.0,0.372093023255814,0.2666666666666667,22.0,9.5,0.3458376156217883,0.2619180115006492,30.0,11.0,448.0,390.0,5.0,11.0,16.0,8.0,6.0,6.5,2019.0,1412.0,4.0,8.0,11.123456790123457,4.0,39.6,33.3,17.0,7.0,1.0,0.0,19.0,3.3,7.6,7.0,2.0,167.0,362.0,1.0,4.0,49.0,2.5,2.0,34.0,36.0,24.0,11.0,29.0,30.0,24.0,10.5,20.0,9.9,11.7,22.0,8.0,22.0,22.0,2.0,14.5,7.5,10.427609427609427,1.0,28392.0,29160.0,23.0,Baltimore Ravens,5838.0,5391.0,8.0,12.0,100.0,100.0,20.0,13.5,42.0,28.0,4.5,10.0,42.0,28.0,4.5,10.0,7.2,7.3,17.5,15.5,4.5,3.6,3.0,7.5,11.6,11.4,15.5,18.0,28.3,23.1,14.5,1.0,9.1,7.2,9.0,14.0,5.7,5.2,7.0,9.5,47.4,45.9,25.5,1.0,32.0,29.8,13.0,9.0,447.0,8.0,1.6,2.0277777777777777,3.0,24.0
174.0,171.0,2.5,29.0,395.0,345.0,28.0,1.0,258.0,205.0,23.5,1.0,101.0,111.0,28.0,11.0,36.0,29.0,12.5,9.5,1.0,0.0,0.0,0.0,6.8,6.9,25.0,7.0,7425.0,7.0,7.4,7.7,25.5,8.0,49.0,169.0,171.0,30.0,9.0,-0.6000000000000014,20.0,25.5,26.1,7.5,30.0,456.0,69.2,62.5,15.0,1.0,341.0,11.0,1.0,4.0,30.0,28.916666666666668,32.0,142.36,143.71,-115.66,27.0,8.0,4.07,-34.86,32.0,2.0,-141.89,32.0,5.0,86.4,96.9,31.0,11.0,0.0,6.0,9.0,5.0,2.0,0.0,6.0,9.0,3.0,1.0,13.0,5.0,30.5,26.5,28.75,32.0,10.1125,6.0,7.35,6.0,12.875,12.5,22.0,0.0,1.0,20.0,0.5909090909090909,27.0,18.236700336700338,20.0,18.8,21.0,17.0,2.6,2.2,22.0,19.0,0.0,3.0,12.0,22.5,24.5,21.0,39.0,18.0,31.0,0.0,0.0,13.5,19.0,543.0,1029.0,21.0,30.0,6.9,6.9,27.5,6.5,8.833333333333334,6.0,0.0,0.0,401.0,424.0,28.0,-23.0,20.0,9.0,659.0,546.0,15.0,2.0,0.6292237442922375,0.5675146771037182,22.0,5.0,2.5544554455445545,9.0,33.0,5.0,4.8,19.5,8.0,26.0,18.0,6.5,0.6734693877551021,0.6046511627906976,28.0,18.0,0.7237921604375569,0.6541341145833334,24.0,10.0,4764.0,4019.0,25.0,3.0,80.0,670.0,889.0,19.0,3.0,105.0,18.0,2.0,0.09113924050632913,0.08405797101449275,22.0,20.0,6.4,6.2,30.5,1.0,1095.0,1022.0,15.0,3.0,58.0,0.0,0.0,16.5,6.5,24.0,4.0,2690.0,2783.0,5.0,27.0,63.0,5.0,30.5,0.0,0.0,10.0,21.5,134.0,99.0,1.0,31.0,2.3,2.3,31.0,5.0,19.0,31.0,97.0,92.9,24.0,6.0,4952.0,3.0,0.39147286821705424,24.0,0.3707762557077625,0.4324853228962818,11.0,28.0,0.326530612244898,0.3953488372093024,5.0,15.0,0.276207839562443,0.34586588541666663,9.0,23.0,406.0,442.0,22.0,19.0,16.0,17.0,29.0,6.5,1818.0,2125.0,29.0,13.0,14.469135802469134,11.0,39.1,43.3,31.0,9.0,2.0,0.0,30.0,4.4,5.9,23.0,6.5,188.0,188.0,27.0,11.0,34.0,25.0,10.5,22.0,32.0,17.0,30.0,19.0,31.0,27.0,30.0,30.0,16.7,9.9,25.0,30.0,17.0,28.0,-13.0,31.0,28.0,17.67340067340067,21.0,29406.0,29241.0,14.0,New Orleans Saints,6582.0,6144.0,31.0,1.0,97.9,100.0,20.0,27.0,47.0,43.0,23.0,7.0,46.0,43.0,23.5,7.0,7.5,7.7,25.5,9.0,4.5,4.8,31.0,7.5,10.9,12.3,28.0,25.5,25.9,26.4,27.0,7.0,7.1,4.1,1.0,23.0,6.0,6.0,29.5,4.5,46.4,44.2,16.5,6.0,37.7,35.8,31.0,1.0,438.0,9.0,1.6666666666666667,1.6041666666666667,26.0,20.0
175.0,171.0,2.5,26.5,328.0,277.0,1.0,14.0,160.0,175.0,3.5,29.0,144.0,70.0,3.0,1.0,24.0,32.0,17.5,26.5,1.0,0.0,0.0,0.0,6.7,5.0,3.0,9.5,7306.0,12.0,7.9,5.8,5.0,5.0,43.0,178.0,157.0,16.5,2.0,4.800000000000002,2.0,30.5,25.7,4.0,3.0,287.0,63.2,61.7,12.0,15.0,313.0,1.0,30.5,20.0,11.0,4.833333333333333,1.0,135.41,88.28,-20.84,6.0,12.0,65.66,71.63,2.0,1.0,50.43,3.0,6.0,83.8,87.5,25.5,17.0,0.0,10.0,10.0,13.0,4.0,0.0,10.0,10.0,9.0,2.0,7.0,11.0,12.5,7.0,11.916666666666666,7.0,9.6625,4.0,17.45,20.0,1.875,1.0,23.0,0.0,0.0,22.5,0.3043478260869565,2.0,6.413973063973065,1.0,2.2,1.0,7.0,1.5,2.6,15.0,3.5,2.0,0.0,13.0,19.0,3.0,39.0,43.0,21.0,14.0,0.0,0.0,13.5,19.0,820.0,1035.0,22.0,17.0,6.6,5.5,3.5,13.5,8.416666666666666,5.0,1.0,1.0,394.0,254.0,1.0,140.0,2.0,10.0,454.0,507.0,1.0,32.0,0.485798237022527,0.5887445887445888,13.0,31.0,1.1111111111111112,32.0,20.0,4.4,3.4,4.0,14.5,17.0,2.0,24.0,0.5,0.68,17.0,30.5,0.540585495675316,0.6948993916705662,14.0,32.0,3250.0,2970.0,1.0,27.0,130.0,1009.0,613.0,1.0,27.0,70.0,1.0,32.0,0.07317073170731707,0.11552346570397112,6.0,30.0,6.0,5.5,9.0,8.5,1021.0,924.0,1.0,14.5,62.0,1.0,0.0,16.5,21.0,17.0,1.0,2688.0,3630.0,23.0,28.5,83.0,26.0,26.5,0.0,1.0,26.0,21.5,252.0,195.0,7.0,19.0,2.13,1.39,2.0,8.5,36.0,12.0,95.1,80.4,5.5,8.0,3492.0,26.0,0.9,1.0,0.5142017629774731,0.4112554112554112,20.0,2.0,0.5,0.31999999999999995,16.0,2.5,0.459414504324684,0.3051006083294337,19.0,1.0,525.0,380.0,4.0,2.0,20.0,8.0,6.0,1.0,2762.0,1304.0,3.0,1.0,21.302469135802472,30.0,40.6,26.9,2.5,5.0,1.0,1.0,42.0,8.5,6.8,12.0,24.0,242.0,234.0,18.0,18.5,37.0,20.0,20.5,37.0,24.0,6.5,5.0,31.0,21.0,6.5,5.0,14.0,6.9,12.3,20.0,1.0,24.0,20.5,10.0,4.0,3.0,10.62794612794613,2.0,31150.0,26847.0,2.0,Seattle Seahawks,6012.0,4274.0,1.0,9.0,100.0,100.0,20.0,13.5,41.0,25.0,1.5,11.5,41.0,25.0,1.5,11.5,7.7,6.3,2.0,6.5,5.3,3.4,2.0,1.0,12.2,10.2,2.0,8.0,21.0,24.1,19.0,30.0,7.0,11.5,30.0,25.0,5.9,4.6,1.0,6.5,43.4,43.7,9.0,26.0,34.2,25.0,2.0,5.0,1738.0,1.0,1.4528301886792454,1.8529411764705883,10.0,29.0
181.0,180.0,13.5,17.0,361.0,309.0,10.0,4.5,226.0,194.0,14.5,7.0,99.0,99.0,20.0,12.0,36.0,16.0,1.0,9.5,1.0,0.0,1.0,0.0,5.8,6.0,13.0,20.0,7270.0,14.0,6.8,6.8,13.0,19.0,42.0,160.0,159.0,18.5,13.5,1.6000000000000014,11.5,31.1,29.5,26.0,1.0,394.0,66.2,62.9,16.0,5.5,338.0,10.0,7.0,24.0,7.0,15.583333333333334,14.0,68.79,83.74,-48.03,12.0,13.0,-11.91,16.29,20.0,10.0,-20.09,13.0,11.0,78.4,76.5,2.0,27.0,1.0,12.0,8.0,10.0,6.0,1.0,12.0,7.0,6.0,3.0,11.0,11.0,12.5,21.0,15.25,15.0,12.7875,10.0,11.7,10.0,13.875,16.0,27.0,1.0,0.0,27.5,0.4074074074074074,10.5,14.48956228956229,13.0,14.4,15.0,12.0,2.0,2.6,15.0,6.5,2.0,0.0,14.0,15.5,10.0,41.0,46.0,26.0,13.0,0.0,1.0,29.5,19.0,1082.0,1237.0,28.0,10.0,5.8,6.2,13.5,25.0,12.0,10.5,0.0,1.0,388.0,373.0,20.0,15.0,15.0,11.0,595.0,537.0,6.0,12.0,0.6163461538461539,0.5597667638483965,27.0,9.0,2.282828282828284,14.0,27.0,4.5,5.0,23.0,12.5,27.0,20.5,13.0,0.6923076923076923,0.675,18.0,17.0,0.6657739689341189,0.6474335638878776,27.0,21.0,3729.0,3557.0,6.0,17.0,81.0,635.0,920.0,21.0,2.0,105.0,18.0,3.0,0.0997229916897507,0.051779935275080916,32.0,15.0,6.0,5.9,23.0,8.5,1040.0,1029.0,19.0,12.0,59.0,1.0,0.0,16.5,21.0,36.0,23.5,2688.0,2593.0,3.0,28.5,61.0,3.0,29.0,0.0,0.0,10.0,21.5,204.0,349.0,23.0,28.0,1.99,1.99,23.0,11.0,25.0,27.0,92.5,89.7,18.0,11.0,4066.0,13.0,0.4380530973451328,19.0,0.3836538461538461,0.4402332361516035,6.0,24.0,0.3076923076923077,0.325,15.0,16.0,0.3342260310658811,0.35256643611212235,6.0,12.0,399.0,453.0,26.0,22.0,12.0,13.0,19.5,15.0,1872.0,1937.0,24.0,12.0,16.679012345679013,15.0,37.6,36.7,23.0,11.0,3.0,0.0,46.0,7.2,6.8,12.0,21.5,337.0,211.0,22.0,29.0,39.0,17.0,23.0,37.0,34.0,21.0,5.0,29.0,26.0,16.0,10.5,23.0,10.5,13.3,11.0,9.0,25.0,16.5,2.0,14.5,15.5,14.57912457912458,12.0,28960.0,28620.0,18.0,Miami Dolphins,5601.0,5494.0,12.0,14.0,100.0,100.0,20.0,13.5,41.0,39.0,16.5,11.5,41.0,39.0,16.5,11.5,6.8,7.0,12.5,26.5,4.7,4.3,21.5,2.0,10.3,11.1,9.5,30.0,26.4,26.9,28.0,6.0,8.2,9.7,22.0,17.0,5.4,5.3,11.0,15.0,45.6,42.5,1.0,14.0,30.9,30.3,16.5,14.0,107.0,13.0,1.4468085106382975,1.627906976744186,23.0,30.0
175.0,169.0,1.0,26.5,330.0,358.0,32.0,13.0,233.0,224.0,31.0,4.0,75.0,108.0,26.5,26.0,22.0,26.0,6.0,29.5,2.0,0.0,1.0,0.0,6.7,7.1,28.5,9.5,7791.0,4.0,7.3,7.6,24.0,10.0,42.0,162.0,174.0,32.0,11.0,-1.3999999999999986,24.0,26.5,27.9,20.0,24.0,418.0,66.1,63.4,18.0,7.0,359.0,21.0,2.0,12.0,24.5,24.333333333333332,29.0,68.84,105.81,-131.54,29.0,10.0,-26.32,-7.5,30.0,15.0,-136.13,31.0,10.0,90.6,81.6,13.0,4.5,0.0,10.0,4.0,8.0,10.0,0.0,10.0,4.0,8.0,7.0,8.0,12.0,7.5,10.5,22.291666666666668,27.0,14.5375,15.0,7.95,7.0,21.125,23.0,16.0,1.0,0.0,7.0,0.5,23.0,18.76784511784512,23.0,21.3,24.0,15.0,2.4,2.8,12.0,15.5,1.0,5.0,16.0,12.5,17.0,50.0,36.0,15.0,5.0,0.0,0.0,13.5,19.0,1174.0,820.0,12.0,5.0,6.9,7.6,32.0,6.5,12.583333333333334,12.0,0.0,0.0,381.0,417.0,27.0,-36.0,24.0,12.0,632.0,566.0,23.0,3.0,0.6405797101449275,0.5664739884393064,23.0,3.0,3.1066666666666665,2.0,28.0,4.4,3.5,5.0,14.5,20.0,5.0,11.0,0.7179487179487181,0.4878048780487805,32.0,13.0,0.7524376136175839,0.7027620841180163,9.0,1.0,4553.0,4478.0,32.0,5.0,97.0,840.0,744.0,3.0,13.0,91.0,2.5,9.0,0.06666666666666668,0.07262569832402235,28.0,32.0,6.1,6.4,32.0,5.5,1035.0,1038.0,23.0,13.0,67.0,0.0,0.0,16.5,6.5,26.0,7.0,3063.0,2413.0,2.0,23.0,56.0,2.0,24.5,1.0,0.0,10.0,7.0,239.0,250.0,14.5,21.5,2.06,2.25,30.0,10.0,18.0,32.0,93.4,88.9,15.0,9.5,4758.0,5.0,0.3218884120171674,31.0,0.3594202898550725,0.4335260115606936,10.0,30.0,0.28205128205128205,0.5121951219512195,1.0,20.0,0.2475623863824161,0.2972379158819837,24.0,32.0,372.0,450.0,24.5,27.0,11.0,21.0,32.0,18.5,1498.0,1894.0,21.0,24.0,10.308641975308642,1.0,38.9,42.6,30.0,10.0,0.0,1.0,31.0,4.7,3.7,31.0,9.0,205.0,140.0,31.0,14.0,22.0,30.5,13.5,32.0,38.0,28.5,16.0,29.0,31.0,27.0,10.5,23.0,13.1,14.2,6.0,23.5,28.0,6.5,5.0,11.5,15.5,16.235690235690235,17.0,28350.0,29406.0,24.0,Atlanta Falcons,6051.0,6372.0,32.0,8.0,100.0,95.2,1.0,13.5,40.0,42.0,22.0,14.0,40.0,40.0,19.0,14.0,7.5,8.2,31.5,9.0,4.0,4.2,16.5,20.5,11.4,12.9,31.0,19.0,23.5,22.8,12.5,14.5,13.3,9.6,20.5,1.0,5.8,6.1,32.0,8.0,45.7,43.1,4.0,12.5,34.6,37.6,32.0,4.0,-321.0,23.0,1.875,1.9523809523809519,6.0,11.0
193.0,195.0,25.5,8.5,336.0,326.0,21.0,12.0,218.0,187.0,7.0,9.5,83.0,112.0,29.0,22.0,35.0,27.0,8.5,11.5,0.0,0.0,0.0,0.0,6.7,6.3,19.0,9.5,7324.0,11.0,7.3,7.5,22.5,10.0,44.0,153.0,144.0,3.0,21.5,-0.3000000000000007,19.0,28.2,28.5,24.0,14.0,383.0,63.1,62.1,13.0,16.0,324.0,5.5,10.0,6.0,28.5,23.416666666666668,28.0,27.58,82.92,-52.7,14.0,15.0,-43.06,-6.02,29.0,24.0,-56.64,22.0,17.0,92.3,93.5,29.0,3.0,1.0,7.0,9.0,5.0,4.0,1.0,6.0,9.0,4.0,4.0,14.0,9.0,19.0,29.5,19.166666666666668,24.0,14.71875,16.0,9.25,8.5,20.1875,21.0,21.0,1.0,2.0,17.0,0.6666666666666666,30.0,18.411279461279463,22.0,17.9,19.0,14.0,2.3,3.3,5.5,13.5,0.0,1.0,17.0,11.0,15.0,44.0,32.0,10.5,11.0,0.0,0.0,13.5,19.0,1025.0,587.0,5.5,15.0,6.7,6.8,24.5,10.0,16.5,17.0,0.0,1.0,380.0,400.0,22.5,-20.0,19.0,13.0,607.0,522.0,3.0,9.5,0.5865561694290976,0.5650446871896723,24.0,18.0,2.6265060240963853,8.0,30.0,4.9,4.8,19.5,10.0,25.0,15.5,9.5,0.6976744186046512,0.625,24.0,15.0,0.7271489361702128,0.6403858948769129,28.0,7.0,4272.0,3850.0,18.0,7.0,101.0,896.0,948.0,26.0,16.0,105.0,18.0,11.0,0.10416666666666667,0.08282208588957055,23.0,12.0,5.8,5.3,2.0,14.0,1086.0,1007.0,11.5,4.0,81.0,1.0,0.0,16.5,21.0,37.0,25.0,3640.0,3416.0,17.0,10.0,75.0,15.0,8.5,0.0,1.0,26.0,21.5,224.0,391.0,27.0,24.0,1.93,1.88,19.5,13.5,29.0,22.0,92.2,89.4,16.0,12.5,4470.0,7.0,0.3807339449541284,25.0,0.4134438305709024,0.4349553128103277,9.0,15.0,0.3023255813953488,0.375,9.0,18.0,0.2728510638297872,0.3596141051230871,5.0,26.0,449.0,438.0,19.5,10.0,13.0,15.0,25.0,12.5,1603.0,2162.0,30.0,23.0,16.160493827160494,14.0,34.7,35.4,20.0,15.0,0.0,0.0,30.0,4.7,8.3,2.0,9.0,198.0,313.0,3.0,12.5,47.0,4.0,10.5,26.0,31.0,13.5,26.0,24.0,29.0,20.5,23.5,28.0,12.4,12.8,15.5,18.0,26.0,11.5,-2.0,19.5,25.0,18.922558922558924,25.0,29529.0,28080.0,12.0,New York Giants,5875.0,6012.0,29.0,10.0,100.0,100.0,20.0,13.5,44.0,41.0,20.0,9.0,44.0,41.0,21.5,9.0,7.4,8.0,29.0,11.5,3.6,4.9,32.0,29.0,11.7,12.8,30.0,15.0,23.3,18.3,2.0,17.5,7.7,10.6,27.0,19.0,5.4,6.0,29.5,15.0,44.9,45.5,23.0,17.5,30.3,30.8,20.5,16.0,-137.0,20.0,2.055555555555556,1.6326530612244896,22.0,3.0
194.0,199.0,30.5,7.0,313.0,329.0,22.5,18.5,171.0,206.0,25.0,24.5,108.0,89.0,15.5,7.0,34.0,34.0,21.5,13.5,0.0,0.0,0.0,0.0,6.3,5.4,8.0,13.0,6353.0,29.0,6.8,6.1,8.0,19.0,40.0,154.0,142.0,2.0,19.5,0.09999999999999787,17.5,27.7,27.6,17.5,18.5,295.0,60.8,58.6,4.0,22.0,363.0,22.0,28.0,38.0,2.0,10.5,6.0,-9.79,41.25,29.48,2.0,20.0,-44.9,40.94,10.0,25.0,79.59,1.0,22.0,85.7,86.4,23.0,14.0,0.0,7.0,15.0,8.0,5.0,0.0,6.0,13.0,7.0,4.0,9.0,14.0,3.0,14.0,12.208333333333334,11.0,14.74375,17.0,18.8,22.0,10.6875,7.5,19.0,1.0,1.0,13.0,0.4736842105263158,20.0,13.805050505050506,12.0,11.6,8.0,13.0,2.7,3.2,8.0,20.0,4.0,1.0,20.0,4.0,13.5,20.0,45.0,24.5,32.0,0.0,0.0,13.5,19.0,422.0,1169.0,26.0,31.0,6.6,5.9,7.0,13.5,16.333333333333332,16.0,1.0,0.0,372.0,307.0,7.0,65.0,11.0,14.0,485.0,619.0,31.0,30.0,0.4811676082862524,0.6100278551532033,5.0,32.0,1.5833333333333333,29.0,22.0,4.5,4.5,15.5,12.5,28.0,23.0,18.0,0.6470588235294118,0.8235294117647058,2.0,21.0,0.6080174133865409,0.6982588404236223,12.0,29.0,3352.0,3890.0,21.0,24.0,94.0,834.0,786.0,8.0,9.5,99.0,9.5,8.0,0.10862619808306707,0.1033434650455927,15.0,9.0,5.7,5.5,9.0,19.0,1062.0,1077.0,28.0,8.0,84.0,1.0,0.0,16.5,21.0,32.0,17.0,3845.0,3742.0,26.0,5.0,83.0,26.0,7.0,0.0,0.0,10.0,21.5,208.0,396.0,28.0,25.5,1.69,1.48,3.0,19.0,34.0,14.0,86.4,80.4,5.5,17.0,3460.0,27.0,0.631578947368421,4.0,0.5188323917137476,0.3899721448467967,28.0,1.0,0.3529411764705882,0.17647058823529416,31.0,12.0,0.3919825866134591,0.3017411595763777,21.0,4.0,551.0,420.0,13.0,1.0,12.0,6.0,2.5,15.0,2161.0,1681.0,10.0,5.0,22.925925925925927,31.0,33.0,26.6,1.0,18.0,1.0,1.0,26.0,5.1,5.8,24.0,12.5,108.0,251.0,15.0,1.0,38.0,19.0,4.5,35.0,22.0,4.0,9.0,30.0,19.0,4.0,6.5,22.0,11.3,16.1,3.0,13.0,34.0,1.0,12.0,2.5,11.5,16.01010101010101,16.0,29876.0,28258.0,8.0,Houston Texans,5513.0,5571.0,16.0,17.0,100.0,97.0,2.0,13.5,40.0,33.0,8.0,14.0,40.0,32.0,7.5,14.0,7.1,6.7,7.0,18.0,3.9,4.0,9.5,23.5,11.7,11.4,15.5,15.0,21.1,26.0,25.0,29.0,6.1,12.4,31.0,31.0,5.2,5.2,7.0,22.5,45.8,45.1,19.0,11.0,28.2,27.8,6.0,24.0,-58.0,19.0,1.8205128205128205,1.675,19.0,13.0
191.0,184.0,20.0,11.5,313.0,337.0,25.0,18.5,164.0,197.0,21.0,27.0,122.0,105.0,24.0,2.0,27.0,35.0,24.0,24.0,1.0,0.0,1.0,0.0,5.8,5.3,7.0,20.0,7370.0,9.0,6.3,5.7,3.5,26.0,40.0,153.0,159.0,18.5,21.5,4.100000000000001,3.0,30.3,26.2,9.0,4.0,323.0,64.2,60.0,9.0,13.0,365.0,24.5,22.0,12.0,24.5,16.75,20.0,7.02,9.94,-53.38,15.0,24.0,3.67,9.88,22.0,4.0,-30.61,16.0,19.0,78.8,81.3,10.5,26.0,0.0,6.0,12.0,12.0,3.0,0.0,6.0,10.0,10.0,0.0,9.0,6.0,28.0,14.0,17.666666666666668,21.0,13.55,11.0,21.1,27.0,6.0,2.0,20.0,0.0,1.0,15.0,0.45,17.0,14.628282828282828,14.0,14.1,14.0,17.0,3.4,3.3,5.5,29.5,1.0,2.0,20.0,4.0,24.5,45.0,44.0,23.0,9.0,0.0,0.0,13.5,19.0,1241.0,1123.0,25.0,4.0,6.5,6.2,13.5,16.0,16.25,15.0,0.0,0.0,365.0,344.0,12.0,21.0,14.0,15.0,503.0,608.0,30.0,25.0,0.5166994106090373,0.5885660731021556,14.0,29.0,1.3442622950819672,31.0,20.0,4.0,3.0,2.0,20.0,18.0,3.5,24.0,0.5128205128205128,0.5294117647058824,31.0,29.0,0.6144037356321839,0.6762915289615585,18.0,28.0,3421.0,3888.0,20.0,21.0,102.0,812.0,876.0,16.0,8.0,105.0,18.0,12.0,0.08626198083067092,0.10385756676557864,14.0,24.0,5.5,6.0,27.5,23.0,1018.0,1067.0,26.5,17.0,73.0,0.0,0.0,16.5,6.5,30.0,14.5,3419.0,3274.0,12.0,12.0,75.0,15.0,17.5,0.0,1.0,26.0,21.5,436.0,226.0,10.0,4.0,1.84,1.72,12.5,16.0,40.0,7.0,84.2,75.8,3.0,24.0,3551.0,25.0,0.7439024390243902,2.0,0.4833005893909626,0.4114339268978444,19.0,4.0,0.4871794871794872,0.4705882352941176,2.0,4.0,0.3855962643678161,0.3237084710384415,15.0,5.0,492.0,439.0,21.0,5.0,19.0,16.0,27.0,2.0,2147.0,1861.0,20.0,6.0,11.574074074074074,8.0,34.0,32.6,14.5,16.0,3.0,0.0,23.0,4.4,3.2,32.0,6.5,130.0,125.0,32.0,3.0,20.0,32.0,3.0,33.0,32.0,17.0,13.0,26.0,26.0,16.0,15.5,26.0,13.1,13.6,9.5,23.5,26.0,11.5,0.0,16.5,22.0,15.156565656565657,15.0,29223.0,29256.0,16.0,Cincinnati Bengals,5568.0,5749.0,22.0,15.0,100.0,100.0,20.0,13.5,39.0,34.0,9.5,16.0,39.0,34.0,9.5,16.0,7.1,6.6,6.0,18.0,4.4,4.2,16.5,11.0,11.0,11.0,7.5,24.0,27.6,25.5,22.0,4.0,10.9,7.5,10.0,7.0,5.5,5.4,16.0,12.5,46.8,43.7,9.0,3.0,29.1,31.1,22.0,20.0,-181.0,21.0,1.6136363636363635,1.5714285714285712,27.0,22.0
173.0,178.0,8.0,31.0,309.0,310.0,12.5,21.0,184.0,184.0,5.5,21.0,92.0,108.0,26.5,16.0,33.0,18.0,2.0,15.0,2.0,0.0,0.0,0.0,6.0,5.8,10.5,17.0,7366.0,10.0,7.1,6.7,10.5,14.0,40.0,166.0,162.0,23.5,10.0,1.6000000000000014,11.5,29.3,27.7,19.0,8.0,320.0,64.9,58.3,2.0,11.0,318.0,2.0,24.5,12.0,24.5,14.25,9.0,37.4,58.31,-17.03,4.0,16.0,-2.73,8.98,24.0,5.0,-5.79,9.0,15.0,83.3,86.5,24.0,18.5,1.0,10.0,7.0,10.0,2.0,1.0,10.0,6.0,7.0,1.0,11.0,8.0,21.5,21.0,11.666666666666666,5.0,14.3875,13.0,18.4,21.0,10.375,6.0,22.0,1.0,0.0,20.0,0.5,23.0,15.55808080808081,16.0,16.5,16.5,6.0,1.2,1.1,31.0,2.0,1.0,0.0,6.0,31.0,1.5,51.0,54.0,29.5,4.0,1.0,0.0,13.5,3.5,1430.0,1293.0,30.0,1.0,5.9,5.5,3.5,23.0,15.583333333333334,13.0,0.0,0.0,353.0,281.0,2.0,72.0,9.0,16.0,493.0,545.0,13.5,28.0,0.5634095634095634,0.5771484375,17.0,23.0,2.0,21.5,18.0,3.7,4.0,11.0,24.5,22.0,8.0,27.5,0.5,0.8461538461538461,1.0,30.5,0.6239215686274511,0.6149773071104387,31.0,26.0,3182.0,3252.0,2.0,29.0,88.0,681.0,851.0,13.0,4.0,107.0,23.0,5.0,0.10679611650485436,0.05806451612903226,31.0,11.0,5.7,6.0,27.5,19.0,962.0,1024.0,16.0,29.0,71.0,0.0,0.0,16.5,6.5,29.0,12.0,3164.0,3700.0,25.0,19.0,78.0,20.5,20.0,1.0,0.0,10.0,7.0,605.0,190.0,4.0,1.0,1.93,1.56,6.0,13.5,50.0,1.0,92.2,86.4,12.0,12.5,3428.0,30.0,0.5,11.5,0.4365904365904366,0.4228515625,16.0,10.0,0.5,0.15384615384615385,32.0,2.5,0.3760784313725489,0.3850226928895613,2.0,7.0,420.0,433.0,18.0,16.0,18.0,4.0,1.0,3.0,1918.0,2036.0,28.0,10.0,13.814814814814817,9.0,35.8,32.6,14.5,13.0,0.0,1.0,49.0,9.0,7.8,3.0,28.5,246.0,253.0,13.0,21.0,46.0,5.0,26.0,30.0,37.0,26.0,20.5,25.0,32.0,29.5,19.0,17.0,9.2,6.7,30.0,4.0,14.0,30.5,-3.0,21.0,4.5,14.616161616161618,13.0,28718.0,28836.0,19.0,Kansas City Chiefs,5100.0,5288.0,7.0,25.0,100.0,100.0,20.0,13.5,38.0,25.0,1.5,17.0,38.0,25.0,1.5,17.0,7.0,6.4,4.0,22.0,4.6,4.7,30.0,4.0,10.7,11.0,7.5,27.0,28.0,23.9,18.0,2.5,12.1,6.6,6.0,4.0,5.3,5.2,7.0,18.0,44.6,47.4,30.0,19.5,29.4,29.7,12.0,18.5,-188.0,22.0,1.5217391304347827,1.3617021276595744,32.0,26.5
174.0,179.0,10.5,29.0,326.0,307.0,6.5,15.0,214.0,168.0,1.0,11.0,75.0,98.0,19.0,26.0,37.0,41.0,29.0,7.0,0.0,0.0,0.0,0.0,6.4,6.5,21.5,12.0,6491.0,26.0,7.2,7.2,18.5,12.5,40.0,171.0,157.0,16.5,6.5,-2.1000000000000014,26.0,26.4,28.5,24.0,25.0,380.0,66.2,61.1,11.0,5.5,320.0,3.5,11.0,20.0,11.0,16.25,17.0,51.84,111.54,-79.59,20.0,9.0,-48.68,19.69,19.0,27.0,-53.24,21.0,12.0,84.6,82.4,15.0,16.0,1.0,6.0,9.0,6.0,4.0,1.0,6.0,8.0,4.0,3.0,5.0,11.0,12.5,4.0,19.666666666666668,25.0,18.65,23.0,11.8,11.0,25.5,29.0,15.0,3.0,0.0,3.5,0.3333333333333333,6.0,18.142760942760944,19.0,18.4,20.0,18.0,3.1,1.3,28.5,23.5,0.0,2.0,7.0,28.5,27.5,26.0,67.0,32.0,28.0,0.0,0.0,13.5,19.0,577.0,1488.0,32.0,28.0,6.7,6.2,13.5,10.0,17.75,18.0,0.0,0.0,348.0,348.0,13.5,0.0,17.0,17.0,574.0,524.0,4.0,14.0,0.6055500495540139,0.5566801619433198,28.0,12.0,2.853333333333333,6.0,31.0,5.4,4.6,17.5,6.5,24.0,13.0,8.0,0.8378378378378378,0.6857142857142857,15.0,2.0,0.7498627630375114,0.6331054867910586,29.0,3.0,4098.0,3427.0,4.0,10.0,111.0,967.0,1067.0,29.0,23.0,129.0,30.0,18.0,0.11349693251533742,0.13355048859934854,4.0,5.0,5.9,5.7,16.0,10.5,1009.0,988.0,7.0,20.5,75.0,1.0,0.0,16.5,21.0,35.0,21.5,3366.0,3210.0,10.0,14.0,69.0,10.0,15.0,0.0,0.0,10.0,21.5,203.0,366.0,25.0,29.0,1.87,1.88,19.5,15.0,23.0,28.5,93.4,91.3,20.0,9.5,4296.0,10.0,0.3504672897196261,27.0,0.3944499504459861,0.4433198380566802,5.0,21.0,0.16216216216216214,0.3142857142857143,18.0,31.0,0.2501372369624886,0.3668945132089414,4.0,30.0,398.0,438.0,19.5,23.0,6.0,11.0,15.0,30.0,1367.0,1986.0,26.0,30.0,20.246913580246915,27.0,33.9,35.8,21.0,17.0,1.0,0.0,37.0,6.1,4.7,29.0,17.0,198.0,178.0,28.0,12.5,26.0,29.0,17.0,26.0,34.0,21.0,26.0,22.0,28.0,18.0,26.0,23.0,12.6,9.5,27.0,19.5,18.0,27.0,-5.0,23.0,15.5,17.885521885521886,22.0,29754.0,28103.0,10.0,San Diego Chargers,5465.0,5413.0,9.0,18.0,100.0,100.0,20.0,13.5,40.0,36.0,11.0,14.0,40.0,36.0,11.5,14.0,7.5,6.9,10.5,9.0,3.4,4.5,28.0,31.0,11.3,11.3,13.0,20.5,22.2,22.2,8.0,22.0,8.8,10.5,26.0,16.0,5.4,5.5,21.5,15.0,44.9,46.5,29.0,17.5,31.3,30.2,14.5,11.0,52.0,16.0,2.2058823529411766,1.5333333333333334,30.0,1.0
197.0,198.0,28.5,5.0,273.0,302.0,5.0,28.0,186.0,171.0,2.0,19.5,65.0,89.0,15.5,31.0,22.0,42.0,30.5,29.5,2.0,0.0,2.0,0.0,5.6,4.5,1.0,23.0,6505.0,25.0,6.4,5.5,1.0,24.5,34.0,145.0,148.0,5.0,27.0,3.3000000000000007,6.0,30.2,26.9,11.5,5.0,363.0,62.7,60.3,10.0,17.0,337.0,9.0,15.0,14.0,19.5,5.166666666666667,2.0,-49.72,21.36,35.24,1.0,23.0,-65.53,34.39,11.0,31.0,75.16,2.0,27.0,89.5,81.1,9.0,6.0,0.0,9.0,13.0,8.0,8.0,0.0,9.0,12.0,7.0,6.0,10.0,11.0,12.5,17.0,7.75,1.0,20.16875,27.0,15.4,18.0,24.9375,27.0,22.0,1.0,0.0,20.0,0.4545454545454545,18.0,12.678451178451178,9.0,12.0,11.0,13.0,2.2,3.4,3.5,11.0,0.0,2.0,19.0,6.0,13.5,33.0,32.0,10.5,22.5,1.0,0.0,13.5,3.5,770.0,639.0,9.0,24.0,5.8,5.4,2.0,25.0,23.166666666666668,28.0,1.0,0.0,343.0,289.0,4.0,54.0,12.0,18.0,579.0,559.0,19.0,13.0,0.6058823529411764,0.5968841285296982,10.0,11.0,2.8615384615384616,5.0,23.0,4.0,2.9,1.0,20.0,16.0,1.0,15.5,0.7666666666666667,0.6153846153846154,26.5,8.0,0.7091836734693877,0.6590590590590589,22.0,12.0,3614.0,3292.0,3.0,18.0,124.0,1031.0,849.0,11.5,28.0,104.0,14.0,31.0,0.08058608058608059,0.1390728476821192,1.0,27.0,5.4,5.4,4.0,26.0,1020.0,1027.0,18.0,16.0,86.0,0.0,0.0,16.5,6.5,38.0,26.0,3692.0,3834.0,29.0,8.0,88.0,29.5,6.0,1.0,0.0,10.0,7.0,354.0,246.0,13.0,6.0,1.58,1.37,1.0,23.5,37.0,9.5,86.0,74.5,2.0,20.0,3856.0,18.0,0.3494623655913979,28.0,0.3941176470588236,0.4031158714703018,23.0,22.0,0.2333333333333333,0.3846153846153846,6.5,25.0,0.2908163265306123,0.34094094094094096,11.0,21.0,402.0,414.0,11.0,20.0,7.0,10.0,12.0,27.5,1482.0,1703.0,11.0,25.0,11.197530864197532,5.0,32.5,28.3,5.0,19.0,1.0,2.0,39.0,6.3,8.8,1.0,18.5,242.0,308.0,5.0,18.5,54.0,1.0,18.0,38.0,37.0,26.0,2.5,34.0,30.0,24.0,2.0,23.0,11.2,14.1,7.0,12.0,30.0,3.0,7.0,7.0,15.5,13.356902356902356,8.0,28565.0,29304.0,21.0,Buffalo Bills,5096.0,4995.0,4.0,26.0,96.9,100.0,20.0,29.5,32.0,27.0,3.0,23.0,31.0,27.0,3.0,24.0,6.7,6.4,4.0,28.0,3.7,4.1,13.0,26.5,10.6,10.7,4.5,28.5,23.3,20.0,3.0,17.5,9.6,6.5,4.5,12.0,5.0,4.9,3.5,29.0,42.9,43.6,7.0,29.0,25.8,25.2,3.0,28.5,101.0,14.0,1.8108108108108107,1.5609756097560978,28.0,14.0
178.0,179.0,10.5,23.5,347.0,309.0,10.0,9.0,199.0,193.0,12.5,14.0,117.0,91.0,17.0,3.0,31.0,25.0,5.0,17.0,2.0,0.0,1.0,0.0,5.8,5.8,10.5,20.0,6923.0,19.0,6.9,6.7,10.5,16.0,36.0,174.0,154.0,12.0,4.0,0.09999999999999787,17.5,27.7,27.6,17.5,18.5,327.0,60.0,64.8,25.0,24.5,364.0,23.0,19.5,12.0,24.5,15.083333333333334,12.0,29.83,56.09,-51.81,13.0,17.0,-18.45,9.52,23.0,12.0,-39.67,19.0,16.0,82.9,78.6,6.0,20.0,0.0,7.0,13.0,12.0,3.0,0.0,7.0,12.0,9.0,1.0,11.0,12.0,7.5,21.0,16.875,19.0,13.7125,12.0,14.55,15.0,12.875,12.5,25.0,0.0,1.0,25.0,0.44,15.0,15.766498316498318,17.0,13.9,13.0,12.0,2.2,2.5,17.5,11.0,2.0,1.0,14.0,15.5,10.0,37.0,18.0,1.0,17.5,0.0,0.0,13.5,19.0,805.0,584.0,4.0,19.0,6.0,6.1,10.0,21.5,15.666666666666666,14.0,0.0,2.0,339.0,374.0,21.0,-35.0,23.0,19.0,545.0,562.0,20.0,19.0,0.5537735849056604,0.6026026026026026,7.0,25.0,1.7008547008547008,27.0,23.0,4.2,4.4,13.5,17.0,25.0,15.5,15.5,0.696969696969697,0.6410256410256411,21.0,16.0,0.6329547503154859,0.6704064741585433,19.0,25.0,3511.0,3645.0,11.0,19.0,83.0,756.0,760.0,5.0,6.0,97.0,6.5,4.0,0.0893371757925072,0.08090614886731391,24.0,23.0,6.2,5.7,16.0,3.0,1060.0,999.0,9.0,9.0,74.0,1.0,0.0,16.5,21.0,28.0,9.5,3236.0,3297.0,14.0,17.0,72.0,11.0,16.0,1.0,1.0,26.0,7.0,239.0,435.0,30.0,21.5,1.79,1.89,21.0,17.0,30.0,19.0,86.2,89.5,17.0,19.0,3828.0,19.0,0.5879396984924623,6.0,0.4462264150943396,0.39739739739739743,26.0,8.0,0.303030303030303,0.3589743589743589,12.0,17.0,0.3670452496845141,0.32959352584145674,14.0,8.0,473.0,397.0,9.0,8.0,10.0,14.0,22.0,22.0,2036.0,1792.0,16.0,7.0,23.654320987654323,32.0,34.8,34.1,18.5,14.0,0.0,0.0,42.0,7.2,6.6,16.0,21.5,317.0,268.0,9.0,25.0,40.0,14.0,20.5,35.0,28.0,10.5,9.0,29.0,22.0,9.0,10.5,23.0,11.8,14.0,8.0,16.0,26.0,11.5,3.0,13.0,15.5,17.632996632996633,20.0,30972.0,27566.0,4.0,Carolina Panthers,5547.0,5437.0,10.0,16.0,100.0,100.0,20.0,13.5,34.0,44.0,24.5,20.0,34.0,44.0,25.0,18.5,7.0,7.0,12.5,22.0,4.3,4.5,28.0,13.0,11.7,10.8,6.0,15.0,21.8,32.4,31.0,24.5,8.0,15.5,32.0,18.0,5.2,5.4,16.0,22.5,43.7,45.8,24.0,24.5,31.0,30.3,16.5,13.0,110.0,12.0,1.627906976744186,1.5555555555555556,29.0,21.0
176.0,179.0,10.5,25.0,288.0,321.0,19.0,26.5,171.0,189.0,9.5,24.5,90.0,100.0,21.0,18.0,27.0,32.0,17.5,24.0,4.0,0.0,4.0,0.0,4.9,6.1,14.5,28.0,6819.0,22.0,6.0,7.0,15.5,28.0,35.0,157.0,169.0,29.0,16.5,-0.8999999999999986,23.0,27.3,28.2,21.0,20.0,322.0,62.3,66.1,27.0,18.0,353.0,19.0,23.0,36.0,3.0,17.416666666666668,21.0,-2.41,1.79,-57.96,17.0,26.0,4.02,7.87,26.0,3.0,-42.67,20.0,21.0,74.3,80.6,8.0,31.0,2.0,5.0,10.0,9.0,9.0,2.0,4.0,8.0,7.0,5.0,2.0,6.0,28.0,1.0,12.0,8.0,18.875,24.0,24.5,30.0,13.25,15.0,12.0,2.0,0.0,1.0,0.16666666666666666,1.0,19.595286195286196,24.0,21.8,25.0,18.0,3.5,2.4,19.5,31.0,2.0,1.0,13.0,19.0,27.5,54.0,28.0,7.0,3.0,0.0,0.0,13.5,19.0,1173.0,579.0,3.0,6.0,5.7,6.2,13.5,28.0,20.0,22.0,2.0,1.0,325.0,343.0,11.0,-18.0,18.0,20.0,517.0,534.0,5.0,22.0,0.5790010193679919,0.5609756097560976,26.0,21.0,1.9,24.0,17.0,3.3,4.9,21.0,28.5,26.0,18.0,29.0,0.5862068965517241,0.7222222222222222,12.0,27.0,0.6426307448494454,0.6476881233000906,26.0,24.0,3244.0,3572.0,7.0,28.0,100.0,836.0,938.0,23.0,11.0,112.0,25.0,10.0,0.09375,0.09968847352024922,18.0,17.0,5.8,5.9,23.0,14.0,981.0,1025.0,17.0,28.0,76.0,1.0,0.0,16.5,21.0,39.0,27.0,3318.0,3292.0,13.0,16.0,76.0,18.0,13.5,0.0,0.0,10.0,21.5,297.0,255.0,16.0,10.0,1.64,1.83,16.5,21.0,27.0,24.5,79.2,92.8,23.0,27.0,3566.0,24.0,0.5263157894736842,9.0,0.42099898063200814,0.4390243902439024,7.0,12.0,0.4137931034482759,0.2777777777777778,21.0,6.0,0.3573692551505546,0.3523118766999094,7.0,9.0,413.0,450.0,24.5,18.0,12.0,10.0,12.0,15.0,1804.0,1943.0,25.0,14.0,13.876543209876543,10.0,31.8,34.1,18.5,21.0,0.0,2.0,51.0,9.0,7.1,8.0,28.5,322.0,217.0,21.0,26.0,41.0,10.5,28.0,35.0,31.0,13.5,9.0,26.0,25.0,13.0,15.5,20.0,10.8,10.1,24.0,10.0,19.0,25.5,-1.0,18.0,7.5,17.39057239057239,19.0,27632.0,30251.0,26.0,Minnesota Vikings,5048.0,5515.0,14.0,27.0,100.0,97.3,3.0,13.5,29.0,37.0,13.0,27.0,29.0,36.0,11.5,27.0,6.9,7.1,14.0,25.0,4.4,4.3,21.5,11.0,11.1,10.7,4.5,23.0,21.7,20.7,4.0,26.5,11.0,6.5,4.5,6.0,5.1,5.4,16.0,26.5,43.7,43.3,5.0,24.5,28.5,30.6,18.0,22.0,-467.0,24.0,1.568181818181818,1.6511627906976745,21.0,25.0
186.0,182.0,16.5,13.5,288.0,301.0,4.0,26.5,189.0,189.0,9.5,18.0,79.0,83.0,9.5,24.0,20.0,29.0,12.5,31.0,1.0,0.0,1.0,0.0,5.5,6.3,19.0,25.5,6915.0,20.0,6.6,7.2,18.5,23.0,36.0,151.0,162.0,23.5,23.0,2.3999999999999986,8.0,28.0,25.6,3.0,15.0,327.0,63.5,68.1,31.0,14.0,368.0,27.0,19.5,18.0,15.5,15.333333333333334,13.0,-56.29,5.26,-57.93,16.0,25.0,-56.47,54.74,6.0,28.0,5.33,6.0,28.0,80.0,86.2,22.0,25.0,1.0,7.0,12.0,3.0,7.0,1.0,6.0,10.0,2.0,5.0,11.0,12.0,7.5,21.0,14.25,13.0,19.91875,26.0,19.15,23.0,20.6875,22.0,27.0,0.0,3.0,27.5,0.4074074074074074,10.5,18.368518518518517,21.0,19.7,22.0,16.0,3.1,2.4,19.5,23.5,3.0,5.0,13.0,19.0,21.0,45.0,35.0,13.0,9.0,0.0,1.0,29.5,19.0,1099.0,849.0,13.0,9.0,6.0,6.7,21.5,21.5,23.083333333333332,27.0,0.0,1.0,324.0,354.0,16.5,-30.0,21.0,21.0,515.0,540.0,9.0,23.0,0.587251828631139,0.5771144278606966,18.0,17.0,2.392405063291139,11.0,20.0,3.9,3.3,3.0,22.5,18.0,3.5,24.0,0.6451612903225806,0.6,29.0,22.0,0.6752730883813307,0.686277995023107,17.0,19.0,3400.0,3861.0,19.0,23.0,123.0,1139.0,882.0,17.0,32.0,105.0,18.0,30.0,0.06944444444444445,0.09634551495016612,20.0,31.0,5.3,5.7,16.0,28.5,957.0,1005.0,10.0,30.0,81.0,1.0,0.0,16.5,21.0,28.0,9.5,3721.0,3268.0,11.0,7.0,76.0,18.0,8.5,2.0,0.0,10.0,2.0,482.0,192.0,6.0,3.0,1.55,1.57,7.0,25.0,37.0,9.5,84.9,91.8,22.0,22.0,3695.0,21.0,0.417989417989418,22.0,0.41274817136886105,0.42288557213930345,15.0,16.0,0.3548387096774194,0.4,4.0,11.0,0.3247269116186693,0.3137220049768929,16.0,14.0,395.0,425.0,17.0,26.0,11.0,12.0,17.5,18.5,1635.0,1765.0,14.0,20.0,11.246913580246915,6.0,29.6,30.2,7.0,26.0,0.0,0.0,47.0,8.4,6.9,10.0,23.0,295.0,265.0,10.0,24.0,40.0,14.0,24.5,30.0,29.0,12.0,20.5,24.0,25.0,13.0,23.5,27.0,14.0,13.2,12.5,26.0,25.0,16.5,-2.0,19.5,24.0,17.037037037037035,18.0,28086.0,29484.0,25.0,St. Louis Rams,5035.0,5626.0,17.0,28.0,97.1,100.0,20.0,28.0,35.0,39.0,16.5,18.5,34.0,39.0,16.5,18.5,7.2,7.6,23.0,15.5,4.1,4.2,16.5,17.5,11.3,11.2,11.0,20.5,24.4,24.3,20.0,11.0,13.0,6.9,7.0,2.5,5.3,5.6,24.0,18.0,45.9,43.0,2.5,10.0,26.9,30.8,20.5,26.0,-591.0,25.0,1.75609756097561,1.8095238095238089,12.0,18.0
179.0,182.0,16.5,21.5,310.0,310.0,12.5,20.0,210.0,209.0,26.0,12.0,72.0,59.0,1.0,28.5,28.0,42.0,30.5,22.0,3.0,0.0,1.0,0.0,6.1,5.2,5.5,15.5,6637.0,23.0,6.9,6.0,7.0,16.0,35.0,170.0,149.0,6.0,8.0,3.799999999999997,4.0,29.9,26.1,7.5,7.0,365.0,60.4,64.7,24.0,23.0,383.0,30.0,12.5,14.0,19.5,5.416666666666667,3.0,41.29,83.34,-41.9,8.0,14.0,-35.0,81.82,1.0,21.0,48.45,4.0,14.0,65.8,78.3,4.0,32.0,0.0,10.0,6.0,14.0,8.0,0.0,10.0,5.0,6.0,4.0,8.0,7.0,24.5,10.5,10.166666666666666,2.0,17.575,22.0,11.9,12.0,23.25,24.0,21.0,1.0,0.0,17.0,0.3809523809523809,9.0,10.557912457912458,6.0,7.2,3.0,12.0,2.0,3.4,3.5,6.5,1.0,0.0,20.0,4.0,10.0,25.0,20.0,2.0,29.0,0.0,0.0,13.5,19.0,612.0,544.0,2.0,27.0,6.2,5.8,5.5,19.0,19.416666666666668,21.0,0.0,0.0,321.0,282.0,3.0,39.0,13.0,22.0,604.0,592.0,28.0,11.0,0.6210526315789474,0.6443089430894309,2.0,8.0,2.9166666666666665,4.0,22.0,3.6,3.9,9.5,26.0,23.0,11.0,18.0,0.6666666666666666,0.7419354838709677,9.0,19.5,0.7391782831988262,0.7696780893042575,1.0,5.0,4030.0,3706.0,13.0,12.0,118.0,989.0,849.0,11.5,24.0,99.0,9.5,25.5,0.09032258064516127,0.13548387096774195,3.0,22.0,6.1,5.5,9.0,5.5,1045.0,984.0,6.0,11.0,68.0,0.0,0.0,16.5,6.5,30.0,14.5,3138.0,3583.0,22.0,21.0,82.0,24.0,23.0,0.0,1.0,26.0,21.5,284.0,311.0,20.0,13.0,1.71,1.49,4.0,18.0,32.0,16.0,85.9,83.0,9.0,21.0,4284.0,12.0,0.3428571428571429,29.0,0.3789473684210526,0.3556910569105691,31.0,25.0,0.33333333333333337,0.25806451612903225,24.0,13.5,0.26082171680117383,0.2303219106957425,32.0,28.0,396.0,350.0,2.0,25.0,11.0,8.0,6.0,18.5,1422.0,1109.0,1.0,28.0,17.91358024691358,19.0,32.4,26.9,2.5,20.0,1.0,1.0,45.0,6.9,6.6,16.0,20.0,254.0,295.0,6.0,22.0,42.0,8.0,22.0,38.0,23.0,5.0,2.5,25.0,18.0,3.0,19.0,20.0,9.5,14.3,5.0,6.0,27.0,8.5,7.0,7.0,7.5,13.915824915824915,10.0,30430.0,27118.0,7.0,Detroit Lions,5452.0,4815.0,2.0,19.0,100.0,100.0,20.0,13.5,32.0,30.0,6.0,23.0,32.0,30.0,6.0,22.0,7.1,6.8,8.5,18.0,3.6,3.2,1.0,29.0,11.7,10.4,3.0,15.0,24.5,27.2,29.0,9.5,8.9,10.4,25.0,15.0,5.2,4.9,3.5,22.5,46.1,43.7,9.0,9.0,30.4,26.3,4.0,15.0,637.0,5.0,1.9722222222222217,2.125,1.0,8.0
180.0,177.0,7.0,19.5,322.0,325.0,20.0,16.0,194.0,227.0,32.0,15.5,91.0,78.0,8.0,17.0,37.0,20.0,3.0,7.0,5.0,0.0,5.0,0.0,5.4,7.3,31.0,27.0,6865.0,21.0,6.2,8.2,30.5,27.0,40.0,161.0,163.0,27.0,12.0,-6.899999999999999,31.0,25.9,32.8,31.0,26.0,396.0,65.0,66.8,30.0,10.0,366.0,26.0,6.0,6.0,28.5,25.583333333333332,30.0,-21.44,-2.52,-135.41,30.0,27.0,-7.23,14.42,21.0,7.0,-106.73,30.0,24.0,75.0,84.6,19.0,30.0,0.0,5.0,4.0,6.0,1.0,0.0,5.0,3.0,4.0,0.0,10.0,10.0,16.5,17.0,24.083333333333332,29.0,19.36875,25.0,15.3,17.0,23.4375,25.0,19.0,0.0,1.0,13.0,0.5263157894736842,25.0,23.72121212121212,28.0,25.2,28.0,19.0,3.1,2.6,15.0,23.5,1.0,1.0,14.0,15.5,30.0,55.0,35.0,13.0,2.0,1.0,0.0,13.5,3.5,1290.0,614.0,8.0,3.0,5.8,7.2,30.5,25.0,21.5,24.0,0.0,0.0,319.0,442.0,31.0,-123.0,27.0,23.0,609.0,548.0,16.0,7.5,0.6467661691542289,0.5823412698412699,15.0,2.0,2.131868131868132,17.0,30.0,4.9,6.2,31.0,10.0,34.0,31.0,9.5,0.7894736842105263,0.7391304347826086,10.0,4.0,0.7246321421746608,0.7011437095972153,10.0,9.0,3792.0,4230.0,30.0,15.0,113.0,997.0,978.0,27.0,26.0,106.0,21.5,20.0,0.11490683229813665,0.061538461538461535,30.0,3.0,5.7,5.9,23.0,19.0,1005.0,1008.0,13.0,23.0,72.0,1.0,0.0,16.5,21.0,33.0,19.5,3107.0,2109.0,1.0,22.0,49.0,1.0,19.0,0.0,1.0,26.0,21.5,109.0,335.0,21.0,32.0,1.68,2.38,32.0,20.0,21.0,30.0,87.3,101.7,31.0,16.0,4035.0,14.0,0.4690721649484536,16.0,0.3532338308457711,0.4176587301587301,18.0,31.0,0.21052631578947367,0.2608695652173913,23.0,29.0,0.27536785782533924,0.2988562904027847,23.0,24.0,355.0,421.0,14.5,30.0,8.0,12.0,17.5,26.0,1441.0,1803.0,17.0,27.0,18.77777777777778,22.0,27.8,44.6,32.0,28.0,0.0,0.0,41.0,6.3,6.6,16.0,18.5,243.0,228.0,19.0,20.0,39.0,17.0,19.0,16.0,39.0,31.0,32.0,12.0,33.0,31.5,32.0,29.0,16.1,12.4,19.0,29.0,24.0,20.5,-5.0,23.0,26.5,22.242424242424242,28.0,28980.0,28851.0,17.0,Chicago Bears,5233.0,6033.0,30.0,21.0,94.3,100.0,20.0,32.0,35.0,49.0,30.0,18.5,33.0,49.0,30.0,20.5,6.6,8.1,30.0,29.0,4.1,4.3,21.5,17.5,10.2,12.2,26.0,31.0,23.5,17.5,1.0,14.5,5.2,10.2,24.0,32.0,5.2,6.0,29.5,22.5,43.2,43.0,2.5,27.0,29.0,34.0,30.0,21.0,-800.0,28.0,1.6097560975609757,1.8837209302325584,8.0,23.0
181.0,188.0,22.0,17.0,302.0,300.0,2.5,23.0,191.0,195.0,17.0,17.0,67.0,77.0,6.5,30.0,44.0,28.0,11.0,1.5,5.0,0.0,2.0,0.0,6.2,6.2,16.5,14.0,6015.0,31.0,6.8,7.0,15.5,19.0,32.0,158.0,154.0,12.0,15.0,0.8999999999999986,15.0,26.9,26.0,6.0,21.0,320.0,56.3,63.0,17.0,31.0,365.0,24.5,24.5,24.0,7.0,16.333333333333332,18.0,-15.68,55.43,-31.99,7.0,18.0,-59.05,27.44,13.0,30.0,3.41,7.0,23.0,87.9,78.1,3.0,9.0,0.0,5.0,14.0,11.0,3.0,0.0,5.0,12.0,10.0,2.0,5.0,7.0,24.5,4.0,16.583333333333332,17.0,20.8,28.0,15.1,16.0,26.5,30.0,16.0,1.0,0.0,7.0,0.3125,4.5,17.82020202020202,18.0,16.6,18.0,12.0,2.1,3.1,10.0,8.5,3.0,1.0,18.0,8.5,10.0,22.0,37.0,16.5,30.0,0.0,0.0,13.5,19.0,417.0,967.0,20.0,32.0,6.4,6.8,24.5,18.0,20.916666666666668,23.0,0.0,0.0,310.0,299.0,5.0,11.0,16.0,24.0,568.0,579.0,25.0,15.0,0.6002014098690835,0.6079207920792079,6.0,15.0,2.8507462686567164,7.0,21.0,3.7,3.8,8.0,24.5,22.0,8.0,20.5,0.7777777777777778,0.7096774193548387,13.0,5.0,0.7443315089913995,0.7048039382108301,8.0,4.0,3808.0,4152.0,29.0,14.0,91.0,707.0,1192.0,32.0,5.0,130.0,31.0,6.0,0.1456953642384106,0.09333333333333334,21.0,1.0,5.7,5.5,9.0,19.0,993.0,1010.0,14.0,26.0,92.0,2.0,0.0,16.5,31.0,32.0,17.0,3815.0,3544.0,20.0,6.0,78.0,20.5,4.0,1.0,0.0,10.0,7.0,277.0,284.0,18.0,14.0,1.52,1.55,5.0,27.0,26.0,26.0,81.8,86.0,11.0,25.0,3990.0,16.0,0.3507853403141361,26.0,0.3997985901309165,0.3920792079207921,27.0,18.0,0.2222222222222222,0.29032258064516125,20.0,28.0,0.25566849100860045,0.2951960617891699,25.0,29.0,397.0,396.0,8.0,24.0,6.0,9.0,9.0,30.0,1308.0,1739.0,13.0,31.0,20.148148148148152,26.0,30.9,29.8,6.0,23.5,0.0,0.0,28.0,4.7,5.7,25.5,9.0,182.0,244.0,16.0,9.0,35.0,24.0,6.5,33.0,32.0,17.0,13.0,29.0,25.0,13.0,10.5,17.0,9.4,12.8,15.5,5.0,25.0,16.5,8.0,5.0,4.5,19.04040404040404,26.0,28598.0,28952.0,20.0,Arizona Cardinals,5116.0,5891.0,24.0,24.0,100.0,100.0,20.0,13.5,27.0,32.0,7.0,29.5,27.0,32.0,7.5,29.5,7.0,7.6,23.0,22.0,3.3,4.4,25.5,32.0,12.5,12.0,23.5,3.5,19.0,26.1,26.0,32.0,10.7,8.9,15.5,9.0,5.2,5.8,25.5,22.5,41.5,45.4,21.5,31.0,28.3,31.3,25.0,23.0,-775.0,27.0,2.121212121212121,1.7272727272727268,16.0,2.0
178.0,175.0,5.5,23.5,303.0,308.0,8.0,22.0,165.0,188.0,8.0,26.0,104.0,83.0,9.5,9.5,34.0,37.0,26.0,13.5,0.0,0.0,0.0,0.0,5.6,5.2,5.5,23.0,6943.0,18.0,6.9,5.9,6.0,16.0,33.0,171.0,160.0,20.5,6.5,2.0,9.5,27.8,25.8,5.0,16.5,292.0,60.0,58.8,5.0,24.5,324.0,5.5,29.0,18.0,15.5,7.583333333333333,4.0,10.63,46.81,-46.52,11.0,19.0,-32.96,29.0,12.0,19.0,-8.98,10.0,18.0,80.6,100.0,32.0,24.0,0.0,6.0,9.0,7.0,9.0,0.0,6.0,8.0,5.0,6.0,12.0,6.0,28.0,24.0,12.083333333333334,9.0,16.10625,18.0,19.9,25.0,12.3125,10.0,18.0,1.0,1.0,11.0,0.6666666666666666,30.0,13.067845117845119,10.0,11.9,10.0,10.0,2.1,4.2,1.0,8.5,2.0,1.0,23.0,1.0,5.5,45.0,40.0,19.0,9.0,0.0,0.0,13.5,19.0,1104.0,907.0,17.0,8.0,5.7,6.0,8.5,28.0,18.416666666666668,20.0,0.0,1.0,306.0,340.0,10.0,-34.0,22.0,25.0,487.0,551.0,17.0,29.0,0.5341922695738355,0.5935288169868554,12.0,26.0,1.5865384615384617,28.0,20.0,4.1,5.3,27.0,18.0,29.0,26.0,24.0,0.6666666666666666,0.8055555555555556,3.0,19.5,0.5846535598396639,0.6865642621038305,16.0,30.0,3063.0,3531.0,5.0,30.0,116.0,937.0,909.0,20.0,19.0,122.0,29.0,23.0,0.1122112211221122,0.12012987012987013,5.0,6.0,5.8,5.8,19.0,14.0,1009.0,989.0,8.0,20.5,73.0,1.0,0.0,16.5,21.0,36.0,23.5,3369.0,3362.0,16.0,13.0,74.0,13.0,17.5,0.0,1.0,26.0,21.5,227.0,336.0,22.0,23.0,1.6,1.78,15.0,22.0,35.0,13.0,86.3,79.5,4.0,18.0,3407.0,31.0,0.6303030303030303,5.0,0.4658077304261645,0.40647118301314455,21.0,7.0,0.33333333333333337,0.1944444444444444,30.0,13.5,0.415346440160336,0.3134357378961695,17.0,3.0,470.0,402.0,10.0,9.0,10.0,7.0,4.0,22.0,2176.0,1612.0,7.0,4.0,17.530864197530864,18.0,30.9,32.0,11.0,23.5,0.0,0.0,52.0,9.6,6.1,20.0,30.5,344.0,200.0,24.0,30.0,36.0,22.0,29.5,31.0,20.0,3.0,18.5,25.0,20.0,5.0,19.0,22.0,11.8,16.6,2.0,16.0,29.0,4.5,7.0,7.0,11.5,14.235690235690237,11.0,30438.0,28000.0,6.0,San Francisco 49ers,5239.0,5143.0,5.0,20.0,100.0,100.0,20.0,13.5,33.0,40.0,18.0,21.0,33.0,40.0,19.0,20.5,7.0,6.8,8.5,22.0,4.6,4.0,9.5,4.0,11.7,11.5,17.5,15.0,24.5,22.7,11.0,9.5,6.5,9.3,18.0,29.0,5.2,5.2,7.0,22.5,46.2,45.4,21.5,8.0,29.4,29.3,10.5,18.5,96.0,15.0,1.5217391304347827,1.7,17.0,26.5
192.0,182.0,16.5,10.0,318.0,307.0,6.5,17.0,186.0,195.0,17.0,19.5,88.0,77.0,6.5,19.5,44.0,35.0,24.0,1.5,1.0,0.0,0.0,0.0,5.9,7.9,32.0,18.0,7159.0,16.0,7.3,8.9,32.0,10.0,33.0,154.0,156.0,15.0,19.5,-4.899999999999999,30.0,25.1,30.0,29.0,31.0,364.0,66.5,66.5,28.5,4.0,345.0,15.0,14.0,0.0,32.0,20.833333333333332,23.0,4.71,22.45,-172.2,32.0,22.0,-11.85,51.95,8.0,9.0,-104.87,29.0,20.0,88.9,84.6,19.0,7.5,0.0,11.0,7.0,8.0,1.0,0.0,11.0,6.0,7.0,0.0,13.0,12.0,7.5,26.5,25.541666666666668,30.0,17.13125,19.0,16.95,19.0,17.3125,18.0,31.0,0.0,2.0,31.5,0.41935483870967744,13.0,21.134343434343435,27.0,23.4,27.0,18.0,3.3,1.3,28.5,28.0,0.0,2.0,7.0,28.5,27.5,36.0,43.0,21.0,19.5,0.0,1.0,29.5,19.0,783.0,1111.0,24.0,23.0,6.7,7.2,30.5,10.0,18.333333333333332,19.0,0.0,1.0,301.0,438.0,29.5,-137.0,29.0,26.0,547.0,519.0,2.0,18.0,0.6013916500994035,0.5686475409836066,21.0,14.0,2.113636363636364,19.0,18.0,3.3,6.7,32.0,28.5,35.0,32.0,27.5,0.5454545454545454,0.7608695652173914,7.0,28.0,0.7052980132450332,0.6985294117647058,11.0,14.0,4047.0,3990.0,24.0,11.0,120.0,1130.0,1164.0,31.0,31.0,144.0,32.0,28.0,0.13836477987421386,0.11400651465798045,8.0,2.0,5.4,5.5,9.0,26.0,1006.0,976.0,3.5,22.0,78.0,1.0,0.0,16.5,21.0,42.0,28.5,3659.0,3522.0,19.0,9.0,80.0,22.0,12.0,0.0,1.0,26.0,21.5,208.0,397.0,29.0,25.5,1.58,2.13,28.0,23.5,29.0,22.0,88.8,108.3,32.0,15.0,4461.0,8.0,0.4731182795698925,14.0,0.3986083499005965,0.4313524590163934,12.0,19.0,0.4545454545454546,0.23913043478260865,26.0,5.0,0.29470198675496684,0.30147058823529416,22.0,19.0,401.0,421.0,14.5,21.0,15.0,11.0,15.0,9.5,1691.0,1722.0,12.0,19.0,16.962962962962965,17.0,29.7,37.4,25.0,25.0,0.0,0.0,58.0,9.6,6.5,18.5,30.5,414.0,241.0,17.0,31.0,36.0,22.0,31.0,27.0,26.0,8.0,24.0,24.0,22.0,9.0,23.5,31.0,15.6,8.8,28.0,28.0,19.0,25.5,-12.0,30.0,29.5,18.86868686868687,24.0,29568.0,28392.0,11.0,Washington Redskins,5738.0,5712.0,20.0,13.0,96.9,98.0,7.0,29.5,32.0,51.0,32.0,23.0,31.0,50.0,31.5,24.0,8.2,8.2,31.5,3.5,4.2,4.1,13.0,14.5,12.3,12.3,28.0,5.5,21.8,25.8,23.0,24.5,7.2,9.5,19.0,20.5,5.7,5.9,27.0,9.5,46.9,44.0,14.0,2.0,29.9,31.2,23.5,17.0,26.0,17.0,1.9523809523809519,2.0,4.0,9.0
193.0,198.0,28.5,8.5,294.0,348.0,29.0,24.0,179.0,184.0,5.5,22.0,88.0,126.0,32.0,19.5,27.0,38.0,27.0,24.0,2.0,0.0,0.0,0.0,5.6,5.0,3.0,23.0,6410.0,28.0,6.4,5.6,2.0,24.5,32.0,140.0,154.0,12.0,28.0,-0.6999999999999993,21.5,26.8,27.5,15.0,22.0,274.0,54.6,57.1,1.0,32.0,335.0,8.0,32.0,20.0,11.0,16.5,19.0,-32.0,23.61,0.66,3.0,21.0,-47.08,-7.89,31.0,26.0,0.76,8.0,25.0,78.1,85.3,21.0,28.0,0.0,6.0,15.0,8.0,3.0,0.0,6.0,12.0,6.0,1.0,7.0,8.0,21.5,7.0,16.666666666666668,18.0,17.41875,21.0,21.9,28.0,12.9375,14.0,17.0,1.0,1.0,10.0,0.4117647058823529,12.0,20.754208754208754,26.0,22.0,26.0,16.0,3.2,3.6,2.0,26.5,2.0,0.0,21.0,2.0,21.0,37.0,31.0,8.5,17.5,0.0,0.0,13.5,19.0,801.0,695.0,11.0,21.0,6.5,5.8,5.5,16.0,22.416666666666668,26.0,0.0,0.0,299.0,337.0,9.0,-38.0,25.0,27.0,502.0,587.0,26.0,26.0,0.5277227722772277,0.5527728085867621,29.0,27.0,2.034090909090909,20.0,12.0,2.4,3.7,6.5,32.0,22.0,8.0,32.0,0.4137931034482759,0.6285714285714286,23.0,32.0,0.6672443674176777,0.6132832508109954,32.0,20.0,3465.0,3592.0,8.0,20.0,116.0,932.0,769.0,6.0,17.5,98.0,8.0,23.0,0.09183673469387756,0.10919540229885058,10.0,19.0,5.4,5.8,19.0,26.0,1010.0,1118.0,32.0,19.0,93.0,0.0,0.0,16.5,6.5,42.0,28.5,4119.0,3790.0,28.0,3.0,86.0,28.0,3.0,0.0,0.0,10.0,21.5,181.0,295.0,19.0,30.0,1.44,1.68,11.0,28.0,27.0,24.5,72.8,74.1,1.0,31.0,3678.0,22.0,0.4916201117318436,13.0,0.4722772277227722,0.447227191413238,4.0,6.0,0.5862068965517242,0.3714285714285713,10.0,1.0,0.3327556325823223,0.38671674918900456,1.0,13.0,477.0,500.0,31.0,6.0,17.0,13.0,19.5,4.0,1728.0,2265.0,32.0,17.0,19.641975308641975,25.0,28.0,32.3,12.0,27.0,1.0,0.0,31.0,5.8,5.0,27.0,15.0,213.0,191.0,26.0,15.0,31.0,27.0,13.5,32.0,34.0,21.0,16.0,25.0,29.0,20.5,19.0,23.0,10.9,13.6,9.5,11.0,29.0,4.5,6.0,9.5,15.5,19.50841750841751,27.0,27020.0,30492.0,28.0,Cleveland Browns,5193.0,5857.0,23.0,23.0,100.0,100.0,20.0,13.5,30.0,34.0,9.5,26.0,30.0,34.0,9.5,26.0,7.3,6.4,4.0,13.5,3.6,4.5,28.0,29.0,13.4,11.3,13.0,1.0,21.6,22.4,9.0,28.0,6.7,7.0,8.0,28.0,5.1,5.2,7.0,26.5,44.3,44.1,15.0,21.0,26.8,29.3,10.5,27.0,-664.0,26.0,2.0277777777777777,1.4222222222222225,31.0,4.0
186.0,183.0,19.0,13.5,289.0,300.0,2.5,25.0,154.0,194.0,14.5,31.5,112.0,74.0,4.0,5.0,23.0,32.0,17.5,28.0,4.0,0.0,0.0,0.0,4.8,7.0,26.5,29.5,7076.0,17.0,5.7,8.2,30.5,30.0,27.0,160.0,154.0,12.0,13.5,-0.6999999999999993,21.5,27.8,28.5,24.0,16.5,287.0,57.6,64.1,21.0,29.0,345.0,15.0,30.5,2.0,31.0,14.75,10.0,-47.78,-10.34,-99.33,23.0,28.0,-19.76,21.38,15.0,14.0,-74.3,26.0,26.0,82.1,81.3,10.5,22.0,0.0,13.0,7.0,13.0,6.0,0.0,13.0,7.0,9.0,3.0,9.0,7.0,24.5,14.0,18.083333333333332,22.5,17.29375,20.0,25.4,31.0,9.1875,5.0,25.0,0.0,0.0,25.0,0.36,7.0,19.65723905723906,25.0,20.7,23.0,15.0,3.0,1.1,31.0,21.0,0.0,3.0,6.0,31.0,17.0,58.0,51.0,27.0,1.0,0.0,0.0,13.5,19.0,1342.0,1110.0,23.0,2.0,5.4,6.4,18.0,30.0,21.916666666666668,25.0,0.0,1.0,283.0,401.0,24.0,-118.0,26.0,28.0,498.0,538.0,7.5,27.0,0.5180608365019012,0.5973360655737705,9.0,28.0,1.375,30.0,16.0,3.2,5.8,30.0,30.0,31.0,30.0,30.0,0.5925925925925926,0.7560975609756098,8.0,26.0,0.563719862227325,0.7155682903533906,5.0,31.0,2946.0,3746.0,14.0,32.0,109.0,932.0,780.0,7.0,17.5,91.0,2.5,16.0,0.07958477508650519,0.10666666666666667,12.0,28.0,5.9,5.5,9.0,10.5,1052.0,976.0,3.5,10.0,79.0,1.0,0.0,16.5,21.0,25.0,5.5,3580.0,3757.0,27.0,11.0,81.0,23.0,10.5,0.0,0.0,10.0,21.5,273.0,250.0,14.5,16.0,1.53,2.03,24.0,26.0,43.0,3.0,75.1,101.5,30.0,29.0,3206.0,32.0,0.7272727272727273,3.0,0.4819391634980989,0.4026639344262295,24.0,5.0,0.4074074074074073,0.24390243902439024,25.0,7.0,0.4362801377726751,0.2844317096466093,28.0,2.0,507.0,393.0,7.0,4.0,11.0,10.0,12.0,18.5,2280.0,1489.0,5.0,3.0,19.3641975308642,24.0,31.7,37.2,24.0,22.0,1.0,1.0,47.0,8.6,7.7,5.0,25.0,260.0,310.0,4.0,23.0,45.0,6.5,24.5,39.0,32.0,17.0,1.0,32.0,26.0,16.0,3.5,24.0,11.8,5.5,32.0,16.0,13.0,32.0,-11.0,29.0,19.0,18.614478114478118,23.0,29760.0,28182.0,9.0,New York Jets,5226.0,5235.0,6.0,22.0,100.0,97.7,5.0,13.5,23.0,44.0,24.5,31.5,23.0,43.0,23.5,31.5,6.4,7.5,20.5,30.0,4.5,3.8,6.0,7.5,11.2,11.8,21.5,22.0,23.1,21.8,7.0,19.0,6.3,10.0,23.0,30.0,5.0,5.4,16.0,29.0,45.3,46.4,28.0,15.0,28.0,28.4,8.0,25.0,-9.0,18.0,1.4222222222222225,1.973684210526316,5.0,31.0
180.0,185.0,21.0,19.5,263.0,353.0,30.0,30.0,162.0,223.0,30.0,28.0,72.0,103.0,22.5,28.5,29.0,27.0,8.5,20.5,0.0,0.0,0.0,0.0,4.8,6.7,23.5,29.5,6051.0,30.0,5.9,7.5,22.5,29.0,31.0,146.0,172.0,31.0,26.0,-4.599999999999998,29.0,26.6,31.2,30.0,23.0,301.0,56.7,68.7,32.0,30.0,387.0,31.0,26.0,18.0,15.5,21.333333333333332,24.0,-68.29,-17.44,-137.68,31.0,29.0,-42.31,55.01,5.0,23.0,-72.07,25.0,29.0,83.3,74.4,1.0,18.5,0.0,3.0,8.0,7.0,6.0,0.0,2.0,7.0,6.0,5.0,13.0,11.0,12.5,26.5,20.5,26.0,25.63125,32.0,23.45,29.0,27.8125,31.0,29.0,0.0,1.0,30.0,0.4482758620689655,16.0,25.71936026936027,29.0,28.9,30.0,20.0,3.8,2.5,17.5,32.0,3.0,1.0,14.0,15.5,31.0,36.0,37.0,16.5,19.5,0.0,0.0,13.5,19.0,819.0,868.0,15.0,18.0,5.7,6.8,24.5,28.0,28.583333333333332,31.0,0.0,0.0,277.0,410.0,25.0,-133.0,28.0,29.0,531.0,563.0,21.0,21.0,0.6228632478632479,0.5613870665417057,25.0,7.0,2.25,15.0,21.0,4.0,5.0,23.0,20.0,28.0,23.0,20.5,0.75,0.6511627906976745,20.0,9.0,0.7056934931506851,0.6918516008809079,15.0,13.0,3297.0,4084.0,28.0,25.0,118.0,939.0,935.0,22.0,20.5,106.0,21.5,25.5,0.11026615969581748,0.0764872521246459,26.0,7.0,5.3,6.0,27.5,28.5,936.0,1067.0,26.5,31.0,79.0,1.0,0.0,16.5,21.0,32.0,17.0,3154.0,2826.0,6.0,20.0,64.0,6.0,10.5,0.0,1.0,26.0,21.5,249.0,185.0,3.0,20.0,1.42,2.1,26.0,29.0,23.0,28.5,75.2,97.4,27.0,28.0,3623.0,23.0,0.4444444444444444,18.0,0.3771367521367521,0.4386129334582943,8.0,26.0,0.25,0.34883720930232553,13.0,24.0,0.29430650684931503,0.308148399119092,18.0,20.0,353.0,468.0,27.0,31.0,7.0,15.0,25.0,27.5,1375.0,1819.0,19.0,29.0,16.086419753086417,13.0,26.7,38.9,26.0,29.0,0.0,2.0,52.0,8.9,6.0,21.5,26.5,326.0,210.0,23.0,27.5,36.0,22.0,29.5,24.0,39.0,31.0,28.0,20.0,29.0,20.5,27.5,33.0,17.2,13.0,14.0,31.5,25.0,16.5,-8.0,26.5,31.0,22.53872053872054,29.0,26280.0,31820.0,30.0,Tampa Bay Buccaneers,4672.0,5903.0,25.0,30.0,100.0,100.0,20.0,13.5,31.0,41.0,20.0,25.0,31.0,41.0,21.5,24.0,6.8,7.6,23.0,26.5,3.9,3.9,7.0,23.5,12.0,11.1,9.5,10.5,22.8,23.5,16.5,20.0,10.8,5.8,2.0,8.0,5.0,5.5,21.5,29.0,39.9,44.2,16.5,32.0,25.8,31.8,28.0,28.5,-1231.0,31.0,1.7435897435897436,1.948717948717949,7.0,19.0
191.0,191.0,23.0,11.5,258.0,357.0,31.0,31.0,159.0,211.0,27.5,30.0,75.0,119.0,31.0,26.0,24.0,27.0,8.5,26.5,1.0,0.0,0.0,0.0,5.5,6.5,21.5,25.5,6594.0,24.0,6.7,7.4,21.0,21.5,28.0,138.0,163.0,27.0,29.0,-4.099999999999998,27.0,25.8,29.9,28.0,27.0,299.0,58.3,63.7,19.0,26.5,347.0,17.0,27.0,14.0,19.5,26.166666666666668,31.0,-99.02,-41.89,-112.22,25.0,30.0,-40.88,8.86,25.0,22.0,-85.48,28.0,30.0,86.4,84.6,19.0,11.0,0.0,5.0,7.0,8.0,2.0,0.0,5.0,7.0,5.0,2.0,10.0,4.0,32.0,17.0,23.166666666666668,28.0,22.94375,29.0,20.7,26.0,25.1875,28.0,23.0,1.0,1.0,22.5,0.43478260869565216,14.0,26.235016835016836,31.0,28.8,29.0,16.0,3.1,2.2,22.0,23.5,1.0,1.0,12.0,22.5,21.0,48.0,31.0,8.5,6.0,0.0,1.0,29.5,19.0,1121.0,855.0,14.0,7.0,6.1,6.5,19.0,20.0,24.916666666666668,29.0,0.0,0.0,254.0,438.0,29.5,-184.0,31.0,30.0,513.0,545.0,13.5,24.0,0.6126224156692056,0.5313921747042766,32.0,10.0,2.12,18.0,20.0,3.9,5.1,25.5,22.5,28.0,23.0,24.0,0.7692307692307693,0.6222222222222222,25.0,6.0,0.7022020991973658,0.6322050938337802,30.0,16.0,3412.0,3773.0,15.0,22.0,111.0,961.0,731.0,2.0,22.0,93.0,5.0,18.0,0.09302325581395347,0.07563025210084033,27.0,18.0,4.9,6.0,27.5,32.0,919.0,1099.0,30.0,32.0,89.0,1.0,0.0,16.5,21.0,43.0,30.0,4118.0,3356.0,15.0,4.0,73.0,12.0,5.0,0.0,0.0,10.0,21.5,207.0,350.0,24.0,27.0,1.25,2.17,29.0,30.0,30.0,19.0,81.0,93.6,25.0,26.0,3738.0,20.0,0.4716981132075472,15.0,0.3873775843307944,0.4686078252957234,1.0,23.0,0.23076923076923075,0.37777777777777777,8.0,27.0,0.29779790080263424,0.3677949061662198,3.0,17.0,356.0,515.0,32.0,29.0,6.0,17.0,29.0,30.0,1447.0,2195.0,31.0,26.0,18.679012345679016,21.0,23.6,40.8,29.0,30.0,1.0,2.0,50.0,8.9,6.7,14.0,26.5,326.0,222.0,20.0,27.5,39.0,17.0,27.0,22.0,39.0,31.0,30.0,19.0,33.0,31.5,30.0,26.0,12.6,8.4,29.0,19.5,16.0,29.0,-10.0,28.0,22.0,23.67003367003367,31.0,26358.0,31133.0,29.0,Tennessee Titans,4859.0,5968.0,27.0,29.0,100.0,100.0,20.0,13.5,27.0,47.0,28.5,29.5,27.0,47.0,29.0,29.5,7.3,7.3,17.5,13.5,4.1,4.3,21.5,17.5,12.5,11.5,17.5,3.5,23.4,27.6,30.0,16.0,6.9,8.1,11.5,26.5,5.3,5.4,16.0,18.0,46.3,46.0,27.0,7.0,25.3,31.2,23.5,30.0,-1109.0,29.0,1.7804878048780488,1.6976744186046513,18.0,16.0
198.0,197.0,27.0,3.5,248.0,320.0,18.0,32.0,173.0,190.0,11.0,23.0,56.0,95.0,18.0,32.0,19.0,35.0,24.0,32.0,0.0,0.0,0.0,0.0,4.6,7.1,28.5,31.0,5976.0,32.0,5.0,7.7,25.5,32.0,28.0,137.0,154.0,12.0,30.0,-8.7,32.0,24.2,32.9,32.0,32.0,365.0,58.0,63.8,20.0,28.0,343.0,13.0,12.5,12.0,24.5,22.583333333333332,27.0,-139.12,-60.61,-127.44,28.0,31.0,-71.76,48.36,9.0,32.0,-56.86,23.0,32.0,86.4,84.2,17.0,11.0,0.0,2.0,5.0,10.0,5.0,0.0,2.0,5.0,9.0,3.0,13.0,5.0,30.5,26.5,25.75,31.0,25.0125,31.0,19.4,24.0,30.625,32.0,28.0,1.0,2.0,29.0,0.4642857142857143,19.0,27.65016835016835,32.0,30.6,32.0,16.0,2.5,1.7,27.0,17.5,0.0,2.0,9.0,27.0,21.0,47.0,21.0,3.0,7.0,0.0,0.0,13.5,19.0,1027.0,683.0,10.0,14.0,5.0,6.8,24.5,31.0,29.833333333333332,32.0,1.0,0.0,253.0,452.0,32.0,-199.0,32.0,31.0,629.0,538.0,7.5,4.0,0.6609657947686117,0.5379442843419788,31.0,1.0,3.0892857142857144,3.0,22.0,3.5,5.4,28.0,27.0,29.0,26.0,18.0,0.8461538461538461,0.6304347826086957,22.0,1.0,0.7253599114064231,0.6659674882013634,21.0,8.0,3275.0,3810.0,16.0,26.0,116.0,939.0,941.0,24.0,20.5,116.0,27.0,23.0,0.07661290322580645,0.109375,9.0,29.0,5.1,5.5,9.0,31.0,994.0,1041.0,24.0,25.0,109.0,0.0,0.0,16.5,6.5,47.0,31.0,4930.0,3634.0,24.0,1.0,83.0,26.0,1.0,0.0,1.0,26.0,21.5,261.0,513.0,32.0,18.0,1.21,2.12,27.0,31.0,37.0,9.5,74.4,96.9,26.0,30.0,3456.0,28.0,0.3236994219653179,30.0,0.3390342052313883,0.4620557156580212,2.0,32.0,0.15384615384615385,0.3695652173913043,11.0,32.0,0.2746400885935769,0.3340325117986366,12.0,25.0,337.0,481.0,29.0,32.0,4.0,17.0,29.0,32.0,1240.0,1911.0,22.0,32.0,20.679012345679013,28.0,22.7,39.6,27.0,31.0,0.0,0.0,28.0,4.3,3.9,30.0,5.0,181.0,157.0,29.0,8.0,22.0,30.5,6.5,22.0,38.0,28.5,30.0,19.0,32.0,29.5,30.0,29.0,13.6,6.6,31.0,25.0,14.0,30.5,-15.0,32.0,26.5,24.7003367003367,32.0,27126.0,30338.0,27.0,Oakland Raiders,4515.0,5721.0,21.0,32.0,100.0,100.0,20.0,13.5,28.0,50.0,31.0,28.0,28.0,50.0,31.5,28.0,5.5,7.4,19.0,32.0,3.7,4.0,9.5,26.5,9.5,11.6,19.0,32.0,21.9,32.5,32.0,23.0,7.1,10.9,28.0,23.0,4.5,5.5,21.5,32.0,45.2,43.8,12.0,16.0,22.6,29.1,9.0,32.0,-1206.0,30.0,1.4864864864864864,1.85,11.0,28.0
195.0,193.0,24.0,6.0,271.0,330.0,24.0,29.0,154.0,200.0,22.0,31.5,86.0,107.0,25.0,21.0,31.0,23.0,4.0,17.0,4.0,0.0,1.0,0.0,4.0,7.0,26.5,32.0,6424.0,27.0,5.3,8.1,29.0,31.0,27.0,134.0,163.0,27.0,31.0,-4.100000000000001,28.0,25.7,29.8,27.0,28.5,325.0,58.3,65.6,26.0,26.5,355.0,20.0,21.0,20.0,11.0,22.416666666666668,26.0,-126.33,-103.83,-67.17,19.0,32.0,-8.91,20.76,17.0,8.0,-39.34,18.0,31.0,76.9,88.6,27.0,29.0,0.0,3.0,8.0,9.0,6.0,0.0,3.0,7.0,7.0,3.0,8.0,14.0,3.0,10.5,18.083333333333332,22.5,22.95,30.0,26.15,32.0,19.75,20.0,15.0,2.0,1.0,3.5,0.5333333333333333,26.0,25.904713804713804,30.0,29.2,31.0,18.0,3.2,1.1,31.0,26.5,1.0,4.0,6.0,31.0,27.5,43.0,22.0,4.0,12.0,0.0,0.0,13.5,19.0,1033.0,516.0,1.0,13.0,4.8,6.7,21.5,32.0,25.583333333333332,30.0,0.0,1.0,249.0,412.0,26.0,-163.0,30.0,32.0,557.0,541.0,10.0,16.0,0.6356275303643725,0.5400921658986175,30.0,4.0,1.7906976744186047,25.0,15.0,2.7,4.4,13.5,31.0,24.0,13.0,31.0,0.625,0.6153846153846154,26.5,25.0,0.6476046611998274,0.6572825354012137,23.0,23.0,3001.0,3899.0,22.0,31.0,73.0,573.0,886.0,18.0,1.0,115.0,26.0,1.0,0.11439114391143912,0.0696969696969697,29.0,4.0,5.2,5.8,19.0,30.0,988.0,1085.0,29.0,27.0,96.0,2.0,0.0,16.5,31.0,52.0,32.0,4464.0,3559.0,21.0,2.0,75.0,15.0,2.0,0.0,0.0,10.0,21.5,264.0,464.0,31.0,17.0,1.17,1.9,22.0,32.0,37.0,9.5,72.0,99.1,29.0,32.0,3451.0,29.0,0.5584415584415584,8.0,0.3643724696356275,0.4599078341013825,3.0,29.0,0.375,0.3846153846153846,6.5,8.0,0.3523953388001726,0.3427174645987863,10.0,10.0,360.0,499.0,30.0,28.0,9.0,15.0,25.0,24.5,1633.0,2033.0,27.0,21.0,18.901234567901234,23.0,22.6,36.3,22.0,32.0,1.0,2.0,71.0,11.3,7.7,5.0,32.0,450.0,275.0,8.0,32.0,45.0,6.5,32.0,26.0,35.0,23.0,26.0,20.0,31.0,27.0,27.5,26.0,12.8,9.8,26.0,21.5,20.0,24.0,-6.0,25.0,22.0,22.60942760942761,30.0,26130.0,31459.0,31.0,Jacksonville Jaguars,4634.0,5932.0,26.0,31.0,100.0,100.0,20.0,13.5,23.0,45.0,26.0,31.5,23.0,45.0,26.0,31.5,6.2,7.7,25.5,31.0,4.5,4.1,13.0,7.5,10.6,11.8,21.5,28.5,24.0,23.5,16.5,12.0,7.1,8.9,15.5,23.0,4.7,5.5,21.5,31.0,46.5,47.5,31.5,5.0,23.7,30.7,19.0,31.0,-1298.0,32.0,1.3777777777777778,1.878048780487805,9.0,32.0
184.71875,184.71875,16.5,16.5,320.5,320.5,16.5,16.5,196.5,196.5,16.5,16.5,92.7,92.7,16.5,16.5,31.3,31.3,16.5,16.5,1.8,1.8,0.9,0.9,6.1,6.1,16.5,16.5,7029.4,16.5,7.0,7.0,16.5,16.5,40.40625,157.09375,156.84375,16.5,16.5,-0.006249999999997868,16.5,27.85,27.85625,16.5,16.5,350.0,62.6,62.6,16.5,16.5,350.0,16.5,16.5,18.2,16.5,16.5,16.5,32.7765625,67.76625000000001,-67.76625000000001,16.5,16.5,-26.1,26.1,16.5,16.5,-32.7765625,16.5,16.5,84.0,84.0,16.5,16.5,0.3,7.7,9.4,8.6,4.8,0.3,7.5,8.5,6.6,2.9,9.6,9.6,16.5,16.5,16.5,16.5,16.5,16.5,16.5,16.5,16.5,16.5,20.9,0.9,0.9,16.5,0.4593301435406698,16.5,16.5,16.5,16.5,16.5,14.1,2.5,2.5,16.5,16.5,1.5,1.5,14.1,16.5,16.5,38.3,38.3,16.5,16.5,0.2,0.2,16.5,16.5,910.1,910.1,16.5,16.5,6.4,6.4,16.5,16.5,16.5,16.5,0.4,0.4,361.4,361.4,16.5,0.0,16.5,16.5,558.7,558.7,16.5,16.5,0.5824465488626379,0.5824465488626379,16.5,16.5,2.1197411003236244,16.5,25.2,4.5,4.5,16.5,16.5,25.2,16.5,16.5,0.6792452830188679,0.6792452830188679,16.5,16.5,0.6802147101592374,0.6802147101592374,16.5,16.5,3789.0,3789.0,16.5,16.5,105.8125,888.375,888.375,16.5,16.5,105.8125,16.5,16.5,0.09765990639625584,0.09765990639625584,16.5,16.5,5.721875,5.725000000000002,16.5,16.5,1024.3,1024.3,16.5,16.5,74.6,0.7,0.7,16.5,16.5,32.4,16.5,3340.5,3340.5,16.5,16.5,74.6,16.5,16.5,0.4,0.4,16.5,16.5,287.8,287.8,16.5,16.5,1.835625,1.8328124999999995,16.5,16.5,32.4,16.5,87.1,87.1,16.5,16.5,4028.1,16.5,0.4717557251908397,16.5,0.4175534511373621,0.4175534511373621,16.5,16.5,0.3207547169811321,0.3207547169811321,16.5,16.5,0.3197852898407626,0.3197852898407626,16.5,16.5,427.8,427.8,16.5,16.5,11.9,11.9,16.5,16.5,1781.3,1781.3,16.5,16.5,16.5,16.5,34.256249999999994,34.228125,16.5,16.5,0.7,0.7,37.9,6.3,6.3,16.5,16.5,239.1,239.1,16.5,16.5,37.9,16.5,16.5,30.8,30.8,16.5,16.5,25.9,25.9,16.5,16.5,23.7,12.025000000000002,12.0875,16.5,16.5,23.7,16.5,0.0,16.5,16.5,16.5,16.5,29018.1611328125,28971.9814453125,16.5,Avg Team,5570.3,5570.3,16.5,16.5,99.3,99.3,16.5,16.5,38.4,38.4,16.5,16.5,38.2,38.2,16.5,16.5,7.2,7.2,16.5,16.5,4.2,4.2,16.5,16.5,11.5,11.5,16.5,16.5,23.8,23.8,16.5,16.5,8.9,8.9,16.5,16.5,5.4,5.4,16.5,16.5,44.8,44.8,16.5,16.5,30.15,30.128125000000004,16.5,16.5,0.0,16.5,1.7142857142857142,1.7142857142857142,16.5,16.5
