#Dr,#Dr_Defense,#Dr_Defense_Low_Rank,#Dr_High_Rank,1stD,1stD_Defense,1stD_Defense_Low_Rank,1stD_High_Rank,1stDpass,1stDpass_Defense,1stDpass_Defense_Low_Rank,1stDpass_High_Rank,1stDrun,1stDrun_Defense,1stDrun_Defense_Low_Rank,1stDrun_High_Rank,1stPy,1stPy_Defense,1stPy_Defense_Low_Rank,1stPy_High_Rank,2PA,2PA_Defense,2PM,2PM_Defense,ANY/A,ANY/A_Defense,ANY/A_Defense_Low_Rank,ANY/A_High_Rank,APYd,APYd_High_Rank,AY/A,AY/A_Defense,AY/A_Defense_Low_Rank,AY/A_High_Rank,AllTD,AvgDriveTime,AvgDriveTime_Defense,AvgDriveTime_Defense_Low_Rank,AvgDriveTime_High_Rank,AvgFieldPositionDifferential,AvgFieldPositionDifferential_High_Rank,AvgStartingPosition,AvgStartingPosition_Defense,AvgStartingPosition_Defense_Low_Rank,AvgStartingPosition_High_Rank,Cmp,Cmp%,Cmp%_Defense,Cmp%_Defense_Low_Rank,Cmp%_High_Rank,Cmp_Defense,Cmp_Defense_Low_Rank,Cmp_High_Rank,DefensivePtsScored,DefensivePtsScored_High_Rank,Dscore,Dscore_Rank,ExpectedPoints,ExpectedPointsPassing,ExpectedPointsPassing_Defense,ExpectedPointsPassing_Defense_High_Rank,ExpectedPointsPassing_High_Rank,ExpectedPointsRunning,ExpectedPointsRunning_Defense,ExpectedPointsRunning_Defense_High_Rank,ExpectedPointsRunning_High_Rank,ExpectedPoints_Defense,ExpectedPoints_Defense_High_Rank,ExpectedPoints_High_Rank,FG%,FG%_Defense,FG%_Defense_Low_Rank,FG%_High_Rank,FGA019,FGA2029,FGA3039,FGA4049,FGA50Plus,FGM019,FGM2029,FGM3039,FGM4049,FGM50Plus,FL,FL_Defense,FL_Defense_High_Rank,FL_Low_Rank,FantasyDstScore,FantasyDstScore_Rank,FantasyOffenseScore,FantasyOffenseScore_Rank,FantasyPassScore,FantasyPassScore_Rank,FantasyRushScore,FantasyRushScore_Rank,Fmb,FmbTD,FmbTD_Defense,Fmb_Low_Rank,FumbleLostPercent,FumbleLostPercent_Low_Rank,GameControlPlusBalance,GameControlPlusBalance_Rank,GameControlScore,GameControlScore_Rank,Int,Int%,Int%_Defense,Int%_Defense_High_Rank,Int%_Low_Rank,IntTD,IntTD_Defense,Int_Defense,Int_Defense_High_Rank,Int_Low_Rank,KickRet,KickRet_Defense,KickRet_Defense_Low_Rank,KickRet_High_Rank,KrTD,KrTD_Defense,KrTD_Defense_Low_Rank,KrTD_High_Rank,KrYds,KrYds_Defense,KrYds_Defense_Low_Rank,KrYds_High_Rank,NY/A,NY/A_Defense,NY/A_Defense_Low_Rank,NY/A_High_Rank,Oscore,Oscore_Rank,OthTD,OthTD_Defense,PF,PF_Defense,PF_Defense_Low_Rank,PF_Differential,PF_Differential_High_Rank,PF_High_Rank,PassAtt,PassAtt_Defense,PassAtt_Defense_Low_Rank,PassAtt_High_Rank,PassPercent,PassPercent_Defense,PassPercent_Defense_High_Rank,PassPercent_High_Rank,PassRun1dRatio,PassRun1dRatio_High_Rank,PassTD,PassTD%,PassTD%_Defense,PassTD%_Defense_Low_Rank,PassTD%_High_Rank,PassTD_Defense,PassTD_Defense_Low_Rank,PassTD_High_Rank,PassTdPercent,PassTdPercent_Defense,PassTdPercent_Defense_High_Rank,PassTdPercent_High_Rank,PassYdPercent,PassYdPercent_Defense,PassYdPercent_Defense_High_Rank,PassYdPercent_High_Rank,PassYds,PassYds_Defense,PassYds_Defense_Low_Rank,PassYds_High_Rank,Pen,PenYds,PenYds_Defense,PenYds_Defense_Low_Rank,PenYds_Low_Rank,Pen_Defense,Pen_Defense_Low_Rank,Pen_Low_Rank,Penalty1dPercent,Penalty1dPercent_Defense,Penalty1dPercent_Defense_High_Rank,Penalty1dPercent_High_Rank,Plays/Drive,Plays/Drive_Defense,Plays/Drive_Defense_Low_Rank,Plays/Drive_High_Rank,Ply,Ply_Defense,Ply_Defense_Low_Rank,Ply_High_Rank,Pnt,PntBlck,PntBlck_Defense,PntBlck_Defense_Low_Rank,PntBlck_Low_Rank,PntRet_Defense,PntRet_Defense_Low_Rank,PntYds,PntYds_Defense,PntYds_Defense_Low_Rank,PntYds_High_Rank,Pnt_Defense,Pnt_Defense_Low_Rank,Pnt_High_Rank,PrTD,PrTD_Defense,PrTD_Defense_Low_Rank,PrTD_High_Rank,PrYds,PrYds_Defense,PrYds_Defense_Low_Rank,PrYds_High_Rank,Pts/Drive,Pts/Drive_Defense,Pts/Drive_Defense_Low_Rank,Pts/Drive_High_Rank,PuntRet,PuntRet_High_Rank,QbRating,QbRating_Defense,QbRating_Defense_Low_Rank,QbRating_High_Rank,RawPassYds,RawPassYds_High_Rank,RunPass1dRatio,RunPass1dRatio_High_Rank,RunPercent,RunPercent_Defense,RunPercent_Defense_High_Rank,RunPercent_High_Rank,RunTdPercent,RunTdPercent_Defense,RunTdPercent_Defense_High_Rank,RunTdPercent_High_Rank,RunYdPercent,RunYdPercent_Defense,RunYdPercent_Defense_High_Rank,RunYdPercent_High_Rank,RushAtt,RushAtt_Defense,RushAtt_Defense_Low_Rank,RushAtt_High_Rank,RushTD,RushTD_Defense,RushTD_Defense_Low_Rank,RushTD_High_Rank,RushYds,RushYds_Defense,RushYds_Defense_Low_Rank,RushYds_High_Rank,STscore,STscore_Rank,Sc%,Sc%_Defense,Sc%_Defense_Low_Rank,Sc%_High_Rank,Sfty,Sfty_Defense,Sk,Sk%,Sk%_Defense,Sk%_Defense_High_Rank,Sk%_Low_Rank,SkYds,SkYds_Defense,SkYds_Defense_High_Rank,SkYds_Low_Rank,Sk_Defense,Sk_Defense_High_Rank,Sk_Low_Rank,TFGA,TFGA_Defense,TFGA_Defense_Low_Rank,TFGA_High_Rank,TFGM,TFGM_Defense,TFGM_Defense_Low_Rank,TFGM_High_Rank,TO,TO%,TO%_Defense,TO%_Defense_High_Rank,TO%_Low_Rank,TO_Defense,TO_Defense_High_Rank,TO_Differential,TO_Differential_High_Rank,TO_Low_Rank,ThreePhaseScore,ThreePhaseScore_Rank,TimeOfPossession,TimeOfPossession_Defense,TimeOfPossession_High_Rank,Tm,TotalYds,TotalYds_Defense,TotalYds_Defense_Low_Rank,TotalYds_High_Rank,XP%,XP%_Defense,XP%_Defense_Low_Rank,XP%_High_Rank,XPA,XPA_Defense,XPA_Defense_Low_Rank,XPA_High_Rank,XPM,XPM_Defense,XPM_Defense_Low_Rank,XPM_High_Rank,Y/Apass,Y/Apass_Defense,Y/Apass_Defense_Low_Rank,Y/Apass_High_Rank,Y/Arun,Y/Arun_Defense,Y/Arun_Defense_Low_Rank,Y/Arun_High_Rank,Y/C,Y/C_Defense,Y/C_Defense_Low_Rank,Y/C_High_Rank,Y/KR,Y/KR_Defense,Y/KR_Defense_Low_Rank,Y/KR_High_Rank,Y/PR,Y/PR_Defense,Y/PR_Defense_Low_Rank,Y/PR_High_Rank,Y/Play,Y/Play_Defense,Y/Play_Defense_Low_Rank,Y/Play_High_Rank,Y/Pnt,Y/Pnt_Defense,Y/Pnt_Defense_Low_Rank,Y/Pnt_High_Rank,Yds/Drive,Yds/Drive_Defense,Yds/Drive_Defense_Low_Rank,Yds/Drive_High_Rank,Yds_Differential,Yds_Differential_High_Rank,YppYprRatio,YppYprRatio_Defense,YppYprRatio_Defense_High_Rank,YppYprRatio_High_Rank
180.0,183.0,9.0,27.0,353.0,358.0,30.0,5.0,230.0,246.0,32.0,5.0,89.0,96.0,18.0,21.5,34.0,16.0,2.0,3.0,1.0,0.0,0.0,5.0,9.4,6.0,19.5,1.0,8051.0,3.0,10.5,6.6,13.5,1.0,70.0,162.0,155.0,19.0,7.5,5.300000000000002,2.0,30.8,25.5,3.0,4.0,376.0,68.1,61.2,19.0,2.0,390.0,32.0,4.5,30.0,5.5,23.083333333333332,26.5,246.54,273.77,-64.64,21.0,2.0,-17.44,-6.29,25.0,12.0,-64.58,23.0,3.0,85.7,81.5,11.5,10.0,1.0,5.0,14.0,5.0,3.0,1.0,4.0,14.0,3.0,2.0,6.0,7.0,26.5,6.0,17.666666666666668,19.0,11.65625,9.0,2.25,1.0,21.0625,24.0,15.0,1.0,0.0,6.0,0.4,10.0,11.156397306397306,5.0,7.2,3.0,8.0,1.4,4.9,1.0,2.0,4.0,0.0,31.0,1.0,2.0,41.0,59.0,29.0,19.0,1.0,0.0,12.0,5.0,1005.0,1378.0,29.0,18.0,8.3,7.2,30.0,1.0,6.5,3.0,0.0,0.0,560.0,359.0,19.0,201.0,2.0,1.0,552.0,637.0,32.0,14.0,0.6002024291497976,0.6348903717826502,3.0,8.0,2.5842696629213484,3.0,51.0,9.2,4.6,22.0,1.0,29.0,27.5,1.0,0.8095238095238095,0.7435897435897436,5.0,3.0,0.7596420857759949,0.7283219438116932,2.0,3.0,4924.0,4796.0,32.0,3.0,76.0,591.0,948.0,24.0,2.0,122.0,30.5,1.5,0.09631728045325776,0.0446927374301676,31.0,14.0,5.6,5.9,27.5,13.0,988.0,1049.0,23.5,28.0,55.0,0.0,0.0,16.5,12.0,24.0,2.0,2506.0,0.0,16.5,30.0,58.0,2.5,30.0,1.0,1.0,23.0,9.5,295.0,305.0,14.0,21.0,2.85,1.89,23.0,2.0,27.0,30.5,122.6,80.6,9.5,1.0,5161.0,3.0,0.3869565217391304,30.0,0.3997975708502024,0.3651096282173498,30.0,25.0,0.19047619047619047,0.2564102564102564,28.0,30.0,0.24035791422400501,0.2716780561883068,31.0,30.0,395.0,383.0,5.0,26.0,12.0,10.0,10.0,17.0,1558.0,1789.0,14.0,27.0,15.969135802469136,14.0,48.3,33.9,21.0,2.0,0.0,2.0,41.0,6.9,4.4,32.0,22.0,237.0,192.0,26.5,17.0,29.0,28.5,21.5,28.0,27.0,5.5,23.0,24.0,22.0,7.0,19.0,14.0,6.1,20.2,1.0,2.0,38.0,1.5,24.0,2.0,2.0,15.112794612794612,11.0,29160.0,28365.0,13.0,Green Bay Packers,6482.0,6585.0,32.0,3.0,98.6,100.0,20.0,26.0,69.0,35.0,12.0,1.0,68.0,35.0,12.5,1.0,9.3,7.8,26.5,1.0,3.9,4.7,26.0,27.0,13.7,12.8,27.0,1.5,24.5,23.4,15.0,11.5,10.9,12.7,28.0,12.0,6.6,6.3,31.5,2.0,45.6,0.0,16.5,15.0,36.0,35.9,31.0,4.0,-103.0,17.0,2.3846153846153846,1.6595744680851063,20.0,2.0
175.0,182.0,8.0,30.0,416.0,326.0,22.0,1.0,280.0,196.0,23.5,1.0,116.0,92.0,13.5,6.0,20.0,38.0,28.0,28.5,3.0,0.0,2.0,0.0,8.2,6.4,25.0,3.0,9052.0,1.0,8.8,7.2,24.0,3.0,66.0,175.0,150.0,13.0,3.0,2.3999999999999986,8.0,28.2,25.8,5.0,17.0,472.0,71.3,57.8,9.0,1.0,362.0,26.0,1.0,18.0,14.0,22.75,25.0,330.95,294.47,-68.83,22.0,1.0,43.36,-13.9,28.0,3.0,-68.42,24.0,1.0,82.4,84.4,22.0,19.0,0.0,11.0,10.0,8.0,5.0,0.0,11.0,10.0,5.0,2.0,5.0,7.0,26.5,2.5,19.75,26.0,5.4375,1.0,3.25,3.0,7.625,6.0,6.0,2.0,0.0,1.0,0.8333333333333334,32.0,10.156228956228956,3.0,7.4,4.0,14.0,2.1,1.4,32.0,6.5,1.0,1.0,9.0,29.0,14.0,42.0,36.0,10.5,17.5,0.0,1.0,28.0,21.0,1111.0,927.0,12.0,10.0,7.8,6.3,16.5,3.0,2.6666666666666665,1.0,0.0,0.0,547.0,339.0,13.0,208.0,1.0,2.0,662.0,626.0,30.0,2.0,0.6141450313339302,0.6524752475247525,1.0,4.0,2.413793103448276,9.0,46.0,6.9,3.8,11.0,2.0,24.0,17.5,2.0,0.7419354838709677,0.6857142857142857,12.5,5.0,0.7154134332352154,0.7051738761662426,8.0,6.0,5347.0,4157.0,30.0,1.0,99.0,851.0,912.0,22.0,16.0,109.0,22.0,14.0,0.04807692307692308,0.1165644171779141,5.0,31.0,6.6,5.7,22.5,1.0,1117.0,1010.0,17.0,1.0,47.0,1.0,0.0,16.5,28.0,19.0,1.0,2224.0,0.0,16.5,32.0,71.0,10.0,31.5,1.0,0.0,9.5,9.5,294.0,118.0,1.0,22.0,2.96,1.79,20.0,1.0,29.0,27.5,110.5,86.4,22.0,2.0,5505.0,1.0,0.4142857142857143,24.0,0.3858549686660698,0.3475247524752475,32.0,29.0,0.25806451612903225,0.3142857142857143,20.5,28.0,0.2845865667647845,0.2948261238337574,25.0,27.0,431.0,351.0,1.0,20.0,16.0,11.0,16.0,8.0,2127.0,1738.0,12.0,6.0,13.456790123456791,6.0,51.4,34.1,22.0,1.0,0.0,0.0,24.0,3.5,5.0,28.5,1.0,158.0,256.0,13.0,3.0,33.0,20.5,2.5,34.0,32.0,19.0,10.0,28.0,27.0,18.0,11.5,19.0,10.9,8.8,29.0,9.0,16.0,31.0,-3.0,20.0,4.5,12.912457912457912,6.0,30625.0,27300.0,6.0,New Orleans Saints,7474.0,5895.0,24.0,1.0,100.0,97.3,3.0,13.0,63.0,37.0,16.0,2.0,63.0,36.0,15.0,2.0,8.3,7.0,14.0,4.0,4.9,5.0,30.0,4.5,11.7,12.2,19.5,18.0,26.5,25.8,28.0,3.0,10.1,6.2,5.0,17.0,6.7,5.8,26.0,1.0,47.3,0.0,16.5,7.0,42.6,32.4,26.5,1.0,1579.0,2.0,1.6938775510204085,1.4,29.5,18.0
180.0,181.0,7.0,27.0,399.0,370.0,32.0,2.0,262.0,245.0,31.0,2.0,107.0,101.0,20.5,8.0,30.0,24.0,12.0,13.0,2.0,0.0,2.0,0.0,8.3,6.4,25.0,2.0,8393.0,2.0,9.0,7.2,24.0,2.0,61.0,153.0,166.0,29.0,15.5,4.800000000000002,3.0,29.3,24.5,2.0,8.0,402.0,65.7,62.4,24.0,4.0,386.0,31.0,3.0,18.0,14.0,22.5,24.0,276.58,263.82,-117.25,29.0,3.0,18.27,13.74,18.0,5.0,-84.74,27.0,2.0,84.8,87.0,24.0,12.0,1.0,13.0,6.0,11.0,2.0,1.0,12.0,5.0,9.0,1.0,5.0,11.0,10.0,2.5,15.583333333333334,12.0,7.65625,2.0,3.0,2.0,12.3125,9.0,13.0,1.0,0.0,3.5,0.38461538461538464,9.0,11.75993265993266,8.0,9.2,7.0,12.0,2.0,3.7,6.5,5.0,2.0,1.0,23.0,2.5,6.0,46.0,60.0,30.5,11.5,0.0,0.0,12.0,21.0,986.0,1294.0,27.0,19.0,7.9,7.1,29.0,2.0,5.833333333333333,2.0,0.0,0.0,513.0,342.0,15.0,171.0,3.0,3.0,612.0,619.0,29.0,3.0,0.5951940850277264,0.6193609022556391,5.0,13.0,2.448598130841121,7.0,39.0,6.4,4.2,15.0,3.0,26.0,22.5,4.0,0.6842105263157895,0.6666666666666666,17.0,9.0,0.7424065420560748,0.7150676600273681,5.0,4.0,5084.0,4703.0,31.0,2.0,87.0,815.0,907.0,20.5,11.0,115.0,27.0,6.0,0.07518796992481203,0.06486486486486487,29.0,25.0,6.2,6.0,31.0,3.5,1082.0,1064.0,28.0,2.0,57.0,0.0,0.0,16.5,12.0,26.0,4.5,2648.0,0.0,16.5,29.0,67.0,5.5,29.0,1.0,0.0,9.5,9.5,393.0,220.0,4.0,13.0,2.68,1.84,21.0,3.0,38.0,13.0,105.7,86.1,20.5,3.0,5257.0,2.0,0.4083969465648855,26.0,0.4048059149722736,0.3806390977443609,28.0,20.0,0.3157894736842105,0.33333333333333337,16.0,24.0,0.2575934579439252,0.2849323399726319,28.0,29.0,438.0,405.0,9.0,17.0,18.0,13.0,19.0,4.0,1764.0,1874.0,17.0,20.0,14.728395061728397,9.0,47.2,32.6,16.0,3.0,0.0,2.0,32.0,5.0,6.1,19.5,9.0,173.0,274.0,10.0,6.5,40.0,14.0,10.0,33.0,23.0,1.0,11.0,28.0,20.0,2.0,11.5,17.0,8.3,17.1,3.0,3.0,34.0,3.5,17.0,3.0,3.0,14.319865319865322,9.0,27540.0,30046.0,27.0,New England Patriots,6848.0,6577.0,31.0,2.0,100.0,100.0,20.0,13.0,59.0,38.0,19.5,3.0,59.0,38.0,20.0,3.0,8.6,8.0,29.0,2.0,4.0,4.6,24.5,23.0,13.1,12.9,28.0,4.0,21.4,21.6,6.0,29.0,10.3,8.5,13.0,16.0,6.3,6.2,29.5,3.0,46.5,0.0,16.5,9.5,37.9,36.2,32.0,2.0,271.0,10.0,2.15,1.7391304347826089,15.0,3.0
197.0,204.0,29.5,7.5,349.0,325.0,21.0,6.5,244.0,195.0,22.0,3.0,71.0,91.0,12.0,30.5,34.0,39.0,29.0,3.0,3.0,0.0,3.0,1.0,7.0,5.3,7.0,6.5,7809.0,5.0,7.8,6.1,8.0,7.0,57.0,147.0,141.0,4.5,22.5,1.6999999999999993,9.5,28.7,27.0,12.0,14.5,423.0,63.5,62.3,22.0,5.0,376.0,29.0,2.0,44.0,1.5,17.833333333333332,17.0,126.56,137.29,-0.29,7.0,5.0,-11.64,-13.89,27.0,8.0,-12.71,15.0,5.0,82.8,88.2,26.5,17.5,0.0,9.0,9.0,4.0,7.0,0.0,9.0,8.0,2.0,5.0,7.0,13.0,3.0,8.5,14.0,9.0,14.9125,17.0,6.2,5.0,23.625,26.0,20.0,2.0,1.0,16.0,0.35,5.0,12.61111111111111,10.0,9.5,8.0,16.0,2.4,3.5,9.0,11.5,5.0,3.0,21.0,5.0,19.5,37.0,49.0,22.0,25.5,0.0,1.0,28.0,21.0,887.0,1255.0,25.0,24.0,6.9,5.9,6.5,11.0,8.75,5.0,0.0,0.0,474.0,387.0,23.0,87.0,8.0,4.0,666.0,604.0,28.0,1.0,0.6635160680529301,0.6113744075829384,7.0,1.0,3.436619718309859,1.0,41.0,6.2,4.3,17.0,4.0,26.0,22.5,3.0,0.82,0.7222222222222222,6.0,2.0,0.7596654568407764,0.6514198265601088,19.0,2.0,4814.0,3831.0,22.0,4.0,128.0,1075.0,982.0,29.5,31.0,119.0,28.0,30.0,0.09742120343839544,0.12,4.0,12.5,5.5,5.3,7.5,16.0,1058.0,1055.0,25.0,4.0,82.0,0.0,0.0,16.5,12.0,36.0,16.5,3573.0,0.0,16.5,16.0,78.0,16.0,13.5,0.0,1.0,23.0,24.0,301.0,484.0,24.0,19.0,2.14,1.68,15.0,6.0,38.0,13.0,97.2,82.1,12.0,5.0,5071.0,4.0,0.29098360655737704,32.0,0.33648393194706994,0.3886255924170616,26.0,32.0,0.18000000000000005,0.2777777777777778,27.0,31.0,0.24033454315922365,0.3485801734398912,14.0,31.0,356.0,410.0,10.0,31.0,9.0,10.0,10.0,24.0,1523.0,2050.0,23.0,29.0,22.203703703703702,30.0,37.6,32.4,15.0,8.0,1.0,1.0,36.0,5.1,6.4,15.5,10.0,257.0,271.0,11.0,20.0,41.0,11.5,17.0,29.0,34.0,23.0,19.0,24.0,30.0,25.5,19.0,23.0,10.7,16.2,4.0,7.5,34.0,3.5,11.0,4.0,13.0,15.722222222222223,14.0,28959.0,28764.0,17.0,Detroit Lions,6337.0,5881.0,23.0,5.0,100.0,100.0,20.0,13.0,54.0,41.0,24.0,4.0,54.0,41.0,24.0,4.0,7.6,6.8,8.0,12.0,4.3,5.0,30.0,13.0,12.0,10.9,4.0,14.5,24.0,25.6,26.0,14.5,7.9,13.4,31.0,26.0,6.0,5.6,21.5,7.5,43.6,0.0,16.5,23.5,32.2,28.8,16.0,9.5,456.0,9.0,1.7674418604651163,1.36,32.0,9.0
179.0,171.0,3.0,29.0,345.0,329.0,23.0,8.0,175.0,191.0,20.0,18.5,139.0,110.0,25.0,1.0,31.0,28.0,22.0,11.0,3.0,0.0,2.0,0.0,6.3,7.4,30.5,11.0,7595.0,8.0,7.2,8.3,31.0,12.0,48.0,162.0,167.0,30.0,7.5,-0.10000000000000142,17.0,27.9,28.0,15.0,18.5,312.0,60.1,64.9,30.0,15.5,318.0,12.0,18.0,4.0,29.0,25.333333333333332,30.0,131.27,71.12,-118.82,30.0,10.0,66.46,-14.76,29.0,1.0,-127.3,31.0,4.0,78.6,87.1,25.0,24.5,1.0,7.0,9.0,9.0,2.0,1.0,7.0,6.0,8.0,0.0,6.0,10.0,16.0,6.0,25.583333333333332,31.0,9.05,3.0,14.35,14.0,3.75,1.0,13.0,0.0,0.0,3.5,0.4615384615384616,18.0,17.18333333333333,19.0,15.7,15.0,17.0,3.3,2.9,17.0,22.0,0.0,1.0,14.0,20.5,21.5,39.0,30.0,6.5,22.0,1.0,0.0,12.0,5.0,926.0,811.0,8.0,23.0,6.9,7.6,31.5,11.0,7.583333333333333,4.0,0.0,0.0,406.0,429.0,27.0,-23.0,20.0,5.5,519.0,490.0,6.0,23.0,0.5545545545545546,0.5360082304526749,25.0,23.0,1.2589928057553956,30.0,21.0,4.0,5.7,28.0,15.0,28.0,25.5,15.0,0.44680851063829785,0.6086956521739131,22.0,32.0,0.6139169472502806,0.6535915259847732,16.0,25.0,3829.0,3949.0,24.0,13.0,113.0,1013.0,901.0,19.0,28.0,98.0,13.0,26.5,0.08985507246376813,0.0851063829787234,16.0,19.0,5.7,5.9,27.5,9.5,999.0,972.0,5.5,23.0,66.0,0.0,0.0,16.5,12.0,35.0,14.0,2819.0,0.0,16.5,27.0,52.0,1.0,26.5,0.0,3.0,32.0,24.0,176.0,466.0,23.0,29.0,2.21,2.36,31.0,5.0,32.0,22.0,84.8,98.3,30.0,13.0,4089.0,13.0,0.7942857142857143,3.0,0.4454454454454454,0.4639917695473251,8.0,10.0,0.5531914893617021,0.3913043478260869,11.0,1.0,0.3860830527497193,0.3464084740152268,17.0,8.0,445.0,451.0,21.5,14.0,26.0,18.0,29.0,1.0,2408.0,2093.0,25.0,3.0,24.555555555555557,32.0,38.5,42.7,31.0,6.0,2.0,0.0,35.0,6.3,6.0,21.5,15.0,260.0,170.0,31.0,21.0,31.0,25.5,15.5,28.0,31.0,17.0,23.0,22.0,27.0,18.0,26.5,23.0,12.8,12.9,17.0,18.5,24.0,18.0,1.0,14.5,13.0,18.666666666666664,23.0,28998.0,28557.0,16.0,Carolina Panthers,6237.0,6042.0,28.0,7.0,97.8,100.0,20.0,27.5,45.0,48.0,27.0,7.0,44.0,48.0,27.0,8.0,7.9,8.4,32.0,7.5,5.4,4.6,24.5,1.0,13.1,13.0,29.0,4.0,23.7,27.0,30.0,16.0,5.5,13.3,30.0,30.0,6.2,6.2,29.5,4.5,42.7,0.0,16.5,27.5,34.8,35.1,30.0,6.0,195.0,11.0,1.4629629629629632,1.8260869565217392,7.0,26.0
172.0,170.0,2.0,31.0,359.0,311.0,17.0,3.0,234.0,186.0,15.5,4.0,97.0,102.0,22.0,14.5,28.0,23.0,9.0,17.0,1.0,0.0,1.0,2.0,6.6,6.7,28.0,9.0,7928.0,4.0,7.3,7.5,27.0,10.5,46.0,181.0,164.0,27.0,2.0,1.1999999999999993,14.0,27.9,26.7,9.0,18.5,366.0,62.9,62.6,26.5,7.0,299.0,8.0,6.0,12.0,19.0,21.0,21.0,103.68,121.12,-79.74,25.0,7.0,-14.23,5.19,23.0,10.0,-75.29,25.0,7.0,80.0,89.3,28.0,20.5,0.0,11.0,5.0,12.0,7.0,0.0,11.0,4.0,9.0,4.0,8.0,4.0,30.5,12.5,20.375,27.0,11.375,7.0,9.5,8.0,13.25,12.0,19.0,1.0,0.0,14.0,0.42105263157894735,12.0,13.812457912457912,13.0,11.8,11.0,20.0,3.4,3.6,8.0,24.0,1.0,4.0,17.0,14.0,25.5,43.0,57.0,27.5,15.5,1.0,1.0,28.0,5.0,1100.0,1451.0,31.0,11.0,7.2,7.0,27.5,5.5,9.0,6.0,0.0,0.0,406.0,377.0,22.0,29.0,11.0,5.5,582.0,478.0,3.0,9.0,0.583969465648855,0.5323590814196242,27.0,15.0,2.4123711340206184,10.0,27.0,4.6,6.1,30.0,10.0,29.0,27.5,8.0,0.627906976744186,0.7837837837837838,2.0,21.0,0.7036565977742448,0.64749368914533,22.0,8.0,4426.0,3591.0,13.0,6.0,91.0,753.0,760.0,5.0,6.0,92.0,6.0,7.5,0.07799442896935932,0.07395498392282958,24.0,23.0,6.3,5.8,24.0,2.0,1048.0,958.0,1.0,5.0,47.0,0.0,0.0,16.5,12.0,25.0,3.0,2234.0,0.0,16.5,31.0,60.0,4.0,31.5,0.0,0.0,9.5,24.0,264.0,329.0,17.0,25.5,2.24,1.96,26.0,4.0,31.0,24.0,88.7,92.5,27.0,11.0,4624.0,6.0,0.41452991452991456,23.0,0.416030534351145,0.4676409185803758,6.0,18.0,0.372093023255814,0.21621621621621626,31.0,12.0,0.2963434022257552,0.35250631085466994,11.0,25.0,436.0,448.0,20.0,18.0,16.0,8.0,4.0,8.0,1864.0,1955.0,20.0,16.0,18.024691358024693,24.0,41.3,36.5,26.0,4.0,0.0,0.0,30.0,4.9,6.3,17.0,8.0,198.0,187.0,28.0,11.0,32.0,23.5,8.0,35.0,28.0,9.5,8.5,28.0,25.0,13.5,11.5,28.0,16.3,12.4,19.0,28.0,21.0,23.5,-7.0,25.0,21.0,15.824915824915825,16.0,31132.0,27880.0,3.0,San Diego Chargers,6290.0,5546.0,16.0,6.0,97.8,100.0,20.0,27.5,45.0,40.0,22.5,7.0,44.0,40.0,22.5,8.0,7.9,7.9,28.0,7.5,4.3,4.4,20.0,13.0,12.6,12.6,26.0,10.0,25.6,25.5,25.0,6.0,8.5,13.2,29.0,22.0,6.0,5.8,26.0,7.5,47.5,0.0,16.5,5.0,36.6,32.4,26.5,3.0,744.0,6.0,1.8372093023255816,1.7954545454545454,11.0,5.0
187.0,180.0,5.5,21.0,349.0,292.0,11.0,6.5,215.0,186.0,15.5,9.0,100.0,87.0,10.0,11.5,34.0,19.0,4.0,3.0,1.0,0.0,0.0,1.0,6.8,5.8,15.0,8.0,7181.0,17.0,7.3,6.5,11.5,10.5,46.0,166.0,150.0,13.0,4.0,1.6000000000000014,11.0,28.5,26.9,11.0,16.0,365.0,61.4,60.7,17.5,11.5,340.0,21.5,7.5,18.0,14.0,14.333333333333334,14.0,66.87,113.03,-46.31,17.0,8.0,-38.04,24.21,16.0,24.0,-18.44,17.0,10.0,93.1,82.1,15.0,1.0,2.0,9.0,9.0,7.0,2.0,2.0,9.0,9.0,5.0,2.0,8.0,10.0,16.0,12.5,16.583333333333332,15.0,11.225,6.0,7.7,6.0,14.75,14.0,12.0,1.0,1.0,2.0,0.6666666666666666,30.0,10.576599326599327,4.0,7.5,5.0,13.0,2.2,3.4,10.5,8.5,2.0,2.0,19.0,10.5,9.5,24.0,60.0,30.5,32.0,0.0,0.0,12.0,21.0,563.0,1487.0,32.0,32.0,6.8,6.4,20.0,13.0,11.166666666666666,10.0,0.0,1.0,402.0,350.0,18.0,52.0,10.0,7.0,594.0,560.0,21.0,4.0,0.5778191985088537,0.6145077720207254,6.0,16.0,2.15,14.0,29.0,4.9,4.5,20.5,6.5,25.0,20.5,6.5,0.6744186046511628,0.7142857142857143,7.0,11.0,0.6956521739130435,0.7092544023979018,7.0,11.0,4192.0,3786.0,20.0,8.0,93.0,769.0,843.0,13.0,7.0,101.0,17.5,10.0,0.09742120343839544,0.06506849315068493,28.0,12.5,5.9,5.5,14.5,5.5,1073.0,965.0,4.0,3.0,71.0,1.0,0.0,16.5,28.0,31.0,8.5,2990.0,0.0,16.5,24.0,75.0,13.5,22.5,0.0,0.0,9.5,24.0,315.0,150.0,2.0,18.0,2.04,1.74,17.5,7.0,33.0,19.0,91.1,83.3,14.0,9.0,4365.0,8.0,0.4651162790697674,19.0,0.4221808014911464,0.3854922279792746,27.0,17.0,0.32558139534883723,0.2857142857142857,26.0,22.0,0.3043478260869565,0.29074559760209817,26.0,22.0,453.0,372.0,3.0,11.0,14.0,10.0,10.0,13.0,1834.0,1552.0,6.0,17.0,16.061728395061728,15.0,37.4,32.2,14.0,9.0,0.0,1.0,26.0,4.2,5.6,25.5,4.0,173.0,231.0,19.0,6.5,33.0,20.5,6.0,29.0,28.0,9.5,19.0,27.0,23.0,11.0,14.0,21.0,10.7,15.0,6.0,7.5,29.0,10.0,8.0,5.5,7.5,13.653198653198654,8.0,31042.0,27000.0,4.0,Atlanta Falcons,6026.0,5338.0,12.0,10.0,100.0,100.0,20.0,13.0,45.0,37.0,16.0,7.0,45.0,37.0,17.0,6.0,7.3,7.2,17.0,13.5,4.0,4.2,15.0,23.0,12.0,11.8,9.5,14.5,23.5,24.8,22.0,18.5,9.5,4.8,1.0,20.0,5.6,5.5,17.5,14.0,42.1,0.0,16.5,30.0,32.2,29.6,17.0,9.5,688.0,7.0,1.825,1.7142857142857142,17.0,6.0
190.0,195.0,23.0,15.0,356.0,289.0,8.0,4.0,197.0,173.0,9.0,11.0,134.0,84.0,9.0,2.0,25.0,32.0,25.5,22.0,0.0,0.0,0.0,1.0,5.8,5.7,11.5,15.0,7721.0,7.0,6.5,6.9,19.5,16.5,46.0,158.0,141.0,4.5,10.5,0.09999999999999787,16.0,28.7,28.6,18.0,14.5,330.0,59.6,58.1,10.0,19.0,301.0,9.5,14.0,26.0,7.5,12.333333333333334,10.0,63.46,43.86,-16.49,10.0,15.0,31.28,35.12,10.0,4.0,20.35,10.0,11.0,88.9,66.7,1.0,5.0,0.0,10.0,11.0,4.0,2.0,0.0,10.0,9.0,4.0,1.0,13.0,9.0,21.0,27.0,12.166666666666666,8.0,10.65,5.0,14.05,13.0,7.25,4.0,23.0,3.0,0.0,20.0,0.5652173913043478,25.0,13.20117845117845,12.0,13.5,13.0,25.0,4.5,2.9,17.0,32.0,1.0,2.0,15.0,18.0,31.5,39.0,51.0,23.0,22.0,0.0,0.0,12.0,21.0,815.0,1178.0,22.0,28.0,7.0,6.0,10.0,8.0,9.666666666666666,8.0,0.0,0.0,396.0,328.0,10.0,68.0,9.0,8.0,554.0,518.0,12.0,13.0,0.5656370656370656,0.5784114052953157,16.0,19.0,1.4701492537313432,27.0,22.0,4.0,5.2,26.5,15.0,27.0,24.0,11.5,0.5238095238095238,0.7105263157894737,8.0,30.0,0.6435953648606326,0.6535205848403232,17.0,20.0,4110.0,3397.0,10.0,9.0,107.0,853.0,813.0,10.0,18.0,97.0,10.5,22.0,0.0702247191011236,0.11072664359861592,7.0,28.0,5.6,5.2,3.5,13.0,1036.0,982.0,9.0,7.5,67.0,1.0,0.0,16.5,28.0,31.0,8.5,2830.0,0.0,16.5,26.0,85.0,22.5,24.5,0.0,0.0,9.5,24.0,212.0,176.0,3.0,28.0,1.93,1.61,12.5,9.5,30.0,25.5,78.3,85.7,19.0,19.0,4276.0,10.0,0.6802030456852792,6.0,0.4343629343629344,0.4215885947046844,17.0,14.0,0.4761904761904762,0.2894736842105263,25.0,3.0,0.3564046351393674,0.34647941515967684,16.0,13.0,450.0,414.0,12.0,12.0,20.0,11.0,16.0,2.0,2276.0,1801.0,16.0,5.0,17.97530864197531,22.0,34.7,27.7,4.0,12.5,1.0,0.0,32.0,5.5,8.8,1.0,12.0,166.0,316.0,3.0,4.0,50.0,1.5,10.0,27.0,24.0,2.0,26.5,24.0,16.0,1.0,19.0,38.0,17.9,12.3,20.5,30.0,24.0,18.0,-14.0,30.5,31.0,12.902356902356901,5.0,30020.0,27495.0,8.0,Philadelphia Eagles,6386.0,5198.0,8.0,4.0,100.0,100.0,20.0,13.0,46.0,38.0,19.5,5.0,46.0,38.0,20.0,5.0,7.7,7.2,17.0,11.0,5.1,4.4,20.0,3.0,13.0,12.3,22.5,6.0,20.9,23.1,13.5,31.0,7.1,5.7,3.0,27.5,6.2,5.3,12.0,4.5,42.2,0.0,16.5,29.0,33.7,26.6,8.0,7.0,1188.0,4.0,1.5098039215686276,1.6363636363636362,23.0,25.0
200.0,196.0,25.5,3.0,331.0,338.0,26.0,10.0,216.0,210.0,29.0,8.0,84.0,103.0,23.0,24.0,31.0,25.0,15.5,11.0,4.0,0.0,4.0,1.0,7.4,5.9,17.5,4.0,7808.0,6.0,8.1,6.9,19.5,4.0,47.0,142.0,149.0,10.5,26.5,-2.3000000000000007,24.0,26.4,28.7,19.0,27.5,359.0,61.0,61.3,20.0,13.0,361.0,25.0,9.0,10.0,23.0,21.25,22.0,106.83,174.08,-89.01,27.0,4.0,-63.61,12.82,20.0,32.0,-60.46,22.0,6.0,79.2,80.6,9.0,22.5,0.0,12.0,4.0,5.0,3.0,0.0,12.0,3.0,3.0,1.0,8.0,11.0,10.0,12.5,17.333333333333332,16.5,14.28125,14.0,7.75,7.0,20.8125,22.0,18.0,1.0,0.0,13.0,0.4444444444444444,16.0,17.286700336700335,20.0,16.9,18.0,16.0,2.7,3.4,10.5,15.0,0.0,3.0,20.0,7.5,19.5,52.0,46.0,17.5,6.5,0.0,0.0,12.0,21.0,1209.0,1053.0,17.0,7.0,7.7,6.4,20.0,4.0,13.25,12.0,0.0,0.0,394.0,400.0,25.0,-6.0,19.0,9.0,589.0,589.0,24.0,6.0,0.6001945525291829,0.5942164179104478,12.0,9.0,2.571428571428572,5.0,29.0,4.9,4.8,23.0,6.5,28.0,25.5,6.5,0.6304347826086957,0.6511627906976745,18.0,20.0,0.7683817562084078,0.6778478910660911,11.0,1.0,4734.0,4082.0,29.0,5.0,94.0,795.0,933.0,23.0,9.0,110.0,23.5,11.0,0.09365558912386708,0.07396449704142012,23.0,16.0,5.3,5.6,19.0,24.5,1028.0,1072.0,30.0,11.0,82.0,0.0,0.0,16.5,12.0,41.0,21.5,3745.0,0.0,16.5,15.0,75.0,13.5,13.5,0.0,0.0,9.5,24.0,171.0,407.0,20.0,30.0,1.9,1.92,25.0,11.0,28.0,29.0,92.9,86.1,20.5,6.0,4933.0,5.0,0.3888888888888889,28.0,0.3998054474708171,0.4057835820895522,21.0,24.0,0.3695652173913043,0.34883720930232553,15.0,13.0,0.23161824379159224,0.322152108933909,22.0,32.0,411.0,435.0,16.5,22.0,17.0,15.0,24.5,6.0,1427.0,1940.0,19.0,32.0,18.802469135802472,27.5,32.5,34.7,23.0,16.5,2.0,1.0,28.0,4.5,7.5,7.0,5.5,199.0,335.0,2.0,12.0,48.0,3.5,7.0,24.0,31.0,17.0,31.5,19.0,25.0,13.5,30.5,24.0,11.5,14.8,7.5,13.0,31.0,7.0,7.0,7.5,16.5,17.673400673400675,19.0,28400.0,29204.0,22.0,New York Giants,6161.0,6022.0,27.0,8.0,100.0,100.0,20.0,13.0,43.0,45.0,26.0,10.0,43.0,45.0,26.0,10.0,8.4,7.5,21.5,3.0,3.5,4.5,22.5,32.0,13.7,12.2,19.5,1.5,23.3,22.9,11.0,21.0,6.1,9.9,17.0,29.0,6.0,5.6,21.5,7.5,45.7,0.0,16.5,13.5,30.7,30.8,22.0,13.0,139.0,12.0,2.4,1.6666666666666667,19.0,1.0
191.0,188.0,15.5,14.0,321.0,270.0,5.0,13.0,176.0,166.0,4.0,17.0,131.0,73.0,2.5,3.0,14.0,31.0,24.0,32.0,1.0,0.0,0.0,2.0,7.0,4.5,1.5,6.5,7387.0,12.0,7.9,5.4,2.0,6.0,41.0,164.0,140.0,2.5,5.0,2.400000000000002,7.0,30.3,27.9,14.0,5.0,288.0,61.7,51.9,1.0,9.0,279.0,4.0,26.0,12.0,19.0,6.166666666666667,3.0,46.86,69.3,50.93,2.0,12.0,-13.04,36.26,9.0,9.0,99.11,2.0,12.0,84.2,83.3,18.5,15.0,0.0,14.0,11.0,8.0,5.0,0.0,14.0,10.0,4.0,4.0,11.0,10.0,16.0,22.5,10.083333333333334,4.0,9.58125,4.0,13.35,11.0,5.8125,2.0,20.0,1.0,1.0,16.0,0.55,24.0,7.186531986531986,1.0,4.9,1.0,9.0,1.9,3.2,13.5,4.0,1.0,0.0,17.0,14.0,3.0,29.0,46.0,17.5,31.0,0.0,0.0,12.0,21.0,730.0,1030.0,15.0,30.0,7.0,5.2,2.0,8.0,9.583333333333334,7.0,0.0,0.0,381.0,278.0,4.0,103.0,6.0,10.0,467.0,538.0,16.5,30.0,0.4780114722753346,0.60625,8.0,31.0,1.3435114503816794,29.0,20.0,4.3,3.3,5.5,11.5,18.0,6.5,20.0,0.5263157894736842,0.6923076923076923,10.0,28.5,0.5888478333893181,0.6639684970465981,14.0,29.0,3506.0,3035.0,3.0,18.0,99.0,852.0,686.0,2.0,17.0,88.0,4.0,14.0,0.04361370716510903,0.1148148148148148,6.0,32.0,5.7,5.3,7.5,9.5,1046.0,960.0,2.0,6.0,74.0,0.0,0.0,16.5,12.0,32.0,10.5,3256.0,0.0,16.5,21.0,83.0,20.0,19.0,1.0,0.0,9.5,9.5,529.0,307.0,15.0,5.0,1.93,1.45,5.0,9.5,51.0,2.0,92.7,69.0,2.0,7.0,3696.0,18.0,0.7443181818181818,4.0,0.5219885277246654,0.39375,25.0,2.0,0.4736842105263158,0.3076923076923077,23.0,4.5,0.4111521666106819,0.3360315029534019,19.0,4.0,546.0,378.0,4.0,1.5,18.0,8.0,4.0,4.0,2448.0,1536.0,4.0,2.0,13.734567901234568,7.0,37.2,29.8,10.0,10.0,0.0,0.0,33.0,6.6,7.6,5.0,20.0,190.0,287.0,6.0,9.5,44.0,6.0,12.5,38.0,36.0,26.5,5.5,32.0,30.0,25.5,4.5,20.0,10.5,13.8,12.0,6.0,27.0,12.0,7.0,7.5,6.0,9.473063973063972,1.0,31324.0,26320.0,1.0,Houston Texans,5954.0,4571.0,2.0,13.0,97.5,100.0,20.0,29.0,40.0,22.0,3.0,12.5,39.0,22.0,3.0,13.5,7.9,6.2,2.0,7.5,4.5,4.1,12.0,7.5,12.8,11.9,13.0,8.0,25.2,22.4,7.0,7.0,10.4,9.6,15.5,14.5,5.7,4.8,3.0,12.5,44.0,0.0,16.5,20.0,31.1,24.3,2.0,12.0,1383.0,3.0,1.7555555555555555,1.5121951219512195,27.0,10.5
192.0,193.0,21.0,13.0,282.0,267.0,2.0,23.0,150.0,190.0,19.0,30.0,101.0,53.0,1.0,10.0,31.0,24.0,12.0,11.0,1.0,0.0,1.0,1.0,6.2,4.9,4.5,12.0,6856.0,24.0,7.4,5.8,6.0,9.0,35.0,161.0,140.0,2.5,9.0,9.2,1.0,33.5,24.3,1.0,1.0,277.0,61.4,57.5,8.0,11.5,333.0,18.5,29.0,8.0,25.5,3.5,1.0,-9.07,35.66,14.86,5.0,16.0,-36.86,72.08,1.0,22.0,95.67,3.0,17.0,84.6,81.5,11.5,13.5,2.0,16.0,14.0,11.0,9.0,2.0,16.0,13.0,6.0,7.0,5.0,15.0,1.5,2.5,8.166666666666666,2.0,14.0375,13.0,18.45,22.0,9.625,7.0,14.0,0.0,0.0,5.0,0.35714285714285715,6.0,7.428451178451178,2.0,5.0,2.0,5.0,1.1,4.0,4.0,1.0,1.0,0.0,23.0,2.5,1.0,39.0,46.0,17.5,22.0,1.0,0.0,12.0,5.0,1060.0,1061.0,19.0,12.0,5.9,6.0,10.0,20.0,16.75,16.0,0.0,0.0,380.0,229.0,2.0,151.0,4.0,11.0,451.0,579.0,23.0,31.0,0.4984894259818731,0.6375770020533881,2.0,30.0,1.4851485148514851,26.0,18.0,4.0,3.5,8.5,15.0,20.0,8.0,24.5,0.5625,0.8695652173913043,1.0,25.5,0.5890631282669884,0.7493409044818495,1.0,28.0,2930.0,3695.0,16.0,29.0,113.0,1014.0,867.0,15.0,29.0,98.0,13.0,26.5,0.1099290780141844,0.0898876404494382,13.0,4.0,5.4,5.2,3.5,19.5,993.0,974.0,7.0,24.5,79.0,1.0,0.0,16.5,28.0,39.0,20.0,3970.0,0.0,16.5,9.0,87.0,25.5,15.0,1.0,0.0,9.5,9.5,544.0,315.0,16.0,4.0,1.85,1.18,1.0,12.0,44.0,7.5,91.4,73.6,5.0,8.0,3193.0,30.0,0.6733333333333333,7.0,0.5015105740181269,0.3624229979466119,31.0,3.0,0.4375,0.13043478260869568,32.0,7.5,0.4109368717330116,0.2506590955181505,32.0,5.0,498.0,353.0,2.0,3.0,14.0,3.0,1.0,13.0,2044.0,1236.0,1.0,8.0,9.141975308641976,1.0,39.6,23.3,1.0,5.0,1.0,1.0,44.0,8.9,6.8,11.5,27.5,263.0,283.0,7.5,22.0,42.0,8.0,25.5,52.0,27.0,5.5,1.0,44.0,22.0,7.0,1.0,10.0,5.2,18.7,2.0,1.0,38.0,1.5,28.0,1.0,1.0,9.856902356902356,2.0,30912.0,27020.0,5.0,San Francisco 49ers,4974.0,4931.0,4.0,26.0,100.0,100.0,20.0,13.0,34.0,21.0,1.5,20.5,34.0,21.0,1.5,20.0,7.1,6.9,11.5,16.5,4.1,3.5,1.5,19.5,11.5,11.9,13.0,21.5,27.2,23.1,13.5,1.0,12.4,8.1,11.0,5.0,5.0,5.1,7.5,24.0,50.3,0.0,16.5,2.0,25.9,25.5,5.0,23.5,43.0,14.0,1.7317073170731707,1.9714285714285715,2.0,13.0
186.0,188.0,15.5,22.5,312.0,269.0,4.0,15.5,181.0,166.0,4.0,14.0,98.0,79.0,6.0,13.0,33.0,24.0,12.0,5.5,1.0,0.0,1.0,0.0,5.7,4.6,3.0,16.0,7070.0,19.0,6.5,5.6,3.5,16.5,41.0,158.0,150.0,13.0,10.5,-0.4000000000000021,18.0,28.9,29.3,20.0,12.0,314.0,57.7,53.8,2.0,22.0,288.0,5.0,17.0,24.0,9.5,4.75,2.0,27.37,69.52,77.51,1.0,11.0,-32.7,45.09,6.0,20.0,133.31,1.0,13.0,76.9,90.3,29.0,26.0,1.0,9.0,12.0,11.0,6.0,1.0,9.0,10.0,9.0,1.0,12.0,11.0,10.0,24.5,7.916666666666667,1.0,12.96875,10.0,13.5,12.0,12.4375,10.0,24.0,3.0,0.0,22.5,0.5,22.0,11.265488215488215,6.0,10.1,9.0,12.0,2.2,2.8,19.5,8.5,1.0,1.0,15.0,18.0,6.0,42.0,36.0,10.5,17.5,0.0,1.0,28.0,21.0,1047.0,1050.0,16.0,14.0,5.9,5.4,3.0,20.0,15.333333333333334,15.0,0.0,0.0,378.0,266.0,3.0,112.0,5.0,12.0,544.0,535.0,15.0,18.0,0.556949806949807,0.5818363273453094,14.0,21.0,1.8469387755102042,19.0,21.0,3.9,2.1,1.0,18.5,11.0,1.0,15.0,0.5833333333333334,0.5238095238095238,31.0,23.0,0.6316663591068463,0.6793595845954132,10.0,23.0,3423.0,3140.0,4.0,19.0,92.0,742.0,1032.0,32.0,4.0,103.0,19.0,9.0,0.10576923076923077,0.08921933085501857,15.0,6.0,5.8,5.5,14.5,7.0,1036.0,1002.0,13.5,7.5,73.0,0.0,0.0,16.5,12.0,33.0,12.0,3393.0,0.0,16.5,20.0,86.0,24.0,20.5,1.0,2.0,29.5,9.5,345.0,392.0,19.0,15.0,1.84,1.27,2.0,13.0,36.0,16.0,81.7,68.8,1.0,15.0,3629.0,19.0,0.5414364640883977,14.0,0.44305019305019294,0.41816367265469057,19.0,12.0,0.4166666666666666,0.4761904761904762,2.0,10.0,0.3683336408931537,0.3206404154045868,23.0,10.0,459.0,419.0,13.0,8.0,15.0,10.0,10.0,10.5,1996.0,1482.0,2.0,10.0,18.802469135802472,27.5,35.5,26.6,3.0,11.0,0.0,0.0,33.0,5.7,8.2,3.0,13.0,206.0,290.0,5.0,13.0,48.0,3.5,12.5,39.0,31.0,17.0,3.5,30.0,28.0,20.5,8.0,24.0,11.8,13.8,12.0,16.0,26.0,14.0,2.0,11.5,16.5,12.430976430976433,4.0,29388.0,28200.0,11.0,Baltimore Ravens,5419.0,4622.0,3.0,15.0,100.0,100.0,20.0,13.0,40.0,26.0,4.0,12.5,40.0,26.0,4.0,12.0,6.7,6.4,3.5,21.5,4.3,3.5,1.5,13.0,11.6,11.9,13.0,20.0,24.9,29.2,31.0,9.0,9.6,11.9,24.0,19.0,5.2,4.6,2.0,18.5,46.5,0.0,16.5,9.5,29.1,24.5,3.0,15.0,797.0,5.0,1.5581395348837208,1.8285714285714287,6.0,23.0
203.0,208.0,32.0,2.0,301.0,272.0,6.0,17.0,173.0,167.0,6.0,20.5,92.0,83.0,8.0,18.0,36.0,22.0,8.0,1.0,1.0,0.0,0.0,1.0,5.1,4.9,4.5,19.5,7299.0,15.0,5.9,5.6,3.5,22.0,45.0,146.0,135.0,1.0,24.5,1.3999999999999986,12.5,30.9,29.5,21.5,3.0,310.0,56.7,54.2,4.0,24.5,275.0,3.0,19.0,30.0,5.5,8.583333333333334,6.0,-66.18,-33.0,32.92,3.0,24.0,-31.61,47.65,5.0,17.0,89.9,4.0,23.0,76.0,96.7,32.0,27.5,0.0,6.0,6.0,7.0,6.0,0.0,5.0,6.0,5.0,3.0,16.0,12.0,5.0,30.5,10.166666666666666,5.0,18.775,22.0,17.05,18.0,20.5,20.0,25.0,1.0,4.0,25.5,0.64,29.0,15.032154882154881,14.0,14.3,14.0,18.0,3.3,3.7,6.5,22.0,2.0,3.0,19.0,10.5,23.5,62.0,61.0,32.0,1.0,1.0,0.0,12.0,5.0,1633.0,1291.0,26.0,1.0,5.6,5.9,6.5,25.5,23.166666666666668,25.0,1.0,0.0,377.0,363.0,20.0,14.0,15.0,13.0,547.0,507.0,8.5,17.0,0.5699029126213592,0.5458207452165156,23.0,18.0,1.880434782608696,17.0,26.0,4.8,3.0,4.0,8.0,15.0,2.5,9.0,0.65,0.46875,32.0,14.0,0.6608538785327721,0.6441017424394152,24.0,15.0,3297.0,3216.0,5.0,21.0,102.0,849.0,966.0,27.0,15.0,110.0,23.5,18.0,0.11960132890365448,0.08088235294117647,18.0,1.0,5.2,4.9,1.0,28.5,1030.0,993.0,12.0,10.0,92.0,0.0,0.0,16.5,12.0,32.0,10.5,3926.0,0.0,16.5,11.0,92.0,29.0,5.5,0.0,0.0,9.5,24.0,426.0,241.0,7.0,11.0,1.69,1.5,6.0,18.0,44.0,7.5,78.4,69.6,3.0,18.0,3542.0,20.0,0.5317919075144508,16.0,0.4300970873786408,0.4541792547834844,10.0,15.0,0.35,0.53125,1.0,19.0,0.3391461214672279,0.3558982575605848,9.0,18.0,443.0,451.0,21.5,16.0,14.0,17.0,27.5,13.0,1692.0,1777.0,13.0,22.0,15.469135802469136,12.0,29.6,29.3,8.0,22.0,3.0,1.0,40.0,6.8,6.5,13.5,21.0,245.0,198.0,25.0,18.0,35.0,17.5,20.0,25.0,30.0,15.0,29.0,19.0,29.0,22.5,30.5,34.0,13.8,13.9,10.0,21.0,31.0,7.0,-3.0,20.0,29.0,15.764309764309763,15.0,29638.0,28080.0,9.0,New York Jets,4989.0,4993.0,5.0,25.0,100.0,100.0,20.0,13.0,44.0,38.0,19.5,9.0,44.0,38.0,20.0,8.0,6.5,6.7,5.5,25.5,3.8,3.9,7.0,29.5,11.4,12.4,24.5,24.0,26.3,21.2,4.0,4.0,9.7,7.5,9.5,18.0,4.8,5.0,4.5,28.0,42.7,0.0,16.5,27.5,24.4,24.0,1.0,29.5,-4.0,15.0,1.7105263157894737,1.717948717948718,16.0,16.0
189.0,189.0,18.0,17.0,313.0,340.0,27.0,14.0,180.0,196.0,23.5,15.5,100.0,120.0,28.0,11.5,33.0,24.0,12.0,5.5,2.0,0.0,1.0,1.0,5.1,6.4,25.0,19.5,6953.0,21.0,5.6,7.1,21.5,26.0,43.0,153.0,151.0,15.0,15.5,-3.3000000000000007,26.5,26.2,29.5,21.5,29.0,356.0,61.6,63.3,28.0,10.0,321.0,14.0,10.0,38.0,3.0,23.916666666666668,28.0,13.19,9.49,-70.47,23.0,18.0,5.5,-15.35,30.0,6.0,-87.55,28.0,15.0,74.2,84.0,21.0,31.5,0.0,12.0,7.0,8.0,4.0,0.0,11.0,5.0,5.0,2.0,5.0,11.0,10.0,2.5,19.25,24.0,14.51875,16.0,15.85,16.0,13.1875,11.0,16.0,2.0,0.0,8.0,0.3125,3.0,19.094276094276097,21.0,20.0,22.0,25.0,4.3,3.9,5.0,30.0,4.0,3.0,20.0,7.5,31.5,37.0,56.0,26.0,25.5,0.0,0.0,12.0,21.0,853.0,1144.0,21.0,26.0,6.2,6.9,26.0,15.0,14.583333333333334,14.0,0.0,1.0,372.0,434.0,30.0,-62.0,22.0,14.0,578.0,507.0,8.5,10.0,0.6058467741935484,0.5343968095712861,26.0,7.0,1.8,21.0,24.0,4.2,5.9,29.0,13.0,30.0,29.5,10.0,0.6666666666666666,0.6122448979591837,21.0,12.0,0.6584281650071123,0.625463118895251,27.0,16.0,3703.0,3714.0,19.0,15.0,86.0,743.0,871.0,16.0,5.0,85.0,2.5,5.0,0.10543130990415336,0.07058823529411765,25.0,7.0,5.4,5.4,11.0,19.5,992.0,1003.0,15.0,26.0,73.0,1.0,0.0,16.5,28.0,43.0,23.5,3472.0,0.0,16.5,19.0,68.0,7.5,20.5,1.0,0.0,9.5,9.5,329.0,494.0,25.0,16.0,1.7,2.15,29.0,17.0,26.0,32.0,77.0,90.4,26.0,21.0,3857.0,16.0,0.5555555555555556,12.0,0.3941532258064516,0.4656031904287139,7.0,26.0,0.33333333333333337,0.3877551020408163,12.0,21.0,0.3415718349928877,0.374536881104749,6.0,17.0,391.0,467.0,24.0,27.0,12.0,19.0,30.5,17.0,1921.0,2224.0,28.0,13.0,15.358024691358024,10.0,31.2,37.0,27.0,20.0,1.0,0.0,23.0,3.8,5.4,27.0,2.0,154.0,210.0,22.0,1.0,29.0,28.5,1.0,31.0,25.0,3.0,14.5,23.0,21.0,3.5,23.5,30.0,15.9,15.3,5.0,27.0,31.0,7.0,1.0,14.5,26.0,18.18855218855219,21.0,28917.0,28539.0,18.0,Buffalo Bills,5624.0,5938.0,26.0,14.0,100.0,98.1,5.5,13.0,41.0,52.0,30.0,11.0,41.0,51.0,30.0,11.0,6.7,7.7,25.0,21.5,4.9,4.8,27.5,4.5,10.8,12.2,19.5,28.0,23.1,20.4,1.0,23.0,12.7,11.5,20.5,3.5,5.7,5.9,28.0,12.5,47.6,0.0,16.5,4.0,29.8,31.4,24.0,14.0,-314.0,19.0,1.3673469387755102,1.6041666666666667,24.0,29.0
185.0,180.0,5.5,24.0,327.0,305.0,14.0,12.0,219.0,199.0,26.5,7.0,91.0,78.0,5.0,19.0,17.0,28.0,22.0,31.0,0.0,0.0,0.0,2.0,7.1,6.3,23.0,5.0,7315.0,13.0,8.0,7.3,26.0,5.0,39.0,163.0,158.0,21.5,6.0,3.1000000000000014,6.0,29.0,25.9,6.0,11.0,376.0,66.0,61.7,21.0,3.0,336.0,20.0,4.5,6.0,27.5,15.916666666666666,15.0,78.92,126.31,-59.21,19.0,6.0,-33.68,32.47,11.0,21.0,-24.08,18.0,8.0,86.5,78.8,6.5,9.0,1.0,9.0,11.0,12.0,4.0,1.0,8.0,11.0,10.0,2.0,9.0,10.0,16.0,18.0,17.916666666666668,20.5,13.4,11.0,5.8,4.0,21.0,23.0,24.0,0.0,1.0,22.5,0.375,7.5,11.521380471380471,7.0,8.6,6.0,12.0,2.1,2.8,19.5,6.5,1.0,2.0,15.0,18.0,6.0,33.0,52.0,24.5,28.0,0.0,0.0,12.0,21.0,768.0,1114.0,20.0,29.0,6.9,6.7,23.5,11.0,11.083333333333334,9.0,0.0,1.0,369.0,347.0,16.0,22.0,12.0,15.0,570.0,545.0,20.0,11.5,0.5988200589970502,0.6039094650205762,10.0,10.0,2.4065934065934065,11.0,33.0,5.8,4.4,19.0,5.0,24.0,17.5,5.0,0.8684210526315791,0.7058823529411765,9.0,1.0,0.6992343541944075,0.7113458386450555,6.0,10.0,4201.0,3906.0,23.0,7.0,114.0,816.0,650.0,1.0,12.0,85.0,2.5,28.0,0.051987767584097865,0.0918032786885246,12.0,30.0,5.7,5.6,19.0,9.5,1017.0,972.0,5.5,14.5,71.0,1.0,0.0,16.5,28.0,30.0,7.0,3047.0,0.0,16.5,22.0,72.0,11.0,22.5,0.0,0.0,9.5,24.0,293.0,278.0,12.0,23.0,1.96,1.76,19.0,8.0,41.0,10.0,100.1,88.4,25.0,4.0,4453.0,7.0,0.4155251141552511,22.0,0.40117994100294985,0.3960905349794238,23.0,23.0,0.13157894736842102,0.2941176470588235,24.0,32.0,0.3007656458055925,0.2886541613549445,27.0,23.0,408.0,385.0,7.0,24.0,5.0,10.0,10.0,30.5,1807.0,1585.0,7.0,18.0,16.95679012345679,18.0,37.8,33.3,19.5,7.0,0.0,1.0,39.0,6.4,7.2,9.0,17.0,252.0,243.0,15.0,19.0,42.0,8.0,18.5,37.0,33.0,20.5,7.0,32.0,26.0,15.5,4.5,21.0,11.4,13.3,14.5,12.0,25.0,16.0,4.0,10.0,7.5,14.442760942760943,10.0,30155.0,28440.0,7.0,Dallas Cowboys,6008.0,5491.0,14.0,11.0,100.0,100.0,20.0,13.0,39.0,35.0,12.0,14.5,39.0,35.0,12.5,13.5,7.8,7.6,24.0,10.0,4.4,4.1,12.0,10.0,11.8,12.3,22.5,16.0,23.3,21.4,5.0,21.0,7.1,9.3,14.0,27.5,5.9,5.6,21.5,10.5,42.9,0.0,16.5,26.0,32.4,30.4,20.0,8.0,517.0,8.0,1.7727272727272725,1.8536585365853653,4.0,8.0
193.0,188.0,15.5,12.0,328.0,369.0,31.0,11.0,186.0,206.0,28.0,12.0,110.0,105.0,24.0,7.0,32.0,58.0,32.0,8.0,2.0,0.0,0.0,0.0,6.1,6.0,19.5,13.5,7503.0,10.0,6.6,6.8,17.5,15.0,38.0,149.0,154.0,18.0,19.5,0.8000000000000007,15.0,27.2,26.4,8.0,21.0,315.0,60.1,53.9,3.0,15.5,324.0,15.5,16.0,8.0,25.5,25.25,29.0,23.79,52.12,-82.79,26.0,13.0,-16.75,-25.3,32.0,11.0,-101.71,30.0,14.0,88.6,72.4,2.0,6.0,1.0,8.0,5.0,11.0,10.0,1.0,8.0,5.0,10.0,7.0,7.0,8.0,24.5,8.5,22.375,29.0,11.55,8.0,15.6,15.0,7.5,5.0,16.0,1.0,1.0,8.0,0.4375,14.0,19.118181818181817,22.0,19.6,21.0,23.0,4.4,3.0,15.0,31.0,0.0,3.0,18.0,12.0,27.5,43.0,47.0,20.0,15.5,1.0,1.0,28.0,5.0,1011.0,1210.0,23.0,17.0,7.2,6.3,16.5,5.5,12.5,11.0,0.0,0.0,359.0,433.0,29.0,-74.0,23.0,16.0,524.0,601.0,27.0,22.0,0.5408866995073892,0.5981308411214953,11.0,25.0,1.690909090909091,24.0,20.0,3.8,5.2,26.5,22.5,31.0,31.0,20.0,0.5555555555555556,0.6739130434782609,16.0,27.0,0.6525032938076416,0.6487663280116109,21.0,19.0,3962.0,4023.0,27.0,11.0,163.0,1358.0,982.0,29.5,32.0,120.0,29.0,32.0,0.0975609756097561,0.15718157181571815,1.0,11.0,5.4,5.9,27.5,19.5,1015.0,1070.0,29.0,17.0,78.0,0.0,0.0,16.5,12.0,44.0,25.0,3960.0,0.0,16.5,10.0,68.0,7.5,16.5,0.0,2.0,29.5,24.0,264.0,593.0,31.0,25.5,1.79,2.05,27.0,15.0,32.0,22.0,79.4,81.3,11.0,17.0,4119.0,11.0,0.5913978494623656,9.0,0.4591133004926108,0.4018691588785047,22.0,8.0,0.4444444444444444,0.32608695652173914,17.0,6.0,0.3474967061923584,0.3512336719883889,12.0,14.0,466.0,430.0,15.0,7.0,16.0,15.0,24.5,8.0,2110.0,2178.0,27.0,7.0,18.0,23.0,34.7,35.6,24.0,12.5,1.0,0.0,25.0,4.6,6.1,19.5,7.0,157.0,239.0,17.0,2.0,39.0,15.5,4.5,35.0,29.0,13.0,8.5,31.0,21.0,3.5,6.5,30.0,15.5,12.8,18.0,24.0,26.0,14.0,-4.0,22.0,26.0,18.636363636363637,22.0,28757.0,28952.0,20.0,Oakland Raiders,6072.0,6201.0,29.0,9.0,100.0,98.1,5.5,13.0,36.0,53.0,31.0,17.5,36.0,52.0,31.0,17.5,7.9,7.1,15.0,7.5,4.5,5.1,32.0,7.5,13.1,13.2,30.5,4.0,23.5,25.7,27.0,18.5,8.3,13.5,32.0,24.0,6.0,5.8,26.0,7.5,50.8,0.0,16.5,1.0,31.4,32.9,28.0,11.0,-129.0,18.0,1.7555555555555555,1.392156862745098,31.0,10.5
199.0,203.0,28.0,4.5,271.0,291.0,9.5,28.0,153.0,199.0,26.5,28.5,97.0,75.0,4.0,14.5,21.0,17.0,3.0,27.0,1.0,0.0,1.0,0.0,4.7,5.4,8.0,26.0,7096.0,18.0,5.9,6.0,7.0,22.0,38.0,147.0,142.0,6.5,22.5,-3.8000000000000007,28.0,27.0,30.8,28.5,23.5,268.0,56.7,60.7,17.5,24.5,383.0,30.0,30.0,44.0,1.5,11.666666666666666,9.0,-92.58,-53.11,-7.67,8.0,27.0,-27.11,57.07,3.0,16.0,61.1,5.0,27.0,87.5,83.3,18.5,7.0,0.0,10.0,6.0,10.0,6.0,0.0,10.0,6.0,6.0,6.0,9.0,11.0,10.0,18.0,11.25,7.0,18.53125,21.0,23.0,31.0,14.0625,13.0,26.0,3.0,1.0,27.0,0.3461538461538461,4.0,17.05959595959596,17.0,18.7,20.0,20.0,4.2,3.2,13.5,28.5,4.0,3.0,20.0,7.5,25.5,57.0,35.0,8.0,2.0,1.0,0.0,12.0,5.0,1238.0,855.0,9.0,6.0,5.8,6.1,13.0,23.5,21.0,21.0,0.0,0.0,353.0,341.0,14.0,12.0,16.0,17.0,473.0,631.0,31.0,27.0,0.5337423312883436,0.6335877862595419,4.0,26.0,1.577319587628866,25.0,18.0,3.8,3.5,8.5,22.5,22.0,13.5,24.5,0.6428571428571429,0.6875,11.0,17.0,0.5990847592518902,0.7249866238630284,3.0,27.0,3011.0,4065.0,28.0,26.0,104.0,800.0,719.0,3.0,10.0,98.0,13.0,19.5,0.07749077490774907,0.0584192439862543,30.0,24.0,5.1,5.3,7.5,31.0,978.0,1048.0,22.0,30.0,89.0,0.0,0.0,16.5,12.0,41.0,21.5,3903.0,0.0,16.5,12.0,85.0,22.5,9.5,2.0,0.0,9.5,2.5,470.0,223.0,6.0,9.0,1.44,1.55,7.5,25.0,30.0,25.5,73.8,79.3,8.0,24.0,3346.0,24.0,0.6339869281045751,8.0,0.4662576687116564,0.3664122137404581,29.0,7.0,0.3571428571428571,0.3125,22.0,16.0,0.4009152407481098,0.27501337613697163,30.0,6.0,456.0,384.0,6.0,9.0,10.0,10.0,10.0,21.5,2015.0,1542.0,5.0,9.0,12.981481481481481,5.0,28.6,30.5,11.0,24.0,1.0,1.0,49.0,9.4,5.0,28.5,31.0,335.0,208.0,23.0,29.0,33.0,20.5,27.5,32.0,36.0,26.5,12.5,28.0,30.0,25.5,11.5,29.0,14.6,14.3,9.0,23.0,31.0,7.0,2.0,11.5,23.5,15.419191919191917,13.0,29253.0,28826.0,12.0,Chicago Bears,5026.0,5607.0,17.0,24.0,100.0,100.0,20.0,13.0,37.0,33.0,9.5,16.0,37.0,33.0,9.5,16.0,7.1,6.8,8.0,16.5,4.4,4.0,9.5,10.0,12.5,11.2,6.0,11.5,21.7,24.4,19.0,28.0,15.7,5.4,2.0,1.0,5.1,5.4,15.0,21.5,43.9,0.0,16.5,21.5,25.2,27.6,10.0,26.0,-581.0,26.0,1.6136363636363635,1.7,18.0,21.0
197.0,200.0,27.0,7.5,285.0,284.0,7.0,22.0,160.0,170.0,8.0,25.0,93.0,94.0,15.0,17.0,32.0,20.0,6.0,8.0,1.0,0.0,0.0,0.0,5.6,5.7,11.5,17.5,6985.0,20.0,6.2,6.7,15.5,18.0,35.0,148.0,142.0,6.5,21.0,4.0,5.0,30.1,26.1,7.0,6.0,308.0,57.6,59.2,12.0,23.0,319.0,13.0,20.0,20.0,11.0,9.333333333333334,7.5,-34.31,13.03,-12.06,9.0,17.0,-39.47,28.67,13.0,26.0,32.41,9.0,19.0,86.8,81.5,11.5,8.0,0.0,14.0,8.0,16.0,0.0,0.0,14.0,5.0,14.0,0.0,8.0,12.0,5.0,12.5,10.416666666666666,6.0,17.51875,20.0,16.6,17.0,18.4375,19.0,17.0,2.0,0.0,11.0,0.4705882352941176,19.5,12.894444444444444,11.0,12.4,12.0,14.0,2.6,1.9,26.0,13.5,1.0,1.0,10.0,26.5,14.0,45.0,44.0,15.0,14.0,0.0,0.0,12.0,21.0,1026.0,916.0,11.0,15.0,6.0,5.8,4.0,16.5,18.833333333333332,18.0,0.0,0.0,344.0,323.0,9.0,21.0,13.0,18.0,535.0,539.0,18.0,20.0,0.5517241379310345,0.578790882061447,15.0,24.0,1.7204301075268815,22.0,21.0,3.9,3.9,12.0,18.5,21.0,10.5,15.0,0.6774193548387096,0.6,23.5,10.0,0.6525986713559985,0.6689723320158103,12.0,18.0,3340.0,3385.0,9.0,20.0,99.0,874.0,878.0,17.0,20.0,101.0,17.5,14.0,0.11228070175438597,0.07042253521126761,26.0,2.0,5.3,5.2,3.5,24.5,1015.0,1009.0,16.0,17.0,91.0,0.0,0.0,16.5,12.0,38.0,19.0,4023.0,0.0,16.5,8.0,98.0,32.0,7.0,1.0,1.0,23.0,9.5,610.0,273.0,11.0,2.0,1.6,1.56,9.0,20.0,53.0,1.0,79.6,85.0,17.0,16.0,3507.0,21.0,0.58125,11.0,0.4482758620689655,0.4212091179385529,18.0,9.0,0.3225806451612904,0.4,9.5,23.0,0.34740132864400153,0.3310276679841897,21.0,15.0,455.0,425.0,14.0,10.0,10.0,14.0,21.0,21.5,1778.0,1675.0,10.0,19.0,11.537037037037038,3.0,32.5,28.5,5.0,16.5,1.0,0.0,25.0,4.5,7.7,4.0,5.5,167.0,277.0,9.0,5.0,45.0,5.0,4.5,38.0,27.0,5.5,5.5,33.0,22.0,7.0,2.5,22.0,9.6,11.0,23.0,4.0,22.0,22.0,0.0,17.0,9.5,13.388888888888888,7.0,29156.0,28400.0,14.0,Cincinnati Bengals,5118.0,5060.0,7.0,20.0,97.1,100.0,20.0,31.0,34.0,35.0,12.0,20.5,33.0,35.0,12.5,22.5,6.6,6.8,8.0,23.5,3.9,3.9,7.0,27.0,11.4,11.5,7.0,24.0,22.8,20.8,2.5,24.0,11.5,7.2,7.0,7.0,5.0,5.0,4.5,24.0,44.2,0.0,16.5,19.0,26.0,25.0,4.0,21.5,58.0,13.0,1.6923076923076923,1.7435897435897436,14.0,19.5
189.0,185.0,11.0,17.0,297.0,332.0,24.0,18.0,159.0,213.0,30.0,26.5,118.0,92.0,13.5,5.0,20.0,27.0,20.0,28.5,0.0,0.0,0.0,1.0,4.6,7.4,30.5,29.0,7312.0,14.0,5.7,8.7,32.0,24.5,39.0,146.0,163.0,26.0,24.5,-0.8999999999999986,20.0,29.1,30.0,26.0,9.5,286.0,56.1,68.2,31.0,27.5,367.0,27.0,27.0,2.0,30.0,21.416666666666668,23.0,-28.14,-64.13,-136.38,31.0,29.0,43.75,50.98,4.0,2.0,-81.04,26.0,18.0,78.6,91.4,30.0,24.5,0.0,7.0,8.0,10.0,3.0,0.0,7.0,7.0,6.0,2.0,9.0,15.0,1.5,18.0,19.5,25.0,14.375,15.0,22.0,28.0,6.75,3.0,20.0,0.0,1.0,16.0,0.45,17.0,21.384175084175084,26.0,23.6,25.0,17.0,3.3,1.5,31.0,22.0,0.0,3.0,8.0,31.5,21.5,53.0,57.0,27.5,5.0,1.0,1.0,28.0,5.0,1428.0,1403.0,30.0,2.0,5.3,6.8,25.0,27.5,17.25,17.0,0.0,0.0,340.0,449.0,31.0,-109.0,28.0,19.0,510.0,538.0,16.5,24.0,0.5551142005958292,0.572541382667965,18.0,22.0,1.347457627118644,28.0,20.0,3.9,6.3,32.0,18.5,34.0,32.0,20.0,0.5263157894736842,0.7727272727272727,3.0,28.5,0.560568720379147,0.7012737742104345,9.0,30.0,2957.0,4019.0,26.0,28.0,109.0,908.0,834.0,11.5,23.0,97.0,10.5,23.0,0.06734006734006734,0.08132530120481928,17.0,29.0,5.5,5.7,22.5,16.0,1007.0,1027.0,18.0,20.0,77.0,0.0,0.0,16.5,12.0,43.0,23.5,3517.0,0.0,16.5,18.0,67.0,5.5,18.0,0.0,1.0,23.0,24.0,277.0,532.0,26.0,24.0,1.76,2.18,30.0,16.0,33.0,19.0,74.6,107.6,32.0,22.0,3255.0,28.0,0.7421383647798742,5.0,0.4448857994041708,0.4274586173320351,15.0,11.0,0.4736842105263158,0.2272727272727273,30.0,4.5,0.4394312796208529,0.29872622578956554,24.0,3.0,448.0,439.0,19.0,13.0,18.0,10.0,10.0,4.0,2318.0,1712.0,11.0,4.0,18.728395061728396,26.0,31.7,41.1,30.0,18.0,1.0,1.0,49.0,8.8,8.5,2.0,25.0,298.0,342.0,1.0,26.0,50.0,1.5,27.5,28.0,35.0,25.0,23.0,22.0,32.0,29.5,26.5,26.0,13.2,10.8,24.0,20.0,23.0,20.5,-3.0,20.0,19.0,19.16835016835017,26.0,27594.0,30155.0,26.0,Minnesota Vikings,5275.0,5731.0,21.0,18.0,97.4,100.0,20.0,30.0,39.0,49.0,28.5,14.5,38.0,49.0,28.5,15.0,6.4,8.1,30.0,27.0,5.2,3.9,7.0,2.0,11.4,11.9,13.0,24.0,26.9,24.6,20.5,2.0,8.4,12.4,27.0,23.0,5.2,5.6,21.5,18.5,45.7,0.0,16.5,13.5,27.9,30.9,23.0,19.0,-456.0,24.0,1.2307692307692308,2.0769230769230766,1.0,32.0
195.0,195.0,23.0,10.0,287.0,310.0,15.5,19.0,166.0,198.0,25.0,23.0,89.0,88.0,11.0,21.5,32.0,24.0,12.0,8.0,1.0,0.0,0.0,1.0,5.6,5.9,17.5,17.5,6845.0,25.0,6.9,6.8,17.5,13.0,33.0,151.0,147.0,8.0,17.0,1.3999999999999986,12.5,29.5,28.1,16.0,7.0,280.0,59.7,59.3,13.0,18.0,350.0,23.0,28.0,12.0,19.0,13.75,12.0,-37.03,4.5,-31.18,13.0,19.0,-37.96,31.65,12.0,23.0,10.24,11.0,20.0,84.6,78.8,6.5,13.5,0.0,15.0,7.0,13.0,4.0,0.0,14.0,6.0,11.0,2.0,12.0,3.0,32.0,24.5,15.333333333333334,11.0,16.94375,19.0,17.7,21.0,16.1875,16.0,28.0,0.0,0.0,30.0,0.42857142857142855,13.0,15.836700336700336,15.0,16.5,17.0,13.0,2.8,2.7,21.0,17.0,1.0,1.0,16.0,16.0,9.5,39.0,41.0,13.0,22.0,0.0,0.0,12.0,21.0,942.0,937.0,13.0,22.0,5.9,6.3,16.5,20.0,19.25,19.5,1.0,0.0,329.0,313.0,6.0,16.0,14.0,20.0,469.0,590.0,25.0,28.5,0.5262626262626262,0.6049856184084372,9.0,27.0,1.8651685393258424,18.0,20.0,4.3,4.1,13.5,11.5,24.0,17.5,20.0,0.6451612903225806,0.75,4.0,15.5,0.6087042142575817,0.7229264759145237,4.0,26.0,3091.0,3992.0,25.0,23.0,85.0,779.0,975.0,28.0,8.0,112.0,26.0,4.0,0.11149825783972124,0.07741935483870968,21.0,3.0,5.3,5.5,14.5,24.5,990.0,1043.0,21.0,27.0,78.0,0.0,0.0,16.5,12.0,46.0,27.0,3810.0,0.0,16.5,13.0,95.0,31.0,16.5,0.0,0.0,9.5,24.0,526.0,442.0,22.0,6.0,1.62,1.55,7.5,19.0,46.0,5.5,84.9,83.7,15.5,12.0,3425.0,23.0,0.536144578313253,15.0,0.4737373737373738,0.3950143815915628,24.0,6.0,0.3548387096774194,0.25,29.0,17.5,0.3912957857424183,0.27707352408547625,29.0,7.0,469.0,412.0,11.0,6.0,11.0,8.0,4.0,19.5,1987.0,1530.0,3.0,11.0,11.635802469135802,4.0,32.8,29.7,9.0,15.0,0.0,2.0,52.0,10.0,6.5,13.5,32.0,334.0,241.0,16.0,28.0,41.0,11.5,30.0,39.0,33.0,20.5,3.5,33.0,26.0,15.5,2.5,25.0,12.8,8.7,30.0,18.5,19.0,26.5,-6.0,24.0,18.0,15.173400673400671,12.0,29445.0,28665.0,10.0,Miami Dolphins,5078.0,5522.0,15.0,22.0,100.0,100.0,20.0,13.0,32.0,31.0,5.5,24.0,32.0,31.0,6.0,24.0,7.3,7.2,17.0,13.5,4.2,3.7,3.0,16.5,12.2,12.1,17.0,13.0,24.2,22.9,11.0,13.0,11.4,9.6,15.5,8.0,5.1,5.3,12.0,21.5,48.8,0.0,16.5,3.0,25.9,28.3,13.0,23.5,-444.0,22.0,1.738095238095238,1.9459459459459456,3.0,12.0
188.0,187.0,13.0,19.5,281.0,324.0,20.0,24.0,185.0,187.0,17.0,13.0,71.0,111.0,26.0,30.5,25.0,26.0,18.0,22.0,0.0,0.0,0.0,0.0,6.1,5.7,11.5,13.5,6875.0,23.0,6.7,6.3,9.5,14.0,34.0,142.0,165.0,28.0,26.5,1.6999999999999993,9.5,27.4,25.7,4.0,20.0,353.0,60.4,62.4,24.0,14.0,369.0,28.0,11.0,12.0,19.0,16.0,16.0,-0.23,51.28,-36.84,16.0,14.0,-51.37,27.52,14.0,30.0,-2.54,14.0,16.0,90.6,96.4,31.0,4.0,0.0,5.0,10.0,10.0,7.0,0.0,5.0,9.0,9.0,6.0,8.0,12.0,5.0,12.5,19.0,23.0,19.38125,25.0,11.45,10.0,27.3125,32.0,17.0,0.0,0.0,11.0,0.4705882352941176,19.5,17.114141414141415,18.0,18.4,19.0,14.0,2.4,1.9,26.0,11.5,1.0,3.0,11.0,24.5,14.0,32.0,30.0,6.5,29.0,1.0,0.0,12.0,5.0,832.0,680.0,6.0,27.0,6.5,5.9,6.5,14.0,19.25,19.5,1.0,0.0,325.0,317.0,8.0,8.0,17.0,21.5,584.0,591.0,26.0,8.0,0.6178861788617886,0.5731481481481482,17.0,3.0,2.605633802816901,2.0,22.0,3.8,3.6,10.0,22.5,21.0,10.5,11.5,0.7333333333333333,0.6774193548387096,15.0,6.0,0.7317664614810669,0.6386835621260121,25.0,5.0,3923.0,3629.0,14.0,12.0,104.0,960.0,812.0,9.0,25.0,99.0,15.5,19.5,0.08896797153024913,0.08024691358024691,19.0,20.0,5.4,5.9,27.5,19.5,984.0,1080.0,31.0,29.0,86.0,0.0,0.0,16.5,12.0,36.0,16.5,3747.0,0.0,16.5,14.0,83.0,20.0,12.0,1.0,0.0,9.5,9.5,490.0,221.0,5.0,7.0,1.58,1.59,10.5,21.0,47.0,3.5,84.4,85.1,18.0,14.0,4113.0,12.0,0.3837837837837838,31.0,0.38211382113821135,0.4268518518518518,16.0,30.0,0.2666666666666667,0.3225806451612904,18.0,27.0,0.26823353851893306,0.361316437873988,8.0,28.0,376.0,461.0,23.0,30.0,8.0,10.0,10.0,27.0,1438.0,2053.0,24.0,31.0,11.037037037037036,2.0,31.4,31.0,12.0,19.0,0.0,0.0,24.0,3.9,4.5,31.0,3.0,190.0,180.0,30.0,9.5,28.0,31.0,2.5,32.0,28.0,9.5,12.5,29.0,27.0,18.0,9.0,22.0,11.7,12.3,20.5,15.0,23.0,20.5,1.0,14.5,9.5,15.828282828282829,17.0,26696.0,30855.0,31.0,Tennessee Titans,5361.0,5682.0,18.5,17.0,100.0,100.0,20.0,13.0,34.0,32.0,7.5,20.5,34.0,32.0,8.0,20.0,7.0,6.4,3.5,18.0,3.8,4.5,22.5,29.5,11.7,10.3,1.5,18.0,26.0,22.7,8.0,5.0,10.4,6.1,4.0,14.5,5.4,5.3,12.0,15.0,43.6,0.0,16.5,23.5,28.5,30.3,19.0,17.0,-321.0,20.0,1.842105263157895,1.4222222222222225,28.0,4.0
168.0,169.0,1.0,32.0,341.0,264.0,1.0,9.0,221.0,156.0,2.0,6.0,96.0,82.0,7.0,16.0,24.0,26.0,18.0,24.0,0.0,0.0,0.0,1.0,6.5,4.5,1.5,10.0,7468.0,11.0,7.6,5.3,1.0,8.0,36.0,186.0,156.0,20.0,1.0,-0.8000000000000007,19.0,26.8,27.6,13.0,25.0,341.0,63.3,54.5,5.0,6.0,289.0,6.0,13.0,10.0,23.0,7.583333333333333,4.0,68.04,95.51,3.08,6.0,9.0,-17.78,25.84,15.0,13.0,35.32,8.0,9.0,74.2,81.5,11.5,31.5,2.0,8.0,8.0,11.0,2.0,2.0,8.0,6.0,6.0,1.0,13.0,4.0,30.5,27.0,15.666666666666666,13.0,13.55,12.0,10.85,9.0,16.25,17.0,16.0,1.0,1.0,8.0,0.8125,31.0,11.83838383838384,9.0,11.5,10.0,15.0,2.8,2.1,24.0,17.0,0.0,0.0,11.0,24.5,17.5,35.0,43.0,14.0,27.0,0.0,0.0,12.0,21.0,877.0,1018.0,14.0,25.0,7.0,4.9,1.0,8.0,13.583333333333334,13.0,0.0,0.0,325.0,227.0,1.0,98.0,7.0,21.5,539.0,530.0,13.0,19.0,0.5724137931034483,0.5860995850622407,13.0,17.0,2.302083333333333,12.0,21.0,3.9,2.8,2.0,18.5,15.0,2.5,15.0,0.6176470588235294,0.6818181818181818,14.0,22.0,0.6805438979352023,0.6327046918123275,26.0,13.0,4054.0,2751.0,1.0,10.0,101.0,854.0,777.0,6.0,19.0,96.0,8.5,16.5,0.07038123167155426,0.09848484848484848,9.0,27.0,6.2,5.9,27.5,3.5,1015.0,964.0,3.0,17.0,60.0,1.0,0.0,16.5,28.0,29.0,6.0,2683.0,0.0,16.5,28.0,87.0,25.5,28.0,1.0,0.0,9.5,9.5,347.0,245.0,8.0,14.0,1.83,1.3,3.0,14.0,33.0,19.0,89.7,71.7,4.0,10.0,4333.0,9.0,0.4343891402714932,21.0,0.4275862068965517,0.4139004149377593,20.0,16.0,0.38235294117647056,0.31818181818181823,19.0,11.0,0.3194561020647977,0.3672953081876725,7.0,20.0,434.0,399.0,8.0,19.0,13.0,7.0,2.0,15.0,1903.0,1597.0,8.0,14.0,16.425925925925927,16.0,33.9,26.0,2.0,14.0,2.0,0.0,42.0,7.2,6.2,18.0,23.0,279.0,230.0,20.0,24.0,35.0,17.5,23.5,31.0,27.0,5.5,14.5,23.0,22.0,7.0,23.5,28.0,16.7,8.3,31.0,29.0,15.0,32.0,-13.0,28.5,21.0,12.176767676767678,3.0,31248.0,26364.0,2.0,Pittsburgh Steelers,5957.0,4348.0,1.0,12.0,100.0,100.0,20.0,13.0,36.0,21.0,1.5,17.5,36.0,21.0,1.5,17.5,8.0,5.6,1.0,5.0,4.4,4.0,9.5,10.0,12.7,10.3,1.5,9.0,25.1,23.7,16.0,8.0,10.5,8.4,12.0,13.0,5.9,4.5,1.0,10.5,44.7,0.0,16.5,18.0,35.4,25.6,6.5,5.0,1609.0,1.0,1.818181818181818,1.4,29.5,7.0
198.0,196.0,25.5,6.0,265.0,310.0,15.5,30.0,153.0,174.0,10.5,28.5,89.0,96.0,18.0,21.5,23.0,40.0,30.0,25.5,1.0,0.0,0.0,1.0,5.0,5.0,6.0,21.0,6833.0,26.0,6.1,5.7,5.0,19.5,35.0,138.0,158.0,21.5,30.0,4.5,4.0,31.3,26.8,10.0,2.0,299.0,58.7,59.7,14.0,20.0,324.0,15.5,23.5,32.0,4.0,9.333333333333334,7.5,-73.36,-12.21,23.44,4.0,20.0,-39.1,37.74,7.0,25.0,54.83,6.0,24.0,83.3,75.7,4.0,16.0,2.0,6.0,10.0,8.0,4.0,2.0,5.0,9.0,7.0,2.0,9.0,9.0,21.0,18.0,9.416666666666666,3.0,18.93125,23.0,20.3,25.0,17.5625,18.0,22.0,0.0,1.0,18.5,0.4090909090909091,11.0,16.11835016835017,16.0,15.9,16.0,14.0,2.8,4.1,3.0,17.0,4.0,1.0,22.0,4.0,14.0,46.0,48.0,21.0,11.5,0.0,1.0,28.0,21.0,1142.0,1249.0,24.0,8.0,5.6,6.1,13.0,25.5,23.75,26.0,1.0,0.0,321.0,315.0,7.0,6.0,18.0,23.0,509.0,543.0,19.0,25.0,0.5573280159521435,0.5490943755958055,22.0,20.0,1.7191011235955056,23.0,15.0,2.9,3.3,5.5,26.5,18.0,6.5,28.0,0.5,0.6428571428571429,19.0,31.0,0.63875745731331,0.6619002822201318,15.0,21.0,3105.0,3518.0,11.0,22.0,138.0,1047.0,907.0,20.5,30.0,96.0,8.5,31.0,0.08679245283018867,0.12903225806451613,2.0,21.0,5.2,5.5,14.5,28.5,1003.0,1049.0,23.5,21.0,95.0,0.0,0.0,16.5,12.0,47.0,28.0,4431.0,0.0,16.5,3.0,81.0,17.5,4.0,0.0,2.0,29.5,24.0,464.0,541.0,27.0,10.0,1.44,1.43,4.0,25.0,42.0,9.0,77.6,74.8,6.0,20.0,3444.0,22.0,0.5816993464052288,10.0,0.4426719840478565,0.4509056244041945,11.0,13.0,0.5,0.3571428571428571,14.0,2.0,0.3612425426866901,0.33809971777986825,18.0,12.0,444.0,473.0,25.0,15.0,15.0,10.0,10.0,10.5,1756.0,1797.0,15.0,21.0,15.790123456790125,13.0,27.8,28.6,6.0,25.0,1.0,0.0,50.0,8.9,5.7,23.5,27.5,339.0,232.0,18.0,30.0,33.0,20.5,29.0,30.0,37.0,28.5,16.5,25.0,28.0,20.5,16.0,23.0,11.6,14.8,7.5,14.0,31.0,7.0,8.0,5.5,13.0,16.33670033670034,18.0,27324.0,30968.0,29.0,Seattle Seahawks,4861.0,5315.0,9.0,28.0,100.0,96.9,1.0,13.0,34.0,32.0,7.5,20.5,34.0,31.0,6.0,20.0,6.8,6.9,11.5,20.0,4.0,3.8,4.5,23.0,11.5,11.6,8.0,21.5,24.8,26.0,29.0,10.0,11.0,11.5,20.5,10.5,4.8,5.1,7.5,28.0,46.6,0.0,16.5,8.0,24.4,27.1,9.0,29.5,-454.0,23.0,1.7,1.8157894736842104,8.5,17.0
199.0,204.0,29.5,4.5,286.0,333.0,25.0,20.5,175.0,174.0,10.5,18.5,83.0,118.0,27.0,25.0,28.0,41.0,31.0,17.0,2.0,0.0,0.0,0.0,4.9,5.8,15.0,22.5,7521.0,9.0,6.1,6.7,15.5,19.5,37.0,138.0,153.0,17.0,30.0,-5.399999999999999,30.0,25.6,31.0,30.5,30.0,307.0,55.8,58.8,11.0,29.0,340.0,21.5,21.0,0.0,31.5,18.666666666666668,19.0,-44.97,-29.51,-33.2,14.0,23.0,-9.59,11.67,21.0,7.0,-0.21,13.0,22.0,79.2,72.9,3.0,22.5,0.0,9.0,6.0,7.0,2.0,0.0,9.0,4.0,5.0,1.0,9.0,9.0,21.0,18.0,17.333333333333332,16.5,19.31875,24.0,17.45,20.0,21.1875,25.0,24.0,0.0,0.0,22.5,0.375,7.5,22.87794612794613,29.0,26.5,29.0,23.0,4.2,1.7,28.5,28.5,0.0,1.0,10.0,26.5,27.5,52.0,52.0,24.5,6.5,0.0,0.0,12.0,21.0,1246.0,1300.0,28.0,4.0,5.9,6.0,10.0,20.0,21.333333333333332,23.0,0.0,0.0,312.0,348.0,17.0,-36.0,21.0,24.0,550.0,578.0,22.0,15.0,0.6082578046324271,0.5662100456621004,19.0,6.0,2.108433734939759,15.0,21.0,3.8,2.9,3.0,22.5,17.0,5.0,15.0,0.6363636363636364,0.53125,30.0,18.5,0.6870184899845917,0.6504751847940866,20.0,12.0,3567.0,3696.0,17.0,17.0,106.0,1004.0,950.0,25.0,26.0,122.0,30.5,21.0,0.0979020979020979,0.12312312312312312,3.0,10.0,5.1,5.6,19.0,31.0,993.0,1095.0,32.0,24.5,92.0,0.0,0.0,16.5,12.0,50.0,31.0,4141.0,0.0,16.5,5.0,92.0,29.0,5.5,4.0,1.0,23.0,1.0,696.0,610.0,32.0,1.0,1.45,1.61,12.5,23.0,46.0,5.5,73.9,82.5,13.0,23.0,3954.0,15.0,0.4742857142857143,18.0,0.3917421953675729,0.4337899543378996,14.0,27.0,0.3636363636363637,0.46875,3.0,14.5,0.3129815100154083,0.3495248152059134,13.0,21.0,389.0,475.0,26.0,28.0,12.0,15.0,24.5,17.0,1625.0,1986.0,21.0,24.0,17.271604938271608,19.0,26.1,32.8,17.0,26.0,0.0,3.0,54.0,8.9,6.8,11.5,27.5,387.0,304.0,4.0,31.0,42.0,8.0,31.0,24.0,48.0,32.0,31.5,19.0,35.0,32.0,30.5,32.0,15.6,9.3,26.0,25.5,19.0,26.5,-13.0,28.5,28.0,19.25589225589226,28.0,27462.0,31212.0,28.0,Arizona Cardinals,5192.0,5682.0,18.5,19.0,100.0,100.0,20.0,13.0,33.0,33.0,9.5,23.0,33.0,33.0,9.5,22.5,7.2,6.9,11.5,15.0,4.2,4.2,15.0,16.5,12.9,11.8,9.5,7.0,24.0,25.0,23.0,14.5,15.1,12.2,25.0,2.0,5.2,5.2,10.0,18.5,45.0,0.0,16.5,17.0,26.0,27.7,11.5,21.5,-490.0,25.0,1.7142857142857142,1.6428571428571428,21.0,15.0
204.0,206.0,31.0,1.0,286.0,315.0,19.0,20.5,130.0,182.0,14.0,31.0,129.0,101.0,20.5,4.0,27.0,32.0,25.5,19.0,6.0,0.0,3.0,0.0,4.8,6.6,27.0,24.0,6906.0,22.0,5.9,7.6,28.0,22.0,36.0,140.0,149.0,10.5,28.0,-1.6000000000000014,23.0,26.7,28.3,17.0,26.0,217.0,50.6,62.4,24.0,32.0,333.0,18.5,32.0,18.0,14.0,20.583333333333332,20.0,-93.02,-68.25,-71.37,24.0,30.0,-19.17,13.07,19.0,14.0,-47.98,20.0,28.0,76.0,82.1,15.0,27.5,0.0,6.0,8.0,7.0,4.0,0.0,5.0,8.0,3.0,3.0,17.0,9.0,21.0,32.0,18.333333333333332,22.0,16.35625,18.0,22.15,29.0,10.5625,8.0,30.0,0.0,2.0,31.5,0.5666666666666667,26.0,22.014309764309765,28.0,24.5,28.0,13.0,3.0,1.7,28.5,19.0,3.0,4.0,9.0,29.0,9.5,39.0,20.0,2.0,22.0,0.0,0.0,12.0,21.0,956.0,491.0,1.0,21.0,5.2,6.4,20.0,29.0,21.583333333333332,24.0,0.0,0.0,309.0,390.0,24.0,-81.0,25.0,25.0,429.0,534.0,14.0,32.0,0.4631268436578171,0.5409219190968956,24.0,32.0,1.007751937984496,32.0,20.0,4.7,4.5,20.5,9.0,24.0,17.5,20.0,0.6451612903225806,0.6857142857142857,12.5,15.5,0.4804579549940782,0.6469868995633188,23.0,32.0,2434.0,3704.0,18.0,31.0,101.0,843.0,845.0,14.0,13.0,99.0,15.5,16.5,0.0944055944055944,0.1015873015873016,8.0,15.0,5.1,5.3,7.5,31.0,1017.0,1063.0,27.0,14.5,101.0,0.0,0.0,16.5,12.0,51.0,32.0,4783.0,0.0,16.5,1.0,92.0,29.0,2.0,2.0,1.0,23.0,2.5,596.0,585.0,30.0,3.0,1.34,1.69,16.0,27.0,47.0,3.5,73.5,93.1,28.0,26.0,2708.0,31.0,0.9923076923076924,1.0,0.5368731563421829,0.4590780809031044,9.0,1.0,0.3548387096774194,0.3142857142857143,20.5,17.5,0.5195420450059218,0.3530131004366812,10.0,1.0,546.0,488.0,27.0,1.5,11.0,11.0,16.0,19.5,2632.0,2021.0,22.0,1.0,15.382716049382717,11.0,24.5,33.0,18.0,27.0,0.0,1.0,42.0,8.9,7.1,10.0,27.5,274.0,283.0,7.5,23.0,41.0,11.5,23.5,25.0,39.0,30.0,29.0,19.0,32.0,29.5,30.5,30.0,14.2,7.8,32.0,22.0,18.0,28.5,-12.0,26.5,26.0,19.52861952861953,29.0,28560.0,30694.0,21.0,Denver Broncos,5066.0,5725.0,20.0,23.0,100.0,100.0,20.0,13.0,30.0,40.0,22.5,25.0,30.0,40.0,22.5,25.0,6.3,7.5,21.5,28.0,4.8,4.1,12.0,6.0,12.5,12.0,16.0,11.5,24.5,24.6,20.5,11.5,12.7,11.5,20.5,3.5,5.0,5.4,15.0,24.0,47.4,0.0,16.5,6.0,24.8,27.7,11.5,27.0,-659.0,27.0,1.3125,1.8292682926829267,5.0,31.0
188.0,190.0,19.0,19.5,312.0,295.0,12.0,15.5,204.0,180.0,13.0,10.0,79.0,95.0,16.0,26.5,29.0,20.0,6.0,14.5,2.0,0.0,1.0,0.0,4.9,6.2,22.0,22.5,7234.0,16.0,5.7,7.2,24.0,24.5,28.0,155.0,152.0,16.0,13.0,-1.5999999999999979,22.0,29.1,30.7,27.0,9.5,346.0,58.5,60.5,15.5,21.0,308.0,11.0,12.0,6.0,27.5,18.166666666666668,18.0,-43.52,-14.58,-56.02,18.0,21.0,-22.34,18.43,17.0,15.0,-24.19,19.0,21.0,75.6,82.9,17.0,29.0,0.0,15.0,9.0,11.0,6.0,0.0,14.0,5.0,8.0,4.0,11.0,8.0,24.5,22.5,17.916666666666668,20.5,21.1125,27.0,17.1,19.0,25.125,28.0,25.0,0.0,1.0,25.5,0.44,15.0,20.276936026936028,24.0,21.5,24.0,24.0,4.1,2.6,22.0,26.5,1.0,0.0,13.0,22.0,29.5,56.0,36.0,10.5,3.0,0.0,0.0,12.0,21.0,1239.0,749.0,7.0,5.0,6.0,6.5,22.0,16.5,21.166666666666668,22.0,0.0,0.0,288.0,367.0,21.0,-79.0,24.0,26.0,591.0,509.0,10.0,5.0,0.6124031007751938,0.5566801619433198,20.0,5.0,2.5822784810126582,4.0,19.0,3.2,4.3,17.0,25.0,22.0,13.5,23.0,0.7037037037037037,0.5945945945945946,25.0,8.0,0.7003898273621681,0.65348537796579,18.0,9.0,3773.0,3553.0,12.0,14.0,91.0,897.0,1006.0,31.0,21.0,123.0,32.0,7.5,0.09294871794871797,0.06779661016949153,27.0,17.0,5.7,5.4,11.0,9.5,1032.0,988.0,10.0,9.0,66.0,0.0,0.0,16.5,12.0,34.0,13.0,2842.0,0.0,16.5,25.0,70.0,9.0,26.5,0.0,0.0,9.5,24.0,328.0,255.0,9.0,17.0,1.5,1.9,24.0,22.0,37.0,15.0,73.3,87.4,24.0,27.0,4058.0,14.0,0.3872549019607843,29.0,0.3875968992248062,0.4433198380566802,13.0,28.0,0.2962962962962963,0.4054054054054054,8.0,25.0,0.29961017263783185,0.34651462203421,15.0,24.0,400.0,438.0,18.0,25.0,8.0,15.0,24.5,27.0,1614.0,1884.0,18.0,25.0,17.419753086419753,20.0,30.9,37.4,28.0,21.0,0.0,0.0,41.0,6.5,7.5,7.0,19.0,285.0,251.0,14.0,25.0,41.0,11.5,21.5,41.0,41.0,31.0,2.0,31.0,34.0,31.0,6.5,35.0,18.6,10.5,25.0,31.0,21.0,23.5,-14.0,30.5,30.0,19.053872053872055,25.0,29140.0,28880.0,15.0,Washington Redskins,5387.0,5437.0,13.0,16.0,96.2,97.4,4.0,32.0,26.0,38.0,19.5,26.0,25.0,37.0,17.0,26.0,6.9,7.5,21.5,19.0,4.0,4.3,17.5,23.0,11.7,12.4,24.5,18.0,22.1,20.8,2.5,27.0,8.9,7.5,9.5,21.0,5.2,5.5,17.5,18.5,43.1,0.0,16.5,25.0,28.6,28.6,15.0,16.0,-50.0,16.0,1.725,1.7441860465116281,13.0,14.0
181.0,184.0,10.0,25.0,277.0,356.0,29.0,26.5,180.0,188.0,18.0,15.5,74.0,135.0,31.0,29.0,23.0,33.0,27.0,25.5,7.0,0.0,2.0,0.0,4.7,7.5,32.0,26.0,6539.0,28.0,5.3,8.2,30.0,30.5,30.0,154.0,162.0,25.0,14.0,-4.0,29.0,27.0,31.0,30.5,23.5,365.0,62.1,62.6,26.5,8.0,301.0,9.5,7.5,26.0,7.5,28.416666666666668,32.0,-94.67,-58.95,-140.77,32.0,28.0,-31.99,-22.28,31.0,19.0,-160.0,32.0,29.0,92.9,79.3,8.0,2.0,0.0,5.0,6.0,14.0,3.0,0.0,5.0,6.0,13.0,2.0,16.0,10.0,16.0,30.5,23.5,30.0,22.925,30.0,18.85,24.0,27.0,31.0,30.0,1.0,2.0,31.5,0.5333333333333333,23.0,26.27474747474748,31.0,29.6,31.0,24.0,4.1,2.9,17.0,26.5,3.0,2.0,14.0,20.5,29.5,46.0,25.0,3.5,11.5,0.0,1.0,28.0,21.0,1024.0,570.0,2.0,16.0,5.9,7.6,31.5,20.0,23.833333333333332,27.0,0.0,0.0,287.0,494.0,32.0,-207.0,31.0,27.0,588.0,481.0,4.0,7.0,0.6418219461697723,0.5029940119760479,29.0,2.0,2.4324324324324325,8.0,17.0,2.9,6.2,31.0,26.5,30.0,29.5,26.0,0.6538461538461539,0.5357142857142857,29.0,13.0,0.7145653876272514,0.6043416257328474,29.0,7.0,3650.0,3814.0,21.0,16.0,123.0,1007.0,786.0,7.0,27.0,95.0,7.0,29.0,0.08303249097472924,0.09269662921348316,11.0,22.0,5.5,5.6,19.0,16.0,966.0,1002.0,13.5,31.0,67.0,0.0,0.0,16.5,12.0,36.0,16.5,3023.0,0.0,16.5,23.0,58.0,2.5,24.5,0.0,0.0,9.5,24.0,231.0,266.0,10.0,27.0,1.44,2.51,32.0,25.0,29.0,27.5,73.6,97.2,29.0,25.0,3838.0,17.0,0.4111111111111111,25.0,0.3581780538302277,0.4970059880239521,4.0,31.0,0.3461538461538461,0.4642857142857143,4.0,20.0,0.2854346123727486,0.39565837426715256,4.0,26.0,346.0,498.0,28.0,32.0,9.0,26.0,32.0,24.0,1458.0,2497.0,32.0,30.0,14.481481481481481,8.0,28.7,42.9,32.0,23.0,1.0,0.0,32.0,5.2,4.6,30.0,11.0,188.0,148.0,32.0,8.0,23.0,32.0,10.0,28.0,29.0,13.0,23.0,26.0,23.0,11.0,15.0,40.0,20.4,13.0,16.0,32.0,24.0,18.0,-16.0,32.0,32.0,22.94949494949495,30.0,27874.0,29808.0,25.0,Tampa Bay Buccaneers,5108.0,6311.0,30.0,21.0,100.0,98.3,7.0,13.0,23.0,60.0,32.0,29.0,23.0,59.0,32.0,29.0,6.5,8.2,31.0,25.5,4.2,5.0,30.0,16.5,10.5,13.2,30.5,30.5,22.3,22.8,9.0,26.0,8.0,7.4,8.0,25.0,5.3,6.3,31.5,16.0,45.1,0.0,16.5,16.0,28.0,34.3,29.0,18.0,-1203.0,31.0,1.5476190476190474,1.64,22.0,24.0
194.0,195.0,23.0,11.0,251.0,268.0,3.0,32.0,122.0,175.0,12.0,32.0,103.0,73.0,2.5,9.0,26.0,20.0,6.0,20.0,1.0,0.0,0.0,1.0,3.4,5.5,9.0,32.0,5668.0,31.0,4.4,6.3,9.5,32.0,25.0,149.0,148.0,9.0,19.5,-1.0,21.0,28.8,29.8,25.0,13.0,240.0,51.2,63.5,29.0,31.0,326.0,17.0,31.0,24.0,9.5,8.083333333333334,5.0,-154.34,-107.82,-16.58,11.0,32.0,-46.04,69.01,2.0,28.0,53.14,7.0,31.0,92.0,75.9,5.0,3.0,1.0,5.0,5.0,8.0,6.0,1.0,5.0,5.0,7.0,5.0,8.0,11.0,10.0,12.5,14.166666666666666,10.0,20.45625,26.0,25.85,32.0,15.0625,15.0,27.0,3.0,2.0,28.5,0.2962962962962963,2.0,19.243434343434345,23.0,20.8,23.0,15.0,3.2,3.3,12.0,20.0,0.0,0.0,17.0,14.0,17.5,47.0,26.0,5.0,9.0,0.0,0.0,12.0,21.0,1055.0,632.0,5.0,13.0,4.2,6.1,13.0,32.0,26.75,32.0,1.0,0.0,243.0,329.0,11.0,-86.0,26.0,28.5,469.0,513.0,11.0,28.5,0.5119760479041916,0.5556690500510725,21.0,29.0,1.1844660194174756,31.0,12.0,2.6,4.1,13.5,30.0,21.0,10.5,31.0,0.5714285714285714,0.6,23.5,24.0,0.5251867919980718,0.667132587859425,13.0,31.0,2179.0,3341.0,8.0,32.0,77.0,680.0,895.0,18.0,3.0,105.0,20.0,3.0,0.10358565737051792,0.07462686567164177,22.0,8.0,5.3,5.2,3.5,24.5,1002.0,979.0,8.0,22.0,99.0,0.0,0.0,16.5,12.0,48.0,29.5,4147.0,0.0,16.5,4.0,89.0,27.0,3.0,0.0,0.0,9.5,24.0,148.0,333.0,18.0,31.0,1.11,1.59,10.5,30.0,34.0,17.0,62.2,83.7,15.5,32.0,2510.0,32.0,0.8442622950819673,2.0,0.4880239520958084,0.4443309499489275,12.0,4.0,0.4285714285714286,0.4,9.5,9.0,0.4748132080019282,0.332867412140575,20.0,2.0,489.0,435.0,16.5,4.0,9.0,14.0,21.0,24.0,1970.0,1667.0,9.0,12.0,18.40740740740741,25.0,22.7,29.2,7.0,30.0,0.0,2.0,44.0,8.6,5.7,23.5,24.0,331.0,213.0,21.0,27.0,31.0,25.5,25.5,25.0,29.0,13.0,29.0,23.0,22.0,7.0,23.5,23.0,11.3,13.3,14.5,11.0,28.0,11.0,5.0,9.0,13.0,17.68686868686869,20.0,28906.0,28860.0,19.0,Jacksonville Jaguars,4149.0,5008.0,6.0,32.0,100.0,97.2,2.0,13.0,24.0,36.0,14.0,27.5,24.0,35.0,12.5,27.5,5.4,6.9,11.5,32.0,4.0,3.8,4.5,23.0,10.5,10.9,4.0,30.5,22.4,24.3,18.0,25.0,4.4,6.9,6.0,31.0,4.1,5.1,7.5,32.0,41.9,0.0,16.5,31.0,20.8,25.6,6.5,32.0,-859.0,29.0,1.35,1.8157894736842104,8.5,30.0
186.0,186.0,12.0,22.5,258.0,343.0,28.0,31.0,170.0,193.0,21.0,22.0,69.0,136.0,32.0,32.0,19.0,14.0,1.0,30.0,1.0,0.0,0.0,0.0,4.6,7.2,29.0,29.0,5546.0,32.0,5.4,8.0,29.0,28.5,25.0,135.0,174.0,32.0,32.0,-7.3000000000000025,32.0,23.5,30.8,28.5,32.0,302.0,56.6,71.2,32.0,26.0,351.0,24.0,22.0,18.0,14.0,26.0,31.0,-97.92,-46.34,-101.27,28.0,26.0,-41.92,9.4,22.0,27.0,-89.35,29.0,30.0,85.2,85.3,23.0,11.0,0.0,7.0,7.0,10.0,3.0,0.0,7.0,6.0,8.0,2.0,15.0,9.0,21.0,29.0,26.166666666666668,32.0,23.90625,32.0,21.25,26.5,26.5625,30.0,24.0,1.0,2.0,22.5,0.625,28.0,27.781986531986533,32.0,30.5,32.0,14.0,2.6,1.6,30.0,13.5,2.0,1.0,8.0,31.5,14.0,31.0,19.0,1.0,30.0,0.0,0.0,12.0,21.0,578.0,584.0,3.0,31.0,5.3,7.0,27.5,27.5,26.166666666666668,31.0,0.0,1.0,243.0,430.0,28.0,-187.0,30.0,28.5,534.0,493.0,7.0,21.0,0.5983175604626709,0.4915254237288136,30.0,11.0,2.4637681159420293,6.0,14.0,2.6,5.1,24.5,30.0,25.0,20.5,29.0,0.6363636363636364,0.5681818181818182,27.0,18.5,0.6526476356504685,0.6119629317607413,28.0,17.0,2995.0,3632.0,15.0,27.0,76.0,549.0,804.0,8.0,1.0,84.0,1.0,1.5,0.07364341085271317,0.040816326530612235,32.0,26.0,5.3,5.9,27.5,24.5,951.0,1062.0,26.0,32.0,89.0,1.0,0.0,16.5,28.0,48.0,29.5,4102.0,0.0,16.5,6.0,74.0,12.0,9.5,0.0,1.0,23.0,24.0,108.0,554.0,29.0,32.0,1.2,2.12,28.0,28.0,32.0,22.0,72.2,103.9,31.0,30.0,3223.0,29.0,0.4058823529411765,27.0,0.4016824395373291,0.5084745762711864,3.0,22.0,0.3636363636363637,0.43181818181818177,6.0,14.5,0.34735236434953154,0.38803706823925865,5.0,16.0,382.0,540.0,32.0,29.0,8.0,19.0,30.5,27.0,1594.0,2303.0,29.0,26.0,22.34567901234568,31.0,24.2,39.2,29.0,29.0,0.0,0.0,35.0,6.2,5.6,25.5,14.0,228.0,192.0,26.5,16.0,29.0,28.5,15.5,27.0,34.0,23.0,26.5,23.0,29.0,22.5,23.5,29.0,15.6,9.1,27.0,25.5,17.0,30.0,-12.0,26.5,23.5,25.063973063973062,32.0,25110.0,32364.0,32.0,Indianapolis Colts,4589.0,5935.0,25.0,30.0,100.0,100.0,20.0,13.0,24.0,49.0,28.5,27.5,24.0,49.0,28.5,27.5,6.0,7.8,26.5,29.0,4.2,4.3,17.5,16.5,10.7,10.9,4.0,29.0,18.6,30.7,32.0,32.0,3.4,11.5,20.5,32.0,4.8,5.6,21.5,28.0,46.1,0.0,16.5,11.0,24.6,31.9,25.0,28.0,-1346.0,32.0,1.4285714285714286,1.8139534883720927,10.0,28.0
180.0,174.0,4.0,27.0,278.0,301.0,13.0,25.0,173.0,149.0,1.0,20.5,77.0,124.0,30.0,28.0,28.0,28.0,22.0,17.0,1.0,0.0,0.0,0.0,4.6,5.7,11.5,29.0,6387.0,30.0,5.3,6.6,13.5,30.5,21.0,156.0,171.0,31.0,12.0,-2.599999999999998,25.0,27.1,29.7,23.5,22.0,320.0,56.1,56.5,6.0,27.5,265.0,2.0,15.0,0.0,31.5,13.25,11.0,-74.13,-35.92,-20.82,12.0,25.0,-31.94,-0.77,24.0,18.0,-17.46,16.0,25.0,82.8,88.2,26.5,17.5,0.0,9.0,4.0,8.0,8.0,0.0,7.0,3.0,7.0,7.0,6.0,11.0,10.0,6.0,17.583333333333332,18.0,22.275,29.0,18.8,23.0,25.75,29.0,22.0,0.0,0.0,18.5,0.2727272727272727,1.0,21.194276094276095,25.0,23.7,26.0,13.0,2.3,1.9,26.0,10.0,0.0,1.0,9.0,29.0,9.5,48.0,46.0,17.5,8.0,0.0,1.0,28.0,21.0,1134.0,1055.0,18.0,9.0,5.1,5.9,6.5,30.0,24.916666666666668,28.0,0.0,0.0,218.0,307.0,5.0,-89.0,27.0,30.0,570.0,469.0,2.0,11.5,0.5947265625,0.4840579710144928,32.0,14.0,2.2467532467532467,13.0,16.0,2.8,3.4,7.0,28.0,16.0,4.0,27.0,0.8,0.5714285714285714,26.0,4.0,0.6686864315083315,0.5564121850319669,32.0,14.0,3090.0,2959.0,2.0,24.0,95.0,847.0,726.0,4.0,14.0,90.0,5.0,12.0,0.10071942446043164,0.09302325581395347,10.0,9.0,5.9,6.1,32.0,5.5,1024.0,1035.0,20.0,12.0,89.0,0.0,0.0,16.5,12.0,26.0,4.5,3570.0,0.0,16.5,17.0,76.0,15.0,9.5,1.0,1.0,23.0,9.5,423.0,303.0,13.0,12.0,1.18,1.64,14.0,29.0,38.0,13.0,72.8,80.6,9.5,29.0,3300.0,25.0,0.44508670520231214,20.0,0.4052734375,0.5159420289855072,1.0,19.0,0.2,0.4285714285714286,7.0,29.0,0.3313135684916685,0.4435878149680331,1.0,19.0,415.0,534.0,31.0,21.0,4.0,12.0,18.0,32.0,1531.0,2359.0,30.0,28.0,17.635802469135804,21.0,24.4,33.3,19.5,28.0,0.0,0.0,39.0,6.4,6.4,15.5,17.0,210.0,199.0,24.0,15.0,32.0,23.5,18.5,29.0,34.0,23.0,19.0,24.0,30.0,25.5,19.0,19.0,10.0,11.5,22.0,5.0,20.0,25.0,1.0,14.5,4.5,18.68855218855219,24.0,28080.0,29754.0,24.0,Cleveland Browns,4621.0,5318.0,10.0,29.0,100.0,100.0,20.0,13.0,20.0,31.0,5.5,30.5,20.0,31.0,6.0,30.5,5.8,6.7,5.5,31.0,3.7,4.4,20.0,31.0,10.3,11.9,13.0,32.0,23.6,22.9,11.0,17.0,11.1,11.7,23.0,9.0,4.5,5.1,7.5,30.5,40.1,0.0,16.5,32.0,25.6,30.5,21.0,25.0,-697.0,28.0,1.5675675675675675,1.5227272727272727,26.0,22.0
189.0,188.0,15.5,17.0,277.0,291.0,9.5,26.5,163.0,169.0,7.0,24.0,89.0,96.0,18.0,21.5,25.0,26.0,18.0,22.0,0.0,0.0,0.0,1.0,4.7,5.8,15.0,26.0,6628.0,27.0,5.5,6.5,11.5,27.0,20.0,150.0,159.0,23.0,18.0,-6.899999999999999,31.0,24.6,31.5,32.0,31.0,299.0,59.8,56.6,7.0,17.0,257.0,1.0,23.5,12.0,19.0,14.166666666666666,13.0,-91.84,-24.13,-35.14,15.0,22.0,-56.34,37.53,8.0,31.0,9.95,12.0,26.0,80.0,82.1,15.0,20.5,1.0,7.0,7.0,12.0,3.0,1.0,7.0,6.0,7.0,3.0,10.0,6.0,28.5,21.0,16.416666666666668,14.0,21.81875,28.0,22.95,30.0,20.6875,21.0,17.0,0.0,0.0,11.0,0.5882352941176471,27.0,21.79090909090909,27.0,24.4,27.0,18.0,3.6,4.4,2.0,25.0,2.0,0.0,20.0,7.5,23.5,46.0,25.0,3.5,11.5,0.0,0.0,12.0,21.0,979.0,605.0,4.0,20.0,5.8,6.7,23.5,23.5,26.0,30.0,0.0,0.0,212.0,338.0,12.0,-126.0,29.0,31.0,500.0,454.0,1.0,26.0,0.5230166503428012,0.4873864783047427,31.0,28.0,1.8314606741573038,20.0,13.0,2.6,5.1,24.5,30.0,23.0,15.0,30.0,0.7222222222222222,0.6216216216216216,20.0,7.0,0.6193444600844561,0.6039752484530283,30.0,24.0,3080.0,3221.0,6.0,25.0,110.0,916.0,834.0,11.5,24.0,108.0,21.0,24.0,0.09025270758122744,0.08934707903780069,14.0,18.0,5.6,5.4,11.0,13.0,1021.0,991.0,11.0,13.0,89.0,0.0,0.0,16.5,12.0,36.0,16.5,4084.0,0.0,16.5,7.0,83.0,20.0,9.5,0.0,1.0,23.0,24.0,475.0,411.0,21.0,8.0,1.05,1.74,17.5,31.0,40.0,11.0,73.0,79.1,7.0,28.0,3288.0,26.0,0.5460122699386503,13.0,0.4769833496571988,0.5126135216952573,2.0,5.0,0.2777777777777778,0.3783783783783784,13.0,26.0,0.3806555399155439,0.3960247515469717,3.0,9.0,487.0,508.0,29.0,5.0,5.0,14.0,21.0,30.5,1893.0,2112.0,26.0,15.0,16.77777777777778,17.0,22.2,31.9,13.0,31.0,0.0,1.0,34.0,6.4,6.0,21.5,17.0,208.0,186.0,29.0,14.0,29.0,28.5,14.0,30.0,28.0,9.5,16.5,24.0,23.0,11.0,19.0,28.0,12.7,13.8,12.0,17.0,26.0,14.0,-2.0,18.0,21.0,19.181818181818183,27.0,28350.0,29892.0,23.0,Kansas City Chiefs,4973.0,5333.0,11.0,27.0,100.0,100.0,20.0,13.0,20.0,37.0,16.0,30.5,20.0,37.0,17.0,30.5,6.6,7.5,21.5,23.5,3.9,4.2,15.0,27.0,11.0,13.3,32.0,27.0,21.3,24.2,17.0,30.0,11.9,11.4,18.0,6.0,4.9,5.4,15.0,26.0,45.9,0.0,16.5,12.0,26.3,28.4,14.0,20.0,-360.0,21.0,1.6923076923076923,1.7857142857142856,12.0,19.5
196.0,192.0,20.0,9.0,267.0,313.0,18.0,29.0,159.0,166.0,4.0,26.5,79.0,122.0,29.0,26.5,29.0,25.0,15.5,14.5,0.0,0.0,0.0,0.0,4.3,6.1,21.0,31.0,6485.0,29.0,5.4,7.1,21.5,28.5,18.0,138.0,160.0,24.0,30.0,-3.3000000000000007,26.5,26.4,29.7,23.5,27.5,292.0,53.2,60.5,15.5,30.0,293.0,7.0,25.0,10.0,23.0,23.083333333333332,26.5,-171.88,-101.65,-59.27,20.0,31.0,-50.48,-7.09,26.0,29.0,-51.0,21.0,32.0,75.0,83.8,20.0,30.0,0.0,7.0,7.0,12.0,2.0,0.0,7.0,6.0,8.0,0.0,13.0,6.0,28.5,27.0,21.083333333333332,28.0,23.125,31.0,21.25,26.5,25.0,27.0,27.0,0.0,4.0,28.5,0.4814814814814815,21.0,25.909259259259258,30.0,28.3,30.0,10.0,1.8,2.5,23.0,3.0,1.0,0.0,12.0,23.0,4.0,55.0,36.0,10.5,4.0,0.0,0.0,12.0,21.0,1280.0,902.0,10.0,3.0,4.8,6.3,16.5,31.0,25.916666666666668,29.0,0.0,1.0,193.0,407.0,26.0,-214.0,32.0,32.0,549.0,484.0,5.0,16.0,0.596248766041461,0.5062923523717329,28.0,12.0,2.0126582278481013,16.0,9.0,1.6,4.3,17.0,32.0,21.0,10.5,32.0,0.5625,0.5526315789473685,28.0,25.5,0.6325765924619793,0.5756888733868155,31.0,22.0,2870.0,3301.0,7.0,30.0,112.0,899.0,951.0,26.0,22.0,111.0,25.0,25.0,0.10861423220973784,0.07987220447284345,20.0,5.0,5.3,5.6,19.0,24.5,1013.0,1033.0,19.0,19.0,106.0,1.0,0.0,16.5,28.0,45.0,26.0,4652.0,0.0,16.5,2.0,81.0,17.5,1.0,1.0,2.0,29.5,9.5,297.0,552.0,28.0,20.0,0.89,1.87,22.0,32.0,27.0,30.5,69.0,87.3,23.0,31.0,3258.0,27.0,0.4968553459119497,17.0,0.40375123395853896,0.4937076476282671,5.0,21.0,0.4375,0.4473684210526315,5.0,7.5,0.3674234075380207,0.4243111266131845,2.0,11.0,409.0,510.0,30.0,23.0,7.0,17.0,27.5,29.0,1667.0,2433.0,31.0,23.0,20.901234567901238,29.0,18.9,35.9,25.0,32.0,2.0,0.0,55.0,9.1,7.5,7.0,30.0,388.0,261.0,12.0,32.0,39.0,15.5,32.0,28.0,37.0,28.5,23.0,21.0,31.0,28.0,28.0,23.0,11.2,8.9,28.0,10.0,18.0,28.5,-5.0,23.0,13.0,23.51851851851852,31.0,27048.0,30720.0,30.0,St. Louis Rams,4537.0,5734.0,22.0,31.0,100.0,100.0,20.0,13.0,18.0,44.0,25.0,32.0,18.0,44.0,25.0,32.0,5.9,7.4,19.0,30.0,4.1,4.8,27.5,19.5,11.2,12.2,19.5,26.0,23.3,25.1,24.0,21.0,11.0,12.3,26.0,10.5,4.5,5.6,21.5,30.5,43.9,0.0,16.5,21.5,23.0,29.8,18.0,31.0,-1197.0,30.0,1.4390243902439026,1.5416666666666667,25.0,27.0
189.0625,189.0625,16.5,16.5,311.3,311.3,16.5,16.5,187.2,187.2,16.5,16.5,96.7,96.7,16.5,16.5,27.3,27.3,16.5,16.5,1.6,1.6,0.8,0.8,5.9,5.9,16.5,16.5,7195.3,16.5,6.7,6.7,16.5,16.5,39.34375,153.53125,153.5,16.5,16.5,0.009374999999998579,16.5,28.2,28.190625,16.5,16.5,327.0,60.1,60.1,16.5,16.5,327.0,16.5,16.5,17.599999999999994,16.5,16.5,16.5,15.74124999999999,42.80249999999997,-42.8025,16.5,16.5,-19.5,19.5,16.5,16.5,-15.74125,16.5,16.5,82.9,82.9,16.5,16.5,0.5,9.3,8.1,9.4,4.4,0.5,8.9,7.0,6.9,2.8,9.5,9.5,16.5,16.5,16.5,16.5,16.5,16.5,16.5,16.5,16.5,16.5,20.3,1.0,1.0,16.5,0.4679802955665025,16.5,16.5,16.5,16.5,16.5,15.8,2.9,2.9,16.5,16.5,1.5,1.5,15.8,16.5,16.5,43.0,43.0,16.5,16.5,0.3,0.3,16.5,16.5,1021.3,1021.3,16.5,16.5,6.3,6.3,16.5,16.5,16.5,16.5,0.2,0.2,354.9,354.9,16.5,0.0,16.5,16.5,544.1,544.1,16.5,16.5,0.5710355669090196,0.5710355669090196,16.5,16.5,1.9358841778696998,16.5,23.3,4.3,4.3,16.5,16.5,23.3,16.5,16.5,0.6508379888268158,0.6508379888268158,16.5,16.5,0.6622456886454147,0.6622456886454147,16.5,16.5,3675.0,3675.0,16.5,16.5,102.75,867.28125,867.25,16.5,16.5,102.75,16.5,16.5,0.08769675554127851,0.08769675554127851,16.5,16.5,5.565624999999999,5.556250000000001,16.5,16.5,1017.8,1017.8,16.5,16.5,77.8,0.3,0.3,16.5,16.5,36.7,16.5,3501.6,3501.6,16.5,16.5,77.8,16.5,16.5,0.6,0.6,16.5,16.5,363.7,363.7,16.5,16.5,1.7543750000000002,1.7493749999999997,16.5,16.5,36.7,16.5,82.5,82.5,16.5,16.5,3916.5,16.5,0.5165598290598291,16.5,0.4289644330909804,0.4289644330909804,16.5,16.5,0.34916201117318424,0.34916201117318424,16.5,16.5,0.3377543113545853,0.3377543113545853,16.5,16.5,436.6,436.6,16.5,16.5,12.5,12.5,16.5,16.5,1874.3,1874.3,16.5,16.5,16.5,16.5,32.99375000000001,32.896875,16.5,16.5,0.7,0.7,37.1,6.4,6.4,16.5,16.5,241.5,241.5,16.5,16.5,37.1,16.5,16.5,31.6,31.6,16.5,16.5,26.2,26.2,16.5,16.5,25.3,12.784375,12.771875,16.5,16.5,25.3,16.5,0.0,16.5,16.5,16.5,16.5,29027.001953125,29021.09375,16.5,Avg Team,5549.3,5549.3,16.5,16.5,99.4,99.4,16.5,16.5,37.7,37.7,16.5,16.5,37.5,37.5,16.5,16.5,7.2,7.2,16.5,16.5,4.3,4.3,16.5,16.5,12.0,12.0,16.5,16.5,23.8,23.8,16.5,16.5,9.9,9.9,16.5,16.5,5.5,5.5,16.5,16.5,45.0,45.0,16.5,16.5,29.43125,29.378125,16.5,16.5,0.0,16.5,1.6744186046511629,1.6744186046511629,16.5,16.5
