Year,#Dr,#Dr_Defense,#Dr_Defense_Low_Rank,#Dr_High_Rank,1stD,1stD_Defense,1stD_Defense_Low_Rank,1stD_High_Rank,1stDpass,1stDpass_Defense,1stDpass_Defense_Low_Rank,1stDpass_High_Rank,1stDrun,1stDrun_Defense,1stDrun_Defense_Low_Rank,1stDrun_High_Rank,1stPy,1stPy_Defense,1stPy_Defense_Low_Rank,1stPy_High_Rank,2PA,2PA_Defense,2PM,2PM_Defense,ANY/A,ANY/A_Defense,ANY/A_Defense_Low_Rank,ANY/A_High_Rank,APYd,APYd_High_Rank,AY/A,AY/A_Defense,AY/A_Defense_Low_Rank,AY/A_High_Rank,AllTD,AvgDriveTime,AvgDriveTime_Defense,AvgDriveTime_High_Rank,AvgFieldPositionDifferential,AvgFieldPositionDifferential_High_Rank,AvgStartingPosition,AvgStartingPosition_Defense,AvgStartingPosition_Defense_Low_Rank,AvgStartingPosition_High_Rank,Cmp,Cmp%,Cmp%_Defense,Cmp%_Defense_Low_Rank,Cmp%_High_Rank,Cmp_Defense,Cmp_Defense_Low_Rank,Cmp_High_Rank,DefensivePtsScored,DefensivePtsScored_High_Rank,Dscore,Dscore_Rank,ExpectedPoints,ExpectedPointsPassing,ExpectedPointsPassing_Defense,ExpectedPointsPassing_Defense_High_Rank,ExpectedPointsPassing_High_Rank,ExpectedPointsRunning,ExpectedPointsRunning_Defense,ExpectedPointsRunning_Defense_High_Rank,ExpectedPointsRunning_High_Rank,ExpectedPoints_Defense,ExpectedPoints_Defense_High_Rank,ExpectedPoints_High_Rank,FG%,FG%_Defense,FG%_Defense_Low_Rank,FG%_High_Rank,FGA019,FGA2029,FGA3039,FGA4049,FGA50Plus,FGM019,FGM2029,FGM3039,FGM4049,FGM50Plus,FL,FL_Defense,FL_Defense_High_Rank,FL_Low_Rank,FantasyDstScore,FantasyDstScore_Rank,FantasyOffenseScore,FantasyOffenseScore_Rank,FantasyPassScore,FantasyPassScore_Rank,FantasyRushScore,FantasyRushScore_Rank,Fmb,FmbTD,FmbTD_Defense,FumbleLostPercent,FumbleLostPercent_Low_Rank,GameControlPlusBalance,GameControlPlusBalance_Rank,GameControlScore,GameControlScore_Rank,Int,Int%,Int%_Defense,Int%_Defense_High_Rank,Int%_Low_Rank,IntTD,IntTD_Defense,Int_Defense,Int_Defense_High_Rank,Int_Low_Rank,KickRet,KickRet_Defense,KickRet_Defense_Low_Rank,KickRet_High_Rank,KrTD,KrTD_Defense,KrTD_Defense_Low_Rank,KrTD_High_Rank,KrYds,KrYds_Defense,KrYds_Defense_Low_Rank,KrYds_High_Rank,NY/A,NY/A_Defense,NY/A_Defense_Low_Rank,NY/A_High_Rank,Oscore,Oscore_Rank,OthTD,OthTD_Defense,PF,PF_Defense,PF_Defense_Low_Rank,PF_Differential,PF_Differential_High_Rank,PF_High_Rank,PassAtt,PassAtt_Defense,PassAtt_Defense_Low_Rank,PassAtt_High_Rank,PassPercent,PassPercent_Defense,PassPercent_Defense_High_Rank,PassPercent_High_Rank,PassRun1dRatio,PassRun1dRatio_High_Rank,PassTD,PassTD%,PassTD%_Defense,PassTD%_Defense_Low_Rank,PassTD%_High_Rank,PassTD_Defense,PassTD_Defense_Low_Rank,PassTD_High_Rank,PassTdPercent,PassTdPercent_Defense,PassTdPercent_Defense_High_Rank,PassTdPercent_High_Rank,PassYdPercent,PassYdPercent_Defense,PassYdPercent_Defense_High_Rank,PassYdPercent_High_Rank,PassYds,PassYds_Defense,PassYds_Defense_Low_Rank,PassYds_High_Rank,Pen,PenYds,PenYds_Defense,PenYds_Defense_Low_Rank,PenYds_Low_Rank,Pen_Defense,Pen_Defense_Low_Rank,Pen_Low_Rank,Penalty1dPercent,Penalty1dPercent_Defense,Penalty1dPercent_Defense_High_Rank,Penalty1dPercent_High_Rank,Plays/Drive,Plays/Drive_Defense,Plays/Drive_Defense_Low_Rank,Plays/Drive_High_Rank,Ply,Ply_Defense,Ply_Defense_Low_Rank,Ply_High_Rank,Pnt,PntBlck,PntBlck_Defense,PntBlck_Defense_Low_Rank,PntBlck_Low_Rank,PntRet_Defense,PntRet_Defense_Low_Rank,PntYds,PntYds_Defense,PntYds_Defense_Low_Rank,PntYds_High_Rank,Pnt_Defense,Pnt_Defense_Low_Rank,Pnt_High_Rank,PrTD,PrTD_Defense,PrTD_Defense_Low_Rank,PrTD_High_Rank,PrYds,PrYds_Defense,PrYds_Defense_Low_Rank,PrYds_High_Rank,Pts/Drive,Pts/Drive_Defense,Pts/Drive_Defense_Low_Rank,Pts/Drive_High_Rank,PuntRet,PuntRet_High_Rank,QbRating,QbRating_Defense,QbRating_Defense_Low_Rank,QbRating_High_Rank,RawPassYds,RawPassYds_High_Rank,RunPass1dRatio,RunPass1dRatio_High_Rank,RunPercent,RunPercent_Defense,RunPercent_Defense_High_Rank,RunPercent_High_Rank,RunTdPercent,RunTdPercent_Defense,RunTdPercent_Defense_High_Rank,RunTdPercent_High_Rank,RunYdPercent,RunYdPercent_Defense,RunYdPercent_Defense_High_Rank,RunYdPercent_High_Rank,RushAtt,RushAtt_Defense,RushAtt_Defense_Low_Rank,RushAtt_High_Rank,RushTD,RushTD_Defense,RushTD_Defense_Low_Rank,RushTD_High_Rank,RushYds,RushYds_Defense,RushYds_Defense_Low_Rank,RushYds_High_Rank,STscore,STscore_Rank,Sc%,Sc%_Defense,Sc%_Defense_Low_Rank,Sc%_High_Rank,Sfty,Sfty_Defense,Sk,Sk%,Sk%_Defense,Sk%_Defense_High_Rank,Sk%_Low_Rank,SkYds,SkYds_Defense,SkYds_Defense_High_Rank,SkYds_Low_Rank,Sk_Defense,Sk_Defense_High_Rank,Sk_Low_Rank,TFGA,TFGA_Defense,TFGA_Defense_Low_Rank,TFGA_High_Rank,TFGM,TFGM_Defense,TFGM_Defense_Low_Rank,TFGM_High_Rank,TO,TO%,TO%_Defense,TO%_Defense_High_Rank,TO%_Low_Rank,TO_Defense,TO_Defense_High_Rank,TO_Differential,TO_Differential_High_Rank,TO_Low_Rank,ThreePhaseScore,ThreePhaseScore_Rank,TimeOfPossession,TimeOfPossession_Defense,TimeOfPossession_High_Rank,TotalYds,TotalYds_Defense,TotalYds_Defense_Low_Rank,TotalYds_High_Rank,XP%,XP%_Defense,XP%_Defense_Low_Rank,XP%_High_Rank,XPA,XPA_Defense,XPA_Defense_Low_Rank,XPA_High_Rank,XPM,XPM_Defense,XPM_Defense_Low_Rank,XPM_High_Rank,Y/Apass,Y/Apass_Defense,Y/Apass_Defense_Low_Rank,Y/Apass_High_Rank,Y/Arun,Y/Arun_Defense,Y/Arun_Defense_Low_Rank,Y/Arun_High_Rank,Y/C,Y/C_Defense,Y/C_Defense_Low_Rank,Y/C_High_Rank,Y/KR,Y/KR_Defense,Y/KR_Defense_Low_Rank,Y/KR_High_Rank,Y/PR,Y/PR_Defense,Y/PR_Defense_Low_Rank,Y/PR_High_Rank,Y/Play,Y/Play_Defense,Y/Play_Defense_Low_Rank,Y/Play_High_Rank,Y/Pnt,Y/Pnt_Defense,Y/Pnt_Defense_Low_Rank,Y/Pnt_High_Rank,Yds/Drive,Yds/Drive_Defense,Yds/Drive_Defense_Low_Rank,Yds/Drive_High_Rank,Yds_Differential,Yds_Differential_High_Rank,YppYprRatio,YppYprRatio_Defense,YppYprRatio_Defense_High_Rank,YppYprRatio_High_Rank
1981.0,,,,,343.0,299.0,12.5,4.0,217.0,163.0,17.0,2.0,91.0,117.0,14.0,27.5,35.0,19.0,5.0,2.0,0.0,0.0,0.0,0.0,4.8,6.1,25.0,16.5,7794.0,6.0,5.4,7.1,23.5,21.0,37.0,,,,,,,,,,382.0,53.9,55.1,14.0,18.0,265.0,8.0,1.0,12.0,12.5,17.333333333333332,20.0,,,,,,,,,,,,,84.0,63.0,12.0,2.0,1.0,6.0,12.0,6.0,0.0,1.0,5.0,11.0,4.0,0.0,21.0,19.0,10.5,22.5,17.25,22.0,16.9,21.0,7.55,5.0,26.25,28.0,39.0,1.0,1.0,0.5384615384615384,16.0,,,,,29.0,4.1,3.3,24.5,10.5,0.0,3.0,16.0,25.0,26.0,67.0,62.0,15.0,10.5,1.0,0.0,12.5,3.0,1328.0,1260.0,15.0,10.0,5.9,6.5,23.5,18.0,14.583333333333336,16.0,0.0,0.0,325.0,369.0,21.0,-44.0,18.0,13.0,709.0,481.0,8.0,1.0,0.6536758193091231,0.4876660341555977,23.0,1.0,2.3846153846153846,1.0,27.0,3.8,5.4,24.0,17.0,26.0,23.5,4.5,0.7714285714285715,0.6341463414634146,8.0,1.0,0.7413173652694611,0.619393262609343,11.0,1.0,4333.0,3328.0,18.0,2.0,109.0,865.0,991.0,26.0,12.0,115.0,25.0,19.5,0.1020408163265306,0.06354515050167224,22.0,3.0,,,,,1129.0,1054.0,14.0,3.5,88.0,0.0,0.0,14.5,11.5,46.0,18.0,3646.0,3419.0,18.0,6.0,84.0,20.0,6.5,0.0,1.0,23.0,18.5,303.0,399.0,18.0,21.0,,,,,39.0,21.0,69.5,83.3,25.0,20.0,4567.0,2.0,0.41935483870967744,28.0,0.3463241806908769,0.5123339658444023,6.0,28.0,0.2285714285714285,0.36585365853658536,21.0,28.0,0.2586826347305389,0.3806067373906571,18.0,28.0,391.0,540.0,20.0,28.0,8.0,15.0,12.5,28.0,1512.0,2045.0,15.0,28.0,12.303030303030305,8.0,0.0,0.0,14.5,14.5,3.0,0.0,29.0,3.9,6.4,18.0,3.5,234.0,271.0,16.0,9.0,33.0,17.5,6.5,25.0,27.0,13.0,18.5,21.0,17.0,10.5,9.5,50.0,0.0,0.0,14.5,14.5,35.0,19.5,-15.0,25.0,26.5,14.961432506887052,17.0,,,,5845.0,5373.0,17.5,6.0,91.9,91.3,8.0,23.0,37.0,46.0,24.0,17.5,34.0,42.0,23.0,21.0,6.4,7.5,22.0,23.0,3.9,3.8,10.0,20.0,12.0,13.6,19.5,24.5,19.8,20.3,13.5,15.0,7.8,8.7,16.5,15.5,5.2,5.1,16.0,11.5,41.4,40.7,11.5,11.0,,,,,472.0,10.0,1.6410256410256412,1.973684210526316,6.0,21.0
1982.0,,,,,167.0,159.0,6.0,14.0,107.0,87.0,8.0,4.0,52.0,53.0,4.5,22.5,8.0,19.0,24.5,26.0,0.0,0.0,0.0,0.0,4.9,4.8,15.5,12.5,4049.0,10.0,5.6,6.1,18.0,17.5,23.0,,,,,,,,,,187.0,56.0,53.8,9.5,11.0,157.0,14.5,4.0,14.0,4.5,15.5,18.0,,,,,,,,,,,,,57.1,57.9,5.0,22.5,0.0,5.0,2.0,6.0,1.0,0.0,4.0,1.0,3.0,0.0,5.0,9.0,15.5,2.0,13.5,11.0,12.75,10.0,7.5,5.0,18.0,18.0,12.0,1.0,1.0,0.4166666666666667,7.0,,,,,12.0,3.6,4.1,17.0,9.5,1.0,3.0,12.0,16.5,13.5,37.0,38.0,17.5,9.0,0.0,0.0,13.5,15.5,786.0,663.0,12.0,6.0,5.5,5.8,13.0,16.5,13.083333333333336,12.0,0.0,1.0,187.0,198.0,20.0,-11.0,16.0,13.0,334.0,292.0,20.0,3.5,0.5923460898502496,0.5532646048109966,8.0,4.0,2.0576923076923075,3.0,15.0,4.5,3.8,13.5,9.5,11.0,14.5,6.0,0.7142857142857143,0.5789473684210527,15.5,5.0,0.6832233414379993,0.6476683937823834,11.0,7.0,1967.0,1875.0,19.0,5.0,62.0,496.0,399.0,7.0,17.0,48.0,7.0,21.0,0.04790419161676647,0.11949685534591195,2.0,26.0,,,,,601.0,582.0,12.0,8.0,58.0,0.0,0.0,14.5,11.0,30.0,22.0,2384.0,2095.0,23.0,2.0,50.0,22.0,2.0,0.0,0.0,12.5,16.5,196.0,176.0,10.0,13.0,,,,,24.0,13.0,75.0,72.4,14.0,12.0,2105.0,7.0,0.485981308411215,26.0,0.4076539101497504,0.4467353951890034,21.0,25.0,0.2857142857142857,0.42105263157894735,13.5,24.0,0.31677665856200066,0.3523316062176166,18.0,22.0,245.0,260.0,9.5,23.0,6.0,8.0,14.0,18.5,912.0,1020.0,14.0,22.0,12.333333333333336,7.5,0.0,0.0,14.5,14.5,1.0,0.0,22.0,6.2,9.3,10.5,8.0,138.0,231.0,9.5,8.0,30.0,10.0,11.0,14.0,19.0,22.0,19.5,8.0,11.0,15.0,23.0,17.0,0.0,0.0,14.5,14.5,21.0,18.0,4.0,9.5,5.5,13.757575757575758,13.0,,,,2879.0,2895.0,19.0,14.0,100.0,87.5,2.5,6.0,23.0,24.0,21.0,10.0,23.0,21.0,19.5,8.5,6.3,7.2,16.5,22.0,3.7,3.9,17.0,15.5,11.3,13.4,21.0,24.5,21.2,17.4,3.0,6.0,8.2,5.9,8.0,13.0,4.8,5.0,18.5,17.0,41.1,41.9,22.0,12.0,,,,,-16.0,15.0,1.7027027027027026,1.8461538461538465,13.0,22.0
1983.0,,,,,303.0,318.0,16.0,18.0,169.0,150.0,4.5,13.0,112.0,147.0,25.0,19.0,22.0,21.0,12.0,13.0,0.0,0.0,0.0,0.0,4.2,4.3,7.0,21.0,7110.0,20.0,5.1,5.4,5.5,22.5,34.0,,,,,,,,,,310.0,55.9,55.0,9.0,18.5,263.0,6.0,10.0,16.0,19.0,14.583333333333336,18.0,,,,,,,,,,,,,75.8,66.7,8.5,14.0,0.0,10.0,14.0,9.0,0.0,0.0,9.0,12.0,4.0,0.0,10.0,23.0,3.0,2.5,14.333333333333336,15.0,15.14375,19.0,14.35,18.0,15.9375,17.0,33.0,1.0,1.0,0.30303030303030304,1.0,,,,,22.0,4.0,5.2,6.0,8.0,0.0,2.0,25.0,9.0,12.5,68.0,70.0,20.5,8.5,0.0,0.0,13.0,15.5,1466.0,1392.0,21.0,3.0,5.4,5.5,4.5,24.5,17.916666666666668,21.0,1.0,0.0,316.0,348.0,17.0,-32.0,20.0,18.0,555.0,478.0,6.0,7.0,0.5599250936329588,0.4755434782608696,25.0,8.0,1.5089285714285714,13.0,15.0,2.7,4.8,20.0,27.0,23.0,18.5,23.5,0.46875,0.5897435897435898,15.0,24.5,0.6397688782626021,0.5290687078549299,26.0,10.0,3211.0,2903.0,6.0,13.0,90.0,748.0,759.0,8.0,5.5,92.0,9.0,8.5,0.07260726072607261,0.0660377358490566,18.0,13.0,,,,,1068.0,1104.0,26.0,11.0,91.0,0.0,0.0,14.5,8.0,40.0,10.0,3780.0,3026.0,9.0,3.0,77.0,9.5,4.5,0.0,0.0,9.5,20.5,210.0,297.0,7.0,27.0,,,,,24.0,27.0,67.5,70.3,9.0,21.0,3514.0,13.0,0.6627218934911243,16.0,0.4400749063670412,0.5244565217391304,4.0,21.0,0.53125,0.41025641025641024,14.0,4.5,0.3602311217373979,0.4709312921450701,3.0,19.0,470.0,579.0,26.0,21.0,17.0,16.0,18.5,11.5,1808.0,2584.0,25.0,20.0,10.5,5.0,0.0,0.0,14.5,14.5,2.0,1.0,43.0,7.2,9.0,10.0,11.0,303.0,326.0,13.0,7.0,47.0,11.0,12.5,33.0,27.0,13.5,4.0,25.0,18.0,11.5,6.0,32.0,0.0,0.0,14.5,14.5,48.0,5.0,16.0,3.0,5.0,14.681818181818182,14.0,,,,5019.0,5487.0,19.0,20.0,97.1,95.2,13.0,11.0,34.0,42.0,18.0,23.0,33.0,40.0,18.0,22.0,6.3,6.8,5.0,27.0,3.8,4.5,26.0,22.0,11.3,12.3,12.0,26.5,21.6,19.9,18.0,3.0,8.8,7.4,9.0,12.0,4.7,5.0,13.0,24.0,41.5,39.3,5.0,11.5,,,,,-468.0,21.0,1.6578947368421053,1.5111111111111108,27.0,19.0
1984.0,,,,,289.0,342.0,25.0,22.0,150.0,182.0,19.5,23.0,111.0,144.0,27.0,18.0,28.0,16.0,6.5,5.0,0.0,0.0,0.0,0.0,3.5,7.7,28.0,26.0,7230.0,16.0,4.8,8.5,28.0,26.0,31.0,,,,,,,,,,281.0,52.7,65.1,28.0,23.0,319.0,24.0,18.5,18.0,13.0,26.66666666666667,28.0,,,,,,,,,,,,,87.0,85.7,26.0,1.0,2.0,3.0,9.0,5.0,4.0,2.0,3.0,9.0,3.0,3.0,16.0,18.0,7.5,16.5,22.33333333333333,27.0,19.16875,26.0,19.4,24.0,18.9375,21.0,39.0,2.0,2.0,0.41025641025641024,4.0,,,,,25.0,4.7,2.2,28.0,20.5,1.0,2.0,11.0,28.0,21.5,86.0,59.0,10.0,1.0,0.0,0.0,12.0,17.0,1775.0,1281.0,14.0,1.0,4.8,7.3,28.0,26.0,21.5,24.0,0.0,0.0,276.0,484.0,28.0,-208.0,28.0,24.0,533.0,490.0,7.5,10.0,0.5734870317002881,0.4849340866290019,25.0,6.0,1.3513513513513509,20.0,18.0,3.4,7.1,28.0,20.5,35.0,28.0,20.5,0.6428571428571429,0.6363636363636364,10.0,9.0,0.6089906700593724,0.5949307304785895,19.0,18.0,2872.0,3779.0,26.0,22.0,90.0,762.0,1047.0,25.0,8.0,113.0,22.0,8.0,0.09688581314878893,0.04678362573099415,26.0,3.0,,,,,1041.0,1062.0,19.0,18.0,82.0,0.0,0.0,14.5,9.5,49.0,20.5,3473.0,2774.0,3.5,13.0,68.0,5.5,14.0,0.0,0.0,11.0,18.0,217.0,435.0,17.0,25.0,,,,,31.0,27.0,63.8,104.4,28.0,25.0,3337.0,22.0,0.74,9.0,0.4265129682997119,0.5150659133709979,4.0,23.0,0.3571428571428571,0.3636363636363637,19.0,20.0,0.3910093299406277,0.40506926952141054,10.0,11.0,444.0,547.0,24.0,24.0,10.0,20.0,24.0,24.0,1844.0,2573.0,27.0,18.0,13.191919191919196,10.0,0.0,0.0,14.5,14.5,0.0,0.0,64.0,10.7,4.9,28.0,25.0,465.0,175.0,28.0,25.0,25.0,28.0,26.0,23.0,28.0,14.5,23.5,20.0,24.0,23.5,17.0,41.0,0.0,0.0,14.5,14.5,29.0,24.0,-12.0,26.0,23.0,21.112947658402206,26.0,,,,4716.0,6352.0,28.0,25.0,96.8,98.3,20.0,18.0,31.0,59.0,28.0,22.5,30.0,58.0,28.0,24.0,6.3,8.1,27.0,25.5,4.2,4.7,27.0,9.0,11.9,12.4,11.5,23.0,20.6,21.7,24.0,7.0,7.0,8.9,15.5,21.0,4.5,6.0,28.0,25.5,42.4,40.8,13.0,6.5,,,,,-1636.0,28.0,1.5,1.7234042553191489,19.0,26.0
1985.0,,,,,317.0,324.0,19.0,12.0,189.0,163.0,11.5,8.0,95.0,139.0,24.0,21.0,33.0,22.0,15.0,3.5,0.0,0.0,0.0,0.0,4.5,5.1,17.0,17.0,7346.0,16.0,5.3,5.9,13.5,21.5,43.0,,,,,,,,,,311.0,54.0,57.1,20.0,16.0,280.0,16.0,6.0,14.0,12.0,15.25,16.0,,,,,,,,,,,,,57.7,78.4,20.0,26.0,2.0,11.0,7.0,5.0,1.0,1.0,10.0,3.0,1.0,0.0,18.0,22.0,3.5,15.5,14.791666666666664,14.0,16.09375,20.0,12.0,11.0,20.1875,20.0,27.0,1.0,1.0,0.6666666666666666,26.0,,,,,29.0,5.0,4.5,8.5,24.0,1.0,2.0,22.0,13.0,26.0,68.0,68.0,20.0,7.0,0.0,0.0,11.5,17.0,1576.0,1491.0,22.0,2.0,5.9,6.2,20.0,11.5,17.083333333333332,19.0,0.0,0.0,346.0,359.0,17.0,-13.0,16.0,14.0,576.0,490.0,9.0,4.5,0.6046738072054528,0.4910798122065728,24.0,1.0,1.9894736842105265,5.0,22.0,3.8,4.1,15.5,20.0,20.0,13.0,12.0,0.5365853658536586,0.5555555555555556,16.0,18.0,0.7056882158804115,0.5931551976573939,23.0,2.0,3635.0,3241.0,15.0,7.0,88.0,690.0,1000.0,28.0,7.0,123.0,28.0,8.0,0.10410094637223977,0.06790123456790123,16.0,2.0,,,,,1027.0,1065.0,17.0,18.0,67.0,0.0,0.0,14.5,9.0,36.0,8.5,2867.0,2691.0,5.0,26.0,65.0,4.0,26.0,0.0,0.0,10.5,17.5,250.0,328.0,12.0,22.5,,,,,25.0,27.0,67.3,74.1,15.0,20.0,3931.0,9.0,0.5026455026455027,24.0,0.3953261927945472,0.5089201877934273,5.0,28.0,0.4634146341463414,0.4444444444444444,13.0,11.0,0.2943117841195885,0.4068448023426061,6.0,27.0,406.0,542.0,23.0,28.0,19.0,16.0,14.0,9.5,1516.0,2223.0,22.0,27.0,14.404040404040403,13.0,0.0,0.0,14.5,14.5,1.0,0.0,45.0,7.2,6.3,25.5,8.0,296.0,223.0,27.5,6.0,33.0,26.0,16.0,26.0,37.0,26.0,23.0,15.0,29.0,27.0,23.0,47.0,0.0,0.0,14.5,14.5,44.0,5.5,-3.0,18.0,25.0,15.685950413223141,18.0,,,,5151.0,5464.0,16.0,16.0,95.3,97.4,20.5,18.0,43.0,39.0,14.0,9.5,41.0,38.0,15.0,10.0,6.8,7.1,16.5,18.0,3.7,4.1,14.0,24.0,12.6,12.4,9.5,17.5,23.2,21.9,19.5,3.0,10.0,9.1,20.0,7.0,5.0,5.1,16.5,14.5,42.8,41.4,16.5,6.0,,,,,-313.0,20.0,1.8378378378378373,1.7317073170731707,15.0,10.0
1986.0,,,,,321.0,286.0,10.0,7.0,186.0,155.0,9.0,7.5,114.0,106.0,16.0,8.5,21.0,25.0,14.0,20.5,0.0,0.0,0.0,0.0,6.9,4.6,11.0,2.0,7322.0,9.0,8.0,5.5,8.0,1.0,48.0,,,,,,,,,,290.0,55.9,55.9,12.0,13.0,276.0,10.0,13.0,18.0,11.0,10.0,6.0,,,,,,,,,,,,,78.6,81.8,27.0,5.0,0.0,8.0,10.0,7.0,3.0,0.0,7.0,9.0,4.0,2.0,14.0,18.0,9.5,11.5,12.166666666666664,10.0,9.63125,4.0,4.45,3.0,14.8125,14.0,31.0,0.0,1.0,0.4516129032258064,13.0,,,,,15.0,2.9,4.9,6.5,3.5,2.0,0.0,24.0,7.5,4.5,56.0,79.0,26.0,19.5,0.0,0.0,12.0,17.0,1200.0,1532.0,26.0,13.0,7.0,6.0,19.0,3.0,7.0,4.0,1.0,1.0,398.0,273.0,5.0,125.0,4.0,4.0,519.0,494.0,10.0,15.0,0.5498046875,0.5251727541954591,17.0,15.0,1.631578947368421,14.0,31.0,6.0,3.2,6.0,2.0,16.0,5.0,2.0,0.6888888888888889,0.6153846153846154,16.0,8.0,0.6924438152539374,0.6416600159616921,15.0,5.0,3913.0,3216.0,13.0,5.0,96.0,890.0,806.0,13.0,19.0,99.0,10.5,8.5,0.06542056074766353,0.08741258741258741,13.0,21.0,,,,,1024.0,1013.0,5.0,19.0,73.0,1.0,0.0,14.5,17.0,40.0,13.0,2963.0,3022.0,7.0,25.0,75.0,6.5,25.0,0.0,0.0,10.5,20.5,215.0,356.0,14.0,27.0,,,,,31.0,26.0,90.1,68.5,7.0,3.0,4185.0,4.0,0.6129032258064516,15.0,0.4501953125,0.47482724580454105,12.0,14.0,0.3111111111111111,0.3846153846153846,13.0,21.0,0.3075561847460626,0.358339984038308,14.0,24.0,461.0,481.0,14.0,19.0,14.0,10.0,5.5,15.0,1738.0,1796.0,13.0,16.0,14.01010101010101,13.0,0.0,0.0,14.5,14.5,0.0,0.0,44.0,7.8,7.1,18.0,15.5,272.0,259.0,21.0,11.0,38.0,19.0,15.0,28.0,33.0,24.5,14.0,22.0,27.0,28.0,9.0,29.0,0.0,0.0,14.5,14.5,42.0,7.0,13.0,4.5,6.5,10.00275482093664,4.0,,,,5651.0,5012.0,11.0,4.0,93.6,88.9,1.0,26.0,47.0,27.0,3.5,3.0,44.0,24.0,2.0,4.5,8.1,7.0,16.5,2.0,3.8,3.7,8.0,17.5,14.4,12.6,12.0,3.0,21.4,19.4,12.0,5.0,6.9,8.9,16.5,25.0,5.5,4.9,12.5,3.0,40.6,40.3,12.0,17.0,,,,,639.0,4.0,2.131578947368421,1.8918918918918919,8.5,4.0
1987.0,,,,,293.0,281.0,11.0,14.5,136.0,159.0,13.5,25.5,129.0,95.0,8.0,4.0,28.0,27.0,16.5,9.0,0.0,0.0,0.0,0.0,4.4,4.5,8.0,24.5,7051.0,10.0,5.8,5.5,8.0,19.5,42.0,,,,,,,,,,232.0,52.0,55.8,16.5,22.0,278.0,21.0,25.0,2.0,26.5,12.583333333333336,11.5,,,,,,,,,,,,,48.3,77.4,23.0,28.0,0.0,12.0,6.0,9.0,2.0,0.0,10.0,3.0,0.0,1.0,10.0,11.0,26.0,2.0,13.833333333333336,14.0,12.49375,13.0,18.3,23.0,6.6875,2.0,28.0,0.0,1.0,0.35714285714285715,2.0,,,,,23.0,5.2,5.2,5.0,25.5,0.0,3.0,26.0,4.0,23.0,71.0,64.0,21.0,2.5,0.0,0.0,11.5,17.0,1421.0,1173.0,17.0,4.0,5.7,5.8,11.5,17.0,13.0,13.0,0.0,1.0,336.0,335.0,16.5,1.0,12.0,13.0,446.0,498.0,20.0,22.0,0.5081632653061224,0.5505617977528089,7.0,19.0,1.054263565891473,28.0,21.0,4.7,4.8,16.0,12.0,24.0,18.0,15.5,0.5121951219512195,0.7272727272727273,6.0,28.0,0.5876481597005615,0.6426202321724711,10.0,22.0,2826.0,3100.0,16.0,20.0,96.0,814.0,964.0,26.0,16.0,107.0,21.5,11.0,0.09556313993174062,0.09608540925266904,10.0,8.0,,,,,980.0,979.0,11.0,18.0,79.0,1.0,0.0,14.5,15.0,44.0,21.0,3116.0,2953.0,11.0,12.0,74.0,10.5,12.0,1.0,0.0,10.0,6.0,420.0,424.0,19.5,10.0,,,,,36.0,16.5,69.4,71.4,8.0,23.0,3185.0,18.0,0.9485294117647058,1.0,0.4918367346938776,0.4494382022471911,22.0,10.0,0.4878048780487805,0.2727272727272727,23.0,1.0,0.4123518402994385,0.357379767827529,19.0,7.0,482.0,440.0,7.0,14.0,20.0,9.0,8.0,1.5,1983.0,1724.0,11.0,11.0,15.040404040404038,19.0,0.0,0.0,14.5,14.5,1.0,0.0,52.0,10.4,7.6,14.5,24.5,359.0,307.0,11.0,20.5,41.0,11.5,22.5,29.0,31.0,21.5,13.5,14.0,24.0,24.0,24.5,33.0,0.0,0.0,14.5,14.5,37.0,11.5,4.0,12.0,10.0,13.404958677685952,9.0,,,,4809.0,4824.0,10.0,15.0,97.6,92.1,6.0,11.0,41.0,38.0,17.0,9.0,40.0,35.0,13.5,9.0,7.1,6.8,9.5,13.0,4.1,3.9,15.0,8.5,13.7,12.3,7.5,5.0,20.0,18.3,8.0,13.0,11.7,9.6,17.5,3.0,4.9,4.9,12.0,15.0,39.4,39.9,19.0,17.0,,,,,-15.0,14.0,1.7317073170731707,1.7435897435897436,17.0,16.0
1988.0,,,,,318.0,243.0,1.0,8.5,187.0,132.0,1.0,6.0,112.0,85.0,2.5,16.5,19.0,26.0,18.0,21.5,0.0,0.0,0.0,0.0,6.0,2.1,1.0,4.5,7663.0,3.0,7.1,2.9,1.0,3.0,49.0,,,,,,,,,,294.0,56.5,45.6,2.0,9.0,219.0,2.0,11.0,46.0,1.0,2.083333333333333,1.0,,,,,,,,,,,,,80.0,84.0,26.0,6.5,3.0,7.0,10.0,5.0,0.0,2.0,7.0,10.0,1.0,0.0,12.0,17.0,8.0,6.5,4.916666666666667,1.0,10.725,7.0,7.95,6.0,13.5,13.0,22.0,2.0,0.0,0.5454545454545454,19.0,,,,,18.0,3.5,7.5,1.0,10.0,5.0,1.0,36.0,1.0,11.5,56.0,81.0,27.5,22.5,0.0,0.0,11.0,17.5,1160.0,1622.0,28.0,16.0,6.7,4.8,1.0,4.5,8.916666666666666,4.0,0.0,1.0,406.0,233.0,2.0,173.0,1.0,4.0,520.0,480.0,8.0,13.0,0.5308988764044944,0.5430672268907563,11.0,14.0,1.6696428571428572,10.0,20.0,3.8,2.5,1.5,14.5,12.0,2.0,15.5,0.4761904761904762,0.5454545454545454,17.0,23.0,0.6772117962466488,0.6084087020288438,16.0,5.0,3789.0,2489.0,2.0,4.0,118.0,998.0,753.0,8.0,25.0,91.0,7.5,25.5,0.059748427672955975,0.10699588477366256,4.0,22.0,,,,,1068.0,952.0,1.0,7.0,86.0,2.0,0.0,14.5,24.5,39.0,15.5,3468.0,4061.0,28.0,7.0,96.0,28.0,7.0,0.0,0.0,11.5,17.0,553.0,405.0,19.0,2.0,,,,,59.0,1.0,80.4,41.2,1.0,7.0,4100.0,4.0,0.5989304812834224,19.0,0.4691011235955056,0.4569327731092437,18.0,15.0,0.5238095238095238,0.4545454545454546,12.0,6.0,0.3227882037533512,0.3915912979711562,13.0,24.0,501.0,435.0,4.0,12.0,22.0,10.0,5.0,5.0,1806.0,1602.0,5.0,20.0,14.727272727272727,15.0,0.0,0.0,14.5,14.5,2.0,2.0,47.0,8.3,7.2,14.0,22.0,311.0,274.0,15.0,19.0,37.0,15.5,22.5,25.0,25.0,9.5,20.0,20.0,21.0,15.0,16.5,30.0,0.0,0.0,14.5,14.5,53.0,1.0,23.0,1.0,6.5,8.016528925619836,2.0,,,,5595.0,4091.0,1.0,7.0,98.0,91.7,4.0,8.0,49.0,24.0,1.0,3.0,48.0,22.0,1.5,2.5,7.9,5.8,1.0,2.0,3.6,3.7,6.5,23.0,13.9,12.6,13.0,6.0,20.7,20.0,15.0,9.5,9.4,10.4,23.0,7.0,5.2,4.3,1.0,9.0,40.3,42.3,27.0,15.5,,,,,1504.0,1.0,2.1944444444444446,1.5675675675675675,23.0,1.0
1989.0,,,,,326.0,266.0,3.5,8.0,172.0,140.0,1.5,14.0,126.0,100.0,10.0,4.0,28.0,26.0,19.5,7.0,0.0,0.0,0.0,0.0,5.0,3.7,1.0,14.5,7197.0,12.0,5.9,5.2,5.0,15.5,36.0,,,,,,,,,,272.0,54.5,51.6,5.0,17.0,252.0,2.5,18.0,40.0,2.0,5.25,2.0,,,,,,,,,,,,,72.7,61.9,4.0,13.5,3.0,15.0,10.0,12.0,4.0,3.0,14.0,6.0,8.0,1.0,14.0,18.0,6.0,12.0,6.416666666666668,2.0,12.94375,12.0,14.95,17.0,10.9375,10.0,28.0,4.0,0.0,0.5,15.0,,,,,19.0,3.8,3.7,16.5,14.0,2.0,2.0,18.0,19.5,13.0,51.0,68.0,21.5,24.0,1.0,0.0,11.0,5.0,1122.0,1287.0,21.0,18.0,5.9,4.5,1.0,15.0,12.166666666666664,9.0,0.0,0.0,351.0,275.0,6.0,76.0,10.0,11.0,499.0,488.0,9.5,16.0,0.5118708452041786,0.5475024485798237,11.0,19.0,1.3650793650793651,20.0,17.0,3.4,3.7,11.5,19.0,18.0,9.5,20.0,0.5862068965517241,0.5625,19.0,18.5,0.6068506184586109,0.5977533460803061,24.0,20.0,3189.0,2501.0,1.0,17.0,119.0,974.0,903.0,21.5,24.0,116.0,24.0,23.0,0.08588957055214724,0.09774436090225563,5.0,10.0,,,,,1053.0,1021.0,13.0,6.0,72.0,0.0,0.0,14.5,7.0,32.0,8.0,2864.0,3857.0,28.0,16.0,95.0,28.0,15.5,0.0,0.0,12.0,17.0,448.0,300.0,9.0,5.0,,,,,45.0,6.0,72.0,67.7,7.0,15.0,3468.0,17.0,0.7325581395348837,9.0,0.4881291547958214,0.4524975514201763,18.0,10.0,0.4137931034482759,0.4375,10.0,10.5,0.3931493815413891,0.4022466539196941,5.0,9.0,514.0,462.0,14.0,8.5,12.0,14.0,15.0,18.5,2066.0,1683.0,11.0,7.0,12.12121212121212,5.0,0.0,0.0,14.5,14.5,2.0,0.0,40.0,7.4,12.7,1.0,16.0,279.0,502.0,1.0,14.0,71.0,1.0,14.0,44.0,21.0,2.5,1.0,32.0,13.0,1.0,1.0,33.0,0.0,0.0,14.5,14.5,36.0,17.0,3.0,15.0,13.0,9.639118457300274,2.0,,,,5255.0,4184.0,1.0,14.0,97.2,97.0,12.0,16.0,36.0,33.0,9.5,15.5,35.0,32.0,10.0,15.5,6.9,6.2,2.0,16.5,4.0,3.6,3.0,12.0,12.8,11.9,5.5,14.5,22.0,18.9,10.5,3.0,10.0,9.4,19.0,9.0,5.0,4.1,1.0,15.0,39.8,40.6,19.0,17.0,,,,,1071.0,3.0,1.725,1.7222222222222223,16.0,19.0
1990.0,,,,,288.0,257.0,5.5,11.0,164.0,136.0,2.0,11.0,106.0,107.0,16.0,16.0,18.0,14.0,4.5,19.0,0.0,0.0,0.0,0.0,4.7,4.4,5.0,19.0,6814.0,10.0,5.8,5.5,5.5,19.0,39.0,,,,,,,,,,265.0,53.3,51.7,4.0,23.0,218.0,1.5,13.5,28.0,4.0,11.583333333333336,11.0,,,,,,,,,,,,,89.3,83.3,26.0,2.0,0.0,10.0,9.0,9.0,0.0,0.0,10.0,9.0,6.0,0.0,13.0,11.0,22.5,8.0,10.25,6.0,14.11875,17.0,12.55,12.0,15.6875,16.0,30.0,2.0,0.0,0.43333333333333335,5.0,,,,,24.0,4.8,5.2,3.5,24.0,2.0,1.0,22.0,5.0,27.0,66.0,62.0,17.5,4.5,0.0,0.0,11.5,17.0,1249.0,1350.0,24.0,8.0,5.8,5.6,9.0,17.0,13.916666666666664,16.0,0.0,1.0,351.0,326.0,16.0,25.0,13.0,9.0,497.0,422.0,3.0,11.0,0.5454545454545454,0.4825102880658436,25.0,14.0,1.5471698113207548,13.0,25.0,5.0,4.7,21.5,8.0,20.0,12.5,5.5,0.7142857142857143,0.625,11.5,6.0,0.6291219705999206,0.5603137587449649,26.0,13.0,3167.0,2643.0,3.0,11.0,83.0,565.0,787.0,16.0,2.0,100.0,17.0,6.0,0.0625,0.05447470817120623,22.0,21.0,,,,,1001.0,972.0,16.5,8.0,79.0,1.0,0.0,14.5,18.5,44.0,25.5,3341.0,3034.0,23.0,3.0,77.0,25.5,3.5,0.0,0.0,11.5,18.0,225.0,513.0,28.0,23.0,,,,,33.0,19.5,72.0,68.0,5.0,21.0,3445.0,11.0,0.6463414634146342,16.0,0.4545454545454546,0.5174897119341564,4.0,15.0,0.2857142857142857,0.375,17.5,23.0,0.3708780294000794,0.43968624125503497,3.0,16.0,455.0,503.0,23.0,15.0,10.0,12.0,13.5,22.5,1867.0,2074.0,21.0,15.0,15.434343434343436,17.0,0.0,0.0,14.5,14.5,2.0,0.0,49.0,9.0,10.0,2.0,22.0,278.0,277.0,13.0,16.5,47.0,3.0,23.0,28.0,36.0,27.0,13.0,25.0,30.0,27.0,4.5,37.0,0.0,0.0,14.5,14.5,33.0,10.0,-4.0,19.5,23.0,13.482093663911849,13.0,,,,5034.0,4717.0,13.0,12.0,100.0,94.1,6.0,7.0,38.0,34.0,13.0,12.5,38.0,32.0,11.0,11.5,6.9,6.9,12.5,17.0,4.1,4.1,16.0,11.5,13.0,13.4,22.5,7.5,18.9,21.8,25.0,15.0,6.8,11.7,28.0,23.0,5.0,4.9,11.5,17.5,42.3,39.4,8.0,8.0,,,,,317.0,12.0,1.6829268292682928,1.6829268292682928,16.0,18.0
1991.0,,,,,300.0,301.0,19.5,10.0,158.0,172.0,17.0,16.5,125.0,106.0,22.0,4.0,17.0,23.0,23.0,17.0,0.0,0.0,0.0,0.0,4.9,5.1,11.0,19.0,6336.0,16.0,5.5,5.9,11.0,19.5,36.0,,,,,,,,,,284.0,59.5,57.3,10.5,8.0,286.0,12.5,16.0,12.0,16.0,17.0,15.0,,,,,,,,,,,,,70.8,69.0,7.5,17.0,0.0,9.0,3.0,7.0,5.0,0.0,9.0,3.0,3.0,2.0,10.0,11.0,22.0,3.0,17.916666666666668,22.0,10.025,6.0,15.55,18.0,4.5,1.0,21.0,0.0,1.0,0.4761904761904762,11.0,,,,,16.0,3.4,3.4,15.5,15.0,2.0,1.0,17.0,15.5,12.5,44.0,43.0,7.5,27.0,0.0,0.0,11.0,18.5,899.0,851.0,7.5,21.0,5.7,6.0,14.5,20.5,10.666666666666666,9.0,0.0,0.0,301.0,306.0,16.0,-5.0,16.5,13.0,477.0,499.0,12.5,22.0,0.5211558307533539,0.5384615384615384,19.0,19.0,1.264,27.0,16.0,3.4,3.2,9.0,13.0,16.0,8.5,15.5,0.4705882352941176,0.4848484848484849,25.0,22.5,0.5670731707317073,0.6337719298245614,19.0,27.0,2883.0,3179.0,13.0,21.0,88.0,675.0,709.0,7.0,6.0,92.0,9.0,7.5,0.05666666666666665,0.07641196013289038,8.0,18.0,,,,,969.0,988.0,18.5,16.0,68.0,0.0,0.0,14.5,8.5,42.0,22.5,3095.0,2861.0,13.0,11.0,67.0,10.5,17.0,0.0,0.0,10.5,18.5,225.0,426.0,23.0,25.0,,,,,30.0,20.5,75.2,74.7,12.0,15.0,3016.0,24.0,0.7911392405063291,2.0,0.4788441692466461,0.4615384615384616,10.0,10.0,0.5294117647058824,0.5151515151515151,4.0,6.5,0.4329268292682927,0.36622807017543857,10.0,2.0,464.0,456.0,18.0,9.5,18.0,17.0,21.5,4.5,2201.0,1837.0,20.0,4.0,16.550505050505052,22.0,0.0,0.0,14.5,14.5,0.0,1.0,28.0,5.5,6.2,17.0,9.5,133.0,217.0,20.0,3.0,33.0,17.0,8.5,24.0,29.0,12.0,24.5,17.0,20.0,8.5,23.5,26.0,0.0,0.0,14.5,14.5,28.0,21.5,2.0,9.5,8.0,14.574380165289256,16.0,,,,5084.0,5016.0,14.0,10.0,97.1,97.1,14.0,17.0,35.0,35.0,17.5,10.0,34.0,34.0,18.0,10.5,6.3,6.8,13.0,22.5,4.7,4.0,16.5,2.5,10.6,11.9,14.0,27.0,20.4,19.8,19.0,6.5,7.5,10.1,22.0,20.5,5.2,5.1,14.5,9.0,45.5,42.7,24.5,2.0,,,,,68.0,12.0,1.3404255319148934,1.7,18.0,27.0
1992.0,,,,,288.0,293.0,22.0,9.0,157.0,154.0,13.0,14.5,115.0,113.0,23.0,8.0,16.0,26.0,26.5,22.5,0.0,0.0,0.0,0.0,5.1,3.2,1.0,14.0,6487.0,11.0,6.2,4.1,1.0,12.5,45.0,,,,,,,,,,258.0,56.3,63.0,27.0,17.0,320.0,27.5,15.5,50.0,2.0,9.25,6.0,,,,,,,,,,,,,76.0,80.0,20.0,12.0,0.0,6.0,7.0,8.0,4.0,0.0,4.0,7.0,5.0,3.0,17.0,14.0,14.0,21.5,6.583333333333332,3.0,10.68125,7.0,12.55,12.0,8.8125,6.5,29.0,2.0,1.0,0.5862068965517241,22.0,,,,,15.0,3.3,5.5,1.0,10.0,6.0,1.0,28.0,1.0,7.5,45.0,50.0,12.5,19.5,0.0,0.0,12.0,17.0,874.0,925.0,11.0,20.0,5.8,5.0,2.5,15.5,10.833333333333336,8.0,0.0,1.0,374.0,249.0,7.0,125.0,4.0,4.0,458.0,508.0,22.5,19.0,0.5005025125628141,0.5606820461384152,8.0,23.0,1.3652173913043475,23.0,18.0,3.9,2.4,1.5,12.5,12.0,3.0,12.5,0.4864864864864865,0.5217391304347826,24.0,26.0,0.5856297203510921,0.6161683277962348,15.0,22.0,2869.0,2782.0,7.0,18.0,99.0,809.0,768.0,14.0,19.0,98.0,17.5,17.0,0.05555555555555555,0.08873720136518773,7.0,24.0,,,,,995.0,997.0,23.0,6.0,73.0,1.0,0.0,14.5,21.5,34.0,15.5,3288.0,3184.0,18.0,9.0,76.0,18.5,15.5,0.0,1.0,21.0,20.5,336.0,339.0,17.0,14.0,,,,,33.0,17.0,77.2,65.1,3.0,14.0,3162.0,17.0,0.732484076433121,6.0,0.4994974874371859,0.4393179538615848,21.0,6.0,0.5135135135135135,0.4782608695652174,5.0,3.0,0.41437027964890794,0.3838316722037653,14.0,7.0,497.0,438.0,14.0,5.0,19.0,11.0,12.0,4.5,2030.0,1733.0,14.0,7.0,12.363636363636365,5.0,0.0,0.0,14.5,14.5,1.0,0.0,40.0,8.0,9.1,9.0,16.0,293.0,342.0,7.0,17.0,51.0,3.5,14.0,25.0,25.0,8.5,20.5,19.0,20.0,15.0,15.5,32.0,0.0,0.0,14.5,14.5,42.0,2.0,10.0,3.5,12.5,10.674931129476585,8.0,,,,4899.0,4515.0,8.0,11.0,100.0,100.0,21.5,9.5,45.0,27.0,4.5,3.0,45.0,27.0,6.0,3.0,6.9,6.1,2.0,17.0,4.1,4.0,14.0,13.0,12.3,9.8,1.0,12.5,19.4,18.5,9.0,13.5,10.2,10.0,20.0,10.0,4.9,4.5,2.5,15.0,45.0,41.9,14.0,2.0,,,,,384.0,10.0,1.6829268292682928,1.525,25.0,17.0
1993.0,,,,,283.0,259.0,1.0,17.0,182.0,139.0,1.0,7.0,85.0,98.0,13.0,25.5,16.0,22.0,19.0,20.5,0.0,0.0,0.0,0.0,5.2,3.8,1.0,11.0,6359.0,19.0,5.9,4.8,1.0,14.0,28.0,,,,,,,,,,315.0,59.9,64.9,28.0,9.0,310.0,20.0,10.0,16.0,13.5,6.916666666666668,3.0,,,,,,,,,,,,,74.3,75.8,12.0,18.5,4.0,12.0,6.0,7.0,6.0,4.0,12.0,6.0,3.0,1.0,10.0,10.0,23.5,5.5,9.791666666666666,6.0,15.2375,18.0,11.35,13.0,19.125,21.0,15.0,0.0,1.0,0.6666666666666666,28.0,,,,,14.0,2.7,5.0,1.0,11.0,2.0,3.0,24.0,2.5,10.0,55.0,58.0,21.0,8.5,0.0,1.0,26.5,16.5,1086.0,1420.0,28.0,9.0,5.7,5.5,8.0,13.5,15.25,15.0,0.0,0.0,277.0,290.0,12.5,-13.0,17.0,20.0,526.0,478.0,7.0,12.0,0.5565476190476191,0.5575692963752665,14.0,13.0,2.1411764705882352,3.0,18.0,3.4,2.3,1.0,17.5,11.0,1.0,14.5,0.6923076923076923,0.44,28.0,8.0,0.6633499170812603,0.6513844757149342,15.0,9.0,3200.0,2870.0,6.0,14.0,109.0,806.0,768.0,16.0,21.0,97.0,15.0,22.0,0.05653710247349824,0.08494208494208494,8.0,20.0,,,,,1008.0,938.0,1.0,13.5,90.0,0.0,0.0,14.5,11.0,46.0,23.0,3862.0,3307.0,19.0,3.0,78.0,16.5,3.5,0.0,1.0,22.0,19.0,280.0,560.0,27.0,20.5,,,,,39.0,11.0,79.1,70.3,6.0,11.0,3381.0,17.0,0.46703296703296704,26.0,0.4434523809523809,0.4424307036247335,15.0,16.0,0.3076923076923077,0.56,1.0,21.0,0.3366500829187397,0.3486155242850658,14.0,20.0,447.0,415.0,7.0,17.0,8.0,14.0,22.0,22.0,1624.0,1536.0,6.0,21.0,18.707070707070702,24.0,0.0,0.0,14.5,14.5,2.0,0.0,35.0,6.2,8.6,3.0,10.5,181.0,276.0,9.0,5.0,45.0,7.5,12.0,35.0,33.0,17.0,8.0,26.0,25.0,17.0,12.0,24.0,0.0,0.0,14.5,14.5,34.0,9.5,10.0,5.5,5.0,13.162534435261707,12.0,,,,4824.0,4406.0,1.0,17.0,96.4,93.5,5.0,20.0,28.0,31.0,15.0,20.5,27.0,29.0,11.5,21.0,6.4,6.6,14.0,18.5,3.6,3.7,9.5,19.0,10.7,10.1,2.5,22.0,19.7,24.5,28.0,11.5,7.2,12.2,26.0,23.0,4.8,4.7,7.5,18.5,42.9,42.4,18.0,12.5,,,,,418.0,8.0,1.777777777777778,1.7837837837837835,9.0,10.0
1994.0,,,,,325.0,287.0,11.0,5.0,215.0,195.0,23.5,4.0,92.0,65.0,1.0,16.0,18.0,27.0,18.0,24.5,5.0,0.0,4.0,2.0,5.4,5.3,12.5,14.0,7686.0,4.0,6.0,6.0,13.0,15.5,36.0,,,,,,,,,,409.0,60.8,61.6,23.0,9.0,368.0,27.0,1.0,42.0,1.0,7.583333333333332,6.0,,,,,,,,,,,,,87.2,63.3,4.0,3.0,0.0,13.0,13.0,10.0,3.0,0.0,13.0,12.0,8.0,1.0,14.0,16.0,4.5,21.0,9.833333333333334,6.0,14.225,15.0,9.7,9.0,18.75,21.0,32.0,3.0,0.0,0.4375,10.0,,,,,20.0,3.0,3.0,17.5,10.0,4.0,1.0,18.0,11.0,23.0,60.0,83.0,27.0,20.5,0.0,1.0,20.5,20.0,1296.0,1843.0,27.0,18.0,6.1,5.8,8.5,11.0,10.916666666666664,8.5,0.0,0.0,356.0,314.0,13.0,42.0,8.0,7.0,673.0,597.0,26.0,2.0,0.6268922528940338,0.6406882591093117,1.0,2.0,2.3369565217391304,4.0,18.0,2.7,4.2,17.0,25.0,25.0,23.5,19.5,0.6206896551724138,0.7352941176470589,3.0,17.0,0.7393980848153214,0.7701391817798398,1.0,4.0,4324.0,3652.0,21.0,3.0,112.0,880.0,614.0,2.0,16.0,83.0,5.0,18.5,0.05538461538461538,0.0940766550522648,10.0,25.0,,,,,1123.0,988.0,7.0,2.0,77.0,0.0,0.0,14.5,12.5,44.0,23.0,3301.0,3483.0,19.0,14.0,86.0,21.0,15.5,0.0,1.0,21.0,20.5,238.0,410.0,20.0,25.0,,,,,39.0,15.5,77.6,82.1,17.5,15.0,4570.0,2.0,0.4279069767441861,25.0,0.37310774710596617,0.3593117408906883,28.0,27.0,0.3793103448275862,0.2647058823529411,26.0,12.0,0.26060191518467857,0.22986081822016025,28.0,25.0,419.0,355.0,1.0,19.0,11.0,9.0,6.0,18.0,1524.0,1090.0,1.0,20.0,13.434343434343436,12.5,0.0,0.0,14.5,14.5,0.0,0.0,31.0,4.4,5.7,15.0,8.0,246.0,250.0,11.0,19.0,36.0,11.5,14.0,39.0,30.0,18.5,1.5,34.0,19.0,7.0,1.5,34.0,0.0,0.0,14.5,14.5,34.0,7.0,0.0,13.5,21.5,10.391184573002755,5.0,,,,5848.0,4742.0,5.0,3.0,100.0,100.0,19.5,10.5,30.0,31.0,14.0,17.5,30.0,31.0,14.5,17.0,6.8,6.5,8.0,14.0,3.6,3.1,1.0,18.0,11.2,10.6,3.0,21.5,21.6,22.2,20.0,12.0,6.1,9.3,18.0,26.0,5.2,4.8,7.0,7.0,42.9,40.5,7.5,8.5,,,,,1106.0,2.0,1.8888888888888888,2.096774193548387,3.0,12.0
1995.0,,,,,342.0,312.0,17.0,7.0,223.0,212.0,27.5,5.0,91.0,75.0,3.0,20.5,28.0,25.0,20.0,7.0,2.0,0.0,1.0,7.0,6.1,5.4,16.0,10.0,8292.0,1.0,6.9,6.2,15.5,9.5,48.0,,,,,,,,,,402.0,62.6,59.5,19.0,5.0,369.0,28.0,2.0,24.0,11.0,16.25,16.0,,,,,,,,,,,,,72.2,74.3,10.0,23.0,1.0,9.0,10.0,12.0,4.0,1.0,8.0,7.0,9.0,1.0,13.0,15.0,11.5,15.5,12.0,10.0,11.525,7.0,5.8,4.0,17.25,19.0,29.0,2.0,2.0,0.4482758620689655,7.0,,,,,16.0,2.5,4.0,5.0,10.5,2.0,1.0,25.0,2.0,14.0,72.0,74.0,22.5,10.5,0.0,0.0,12.5,19.0,1612.0,1581.0,21.5,8.0,6.2,6.2,21.0,12.5,8.75,7.0,0.0,0.0,412.0,385.0,27.0,27.0,10.0,4.0,642.0,620.0,29.0,3.0,0.611659192825112,0.6535433070866141,1.0,8.0,2.4505494505494507,7.0,33.0,5.1,4.7,24.5,4.0,29.0,27.5,2.5,0.7674418604651163,0.725,6.0,7.0,0.7081508925564163,0.7561915244909191,2.0,10.0,4205.0,4122.0,28.0,5.0,105.0,797.0,707.0,6.0,13.0,100.0,11.5,16.0,0.08187134502923976,0.08012820512820512,14.0,9.0,,,,,1115.0,1016.0,11.0,2.0,72.0,0.0,0.0,15.5,11.0,41.0,26.0,2948.0,2870.0,13.0,18.0,68.0,13.0,17.0,1.0,1.0,25.5,5.5,414.0,446.0,27.0,7.0,,,,,35.0,12.5,90.2,80.1,15.0,7.0,4500.0,4.0,0.4080717488789238,24.0,0.38834080717488795,0.3464566929133859,30.0,23.0,0.2325581395348837,0.275,25.0,24.0,0.2918491074435837,0.2438084755090809,29.0,21.0,433.0,352.0,2.0,17.0,10.0,11.0,9.0,20.5,1733.0,1329.0,4.0,16.0,14.848484848484848,14.0,0.0,0.0,15.5,15.5,0.0,0.0,40.0,5.9,6.6,9.0,16.5,295.0,294.0,7.0,24.0,44.0,4.5,20.0,36.0,35.0,20.5,7.0,26.0,26.0,17.5,13.5,29.0,0.0,0.0,15.5,15.5,40.0,2.0,11.0,2.0,13.0,13.140495867768594,6.0,,,,5938.0,5451.0,20.0,4.0,100.0,90.6,1.0,9.5,44.0,32.0,10.0,6.0,44.0,29.0,6.5,6.0,7.0,7.1,23.0,11.5,4.0,3.8,10.5,12.0,11.2,12.0,23.5,23.0,22.4,21.4,14.5,8.5,11.8,10.9,24.0,2.0,5.3,5.4,24.0,10.5,40.9,42.2,16.5,22.0,,,,,487.0,8.0,1.75,1.868421052631579,7.0,15.0
1996.0,,,,,284.0,309.0,20.5,24.0,186.0,169.0,12.5,11.0,75.0,117.0,26.0,28.0,23.0,23.0,8.0,16.0,3.0,0.0,2.0,1.0,5.5,4.3,6.0,12.0,6827.0,24.0,6.3,5.1,5.5,12.0,33.0,,,,,,,,,,331.0,59.0,58.5,17.0,10.0,314.0,19.5,8.0,6.0,25.0,16.25,16.0,,,,,,,,,,,,,75.9,66.7,2.0,23.5,0.0,8.0,14.0,7.0,0.0,0.0,8.0,11.0,3.0,0.0,13.0,13.0,15.5,16.5,15.833333333333336,14.0,16.54375,22.0,9.65,9.5,23.4375,27.0,26.0,0.0,0.0,0.5,16.0,,,,,19.0,3.4,4.1,6.0,17.0,1.0,3.0,22.0,8.5,18.0,58.0,53.0,7.5,22.5,0.0,0.0,11.5,19.5,1075.0,1314.0,12.5,29.0,6.1,5.4,8.0,10.5,17.833333333333332,20.0,0.0,0.0,298.0,315.0,15.0,-17.0,17.5,23.0,561.0,537.0,17.5,8.0,0.5776699029126213,0.5658536585365853,11.0,11.0,2.48,3.0,24.0,4.3,3.4,9.5,11.0,18.0,10.5,8.5,0.7741935483870968,0.5454545454545454,24.0,4.0,0.7029208301306688,0.61352467072931,26.0,6.0,3658.0,3121.0,9.0,8.0,106.0,835.0,840.0,19.0,16.0,105.0,18.0,15.0,0.08098591549295775,0.0744336569579288,21.0,17.0,,,,,1030.0,1025.0,18.0,14.0,90.0,2.0,0.0,15.5,29.5,37.0,13.5,3698.0,3595.0,23.0,5.0,84.0,23.0,3.0,1.0,0.0,10.0,6.5,300.0,577.0,28.0,20.0,,,,,32.0,23.0,80.4,71.2,13.0,10.0,3899.0,9.0,0.4032258064516129,28.0,0.4223300970873787,0.4341463414634147,20.0,20.0,0.22580645161290325,0.4545454545454546,7.0,27.0,0.29707916986933125,0.38647532927069,5.0,25.0,435.0,445.0,16.0,20.0,7.0,15.0,23.0,28.0,1546.0,1966.0,24.0,24.0,23.292929292929287,30.0,0.0,0.0,15.5,15.5,0.0,2.0,34.0,5.7,7.4,7.5,11.5,241.0,263.0,9.0,16.5,43.0,6.0,11.5,29.0,30.0,15.5,18.0,22.0,20.0,7.0,20.5,32.0,0.0,0.0,15.5,15.5,35.0,8.5,3.0,12.0,18.5,18.7465564738292,24.0,,,,5204.0,5087.0,16.0,12.0,100.0,100.0,21.0,10.5,30.0,33.0,17.0,21.0,30.0,33.0,18.0,19.5,7.0,6.3,8.5,9.5,3.6,4.4,29.5,19.0,11.8,10.8,5.0,13.5,18.5,24.8,25.5,30.0,9.4,15.6,30.0,18.5,5.1,5.0,16.5,13.5,41.1,42.8,15.0,26.0,,,,,117.0,11.0,1.9444444444444444,1.4318181818181817,30.0,6.0
1997.0,,,,,293.0,325.0,28.0,16.0,177.0,195.0,28.5,9.0,96.0,104.0,19.5,17.0,20.0,26.0,21.0,24.0,8.0,0.0,6.0,1.0,5.4,6.4,29.0,13.0,7494.0,8.0,6.2,7.3,29.0,14.0,42.0,,,,,,,,,,319.0,59.1,62.0,28.0,6.5,336.0,29.0,7.5,12.0,20.5,25.0,28.0,,,,,,,,,,,,,70.4,76.7,15.0,24.0,0.0,12.0,5.0,9.0,1.0,0.0,11.0,3.0,5.0,0.0,6.0,15.0,8.0,1.0,18.666666666666668,24.5,10.0875,4.0,10.8,11.0,9.375,9.0,16.0,2.0,0.0,0.375,5.0,,,,,16.0,3.0,2.2,26.5,16.5,0.0,0.0,12.0,25.5,17.5,65.0,67.0,20.0,13.0,0.0,0.0,9.5,21.5,1414.0,1398.0,16.0,15.0,5.8,6.3,28.0,12.5,10.0,9.0,0.0,0.0,354.0,359.0,19.5,-5.0,16.0,11.0,540.0,542.0,19.5,12.5,0.5606653620352251,0.5700389105058365,11.0,18.0,1.84375,15.0,26.0,4.8,5.2,26.0,7.0,28.0,28.0,6.0,0.65,0.6829268292682927,7.0,12.0,0.6187896899514381,0.651310005275189,13.0,20.0,3313.0,3704.0,29.0,14.0,97.0,800.0,668.0,1.0,11.0,81.0,1.0,11.0,0.06825938566552901,0.08,13.0,25.0,,,,,1022.0,1028.0,17.0,16.0,81.0,0.0,0.0,15.5,9.0,49.0,24.0,3407.0,2933.0,3.0,20.0,70.0,6.0,18.5,0.0,1.0,23.0,20.5,444.0,566.0,27.0,14.0,,,,,34.0,23.0,82.3,92.2,30.0,9.0,3537.0,16.0,0.5423728813559322,16.0,0.4393346379647749,0.42996108949416345,20.0,13.0,0.35,0.3170731707317073,24.0,19.0,0.3812103100485619,0.348689994724811,18.0,11.0,449.0,442.0,13.0,15.0,14.0,13.0,17.5,13.0,2041.0,1983.0,23.0,6.0,15.141414141414142,15.0,0.0,0.0,15.5,15.5,0.0,0.0,33.0,5.8,7.5,15.0,7.0,224.0,253.0,19.0,9.0,44.0,11.0,9.5,27.0,30.0,15.0,21.5,19.0,23.0,13.0,25.5,22.0,0.0,0.0,15.5,15.5,27.0,17.5,5.0,10.0,8.5,16.856749311294767,19.0,,,,5354.0,5687.0,29.0,8.0,97.1,97.3,10.0,24.0,34.0,37.0,23.0,16.0,33.0,36.0,23.0,15.5,6.6,7.3,27.5,17.5,4.5,4.5,28.0,4.0,11.1,11.8,10.5,24.5,21.8,20.9,6.5,16.0,13.1,11.6,24.5,3.0,5.2,5.5,29.5,9.0,42.1,41.9,7.5,21.5,,,,,-333.0,21.0,1.4666666666666666,1.6222222222222222,22.0,27.0
1998.0,204.0,206.0,24.0,7.0,335.0,300.0,18.5,4.0,210.0,171.0,19.0,2.5,98.0,102.0,19.0,13.5,27.0,27.0,13.5,17.5,5.0,0.0,3.0,2.0,7.9,5.0,9.0,1.0,8152.0,2.0,8.6,5.7,6.5,1.5,64.0,161.0,157.0,5.5,5.199999999999998,4.0,32.9,27.7,3.0,7.0,327.0,61.4,57.7,18.5,3.0,320.0,25.0,3.0,32.0,4.0,12.5,11.0,,,,,,,,,,,,,100.0,89.5,29.0,1.0,1.0,11.0,9.0,12.0,2.0,1.0,11.0,9.0,12.0,2.0,4.0,15.0,6.0,1.0,11.916666666666664,7.0,6.675,3.0,4.1,2.5,9.25,7.5,10.0,2.0,0.0,0.4,8.0,6.353168044077135,2.0,2.8,1.0,16.0,3.0,3.4,13.5,13.0,3.0,1.0,19.0,12.0,15.5,54.0,73.0,26.0,27.0,1.0,4.0,30.0,9.5,1238.0,2008.0,30.0,23.0,7.8,5.8,15.0,1.0,2.9166666666666665,1.5,0.0,0.0,556.0,296.0,6.0,260.0,1.0,1.0,533.0,555.0,25.0,13.0,0.5535714285714286,0.5947843530591775,6.0,17.0,2.142857142857143,8.0,41.0,7.7,3.1,3.0,1.0,17.0,5.0,1.5,0.7068965517241379,0.5862068965517241,21.0,8.0,0.6909323116219668,0.6814054480852744,10.0,6.0,4328.0,3452.0,19.0,1.0,116.0,1045.0,1167.0,29.0,25.0,132.0,28.5,17.5,0.08059701492537312,0.09,16.0,21.0,5.9,5.6,22.0,2.0,1008.0,997.0,12.0,16.0,55.0,0.0,0.0,15.5,11.5,27.0,3.5,2458.0,3152.0,6.0,30.0,74.0,6.5,30.0,0.0,1.0,22.5,21.0,289.0,325.0,11.0,24.0,2.84,1.48,11.0,1.0,29.0,28.5,101.5,73.8,6.0,1.0,4492.0,2.0,0.4666666666666667,23.0,0.4464285714285714,0.4052156469408225,25.0,14.0,0.2931034482758621,0.4137931034482759,10.0,23.0,0.3090676883780332,0.31859455191472563,21.0,25.0,450.0,404.0,9.0,15.5,17.0,12.0,16.0,8.5,1936.0,1614.0,11.0,11.0,15.767676767676766,17.0,51.5,26.7,6.0,1.0,1.0,0.0,25.0,4.5,6.4,23.0,4.5,164.0,247.0,19.0,3.0,38.0,19.0,5.0,35.0,19.0,1.5,5.0,35.0,17.0,4.0,2.0,20.0,10.8,18.0,3.0,6.0,34.0,6.0,14.0,2.0,4.5,9.90633608815427,3.0,32844.0,32342.0,5.0,6264.0,5066.0,13.0,2.0,100.0,100.0,21.0,9.0,59.0,31.0,12.5,1.5,59.0,31.0,13.0,1.0,8.4,6.7,12.5,2.0,4.3,4.0,16.5,5.0,13.7,11.6,11.0,2.0,22.9,27.5,29.5,13.0,10.0,12.0,26.0,17.0,6.2,5.1,20.0,1.5,44.7,42.6,12.0,8.0,34.6,28.3,23.0,1.0,1198.0,2.0,1.9534883720930245,1.675,19.0,5.0
1999.0,186.0,185.0,2.5,27.5,324.0,320.0,27.0,6.0,192.0,213.0,31.0,9.0,96.0,83.0,12.0,16.0,36.0,24.0,15.5,2.0,3.0,0.0,0.0,2.0,6.4,5.9,26.0,5.0,7996.0,2.0,7.6,6.8,26.5,3.0,49.0,152.0,160.0,10.0,3.1000000000000014,5.0,31.6,28.5,3.0,17.0,316.0,59.6,61.6,29.0,7.0,373.0,31.0,14.0,8.0,26.5,21.33333333333333,23.0,,,,,,,,,,,,,63.3,69.0,5.0,29.0,0.0,8.0,11.0,9.0,2.0,0.0,6.0,9.0,4.0,0.0,19.0,18.0,4.5,29.0,18.58333333333333,23.0,12.3875,10.0,9.4,8.0,15.375,15.0,24.0,0.0,3.0,0.7916666666666666,30.5,15.09035812672176,17.0,15.2,15.0,21.0,4.0,2.0,29.0,28.0,1.0,3.0,12.0,27.5,25.0,70.0,69.0,20.0,8.0,2.0,0.0,11.0,2.0,1597.0,1423.0,14.0,6.0,7.0,6.1,22.5,3.0,8.916666666666666,6.5,0.0,0.0,399.0,335.0,18.0,64.0,9.0,5.0,530.0,606.0,31.0,19.5,0.5758793969849246,0.612206572769953,6.0,15.0,2.0,14.0,32.0,6.0,3.3,6.5,3.0,20.0,13.5,3.0,0.7111111111111111,0.6896551724137931,12.0,10.0,0.6885896771966166,0.7110952295872789,4.0,14.0,3989.0,3980.0,30.0,5.0,114.0,955.0,880.0,19.0,23.0,108.0,19.0,23.0,0.1111111111111111,0.075,20.0,3.5,5.5,6.0,30.0,10.5,995.0,1065.0,26.0,22.0,61.0,0.0,0.0,16.0,12.5,28.0,6.0,2769.0,2857.0,3.0,28.0,69.0,3.0,29.0,1.0,0.0,9.5,8.5,269.0,246.0,5.0,25.0,2.0,1.57,19.0,5.0,32.0,24.5,89.3,85.4,27.0,4.0,4318.0,4.0,0.5,18.0,0.42412060301507537,0.38779342723004695,26.0,17.0,0.2888888888888889,0.31034482758620685,20.0,22.0,0.31141032280338343,0.2889047704127211,28.0,18.0,422.0,413.0,10.5,20.0,13.0,9.0,11.0,12.0,1804.0,1617.0,14.0,14.0,14.595959595959597,11.0,34.4,31.4,22.0,7.0,1.0,1.0,43.0,7.5,7.1,13.0,20.5,329.0,272.0,11.5,26.0,46.0,7.0,20.0,30.0,42.0,30.0,19.0,19.0,29.0,26.5,26.5,40.0,18.8,15.1,13.0,30.0,30.0,17.5,-10.0,27.0,30.5,14.980716253443525,13.0,28272.0,29600.0,22.0,5793.0,5597.0,27.0,3.0,100.0,100.0,21.5,10.5,46.0,32.0,11.5,4.0,46.0,32.0,12.0,3.5,8.1,7.0,23.0,2.0,4.3,3.9,16.0,6.0,13.7,11.4,7.5,1.0,22.8,20.6,10.0,8.5,8.4,8.8,13.5,21.0,5.8,5.3,25.5,3.5,45.4,41.4,16.0,2.0,31.1,30.1,29.0,2.0,196.0,13.0,1.8837209302325584,1.794871794871795,12.5,9.0
2000.0,174.0,170.0,1.0,31.0,319.0,344.0,29.0,7.0,193.0,208.0,31.0,9.5,107.0,110.0,25.5,13.5,19.0,26.0,20.5,25.0,2.0,0.0,2.0,0.0,6.9,6.5,29.5,5.0,7854.0,3.0,7.8,7.2,27.5,4.0,47.0,163.0,173.0,6.0,0.8999999999999986,13.0,30.9,30.0,7.0,20.0,307.0,62.0,63.2,27.5,5.0,369.0,31.0,18.0,0.0,29.5,27.25,30.0,115.05,103.63,-143.48,31.0,5.0,26.85,-8.75,26.0,1.0,-127.1,31.0,3.0,95.7,86.2,26.0,1.0,1.0,5.0,9.0,7.0,1.0,1.0,5.0,9.0,7.0,0.0,10.0,10.0,23.0,6.5,26.125,30.0,9.2,5.0,8.65,6.0,9.75,5.0,26.0,0.0,0.0,0.38461538461538464,2.0,16.526308539944903,19.0,17.7,21.0,18.0,3.6,1.4,31.0,19.0,0.0,1.0,8.0,31.0,19.0,67.0,69.0,17.5,15.0,0.0,1.0,24.5,22.5,1456.0,1519.0,17.5,14.5,7.2,6.4,25.0,2.5,5.666666666666668,5.0,0.0,1.0,397.0,371.0,24.0,26.0,15.0,5.0,495.0,584.0,28.0,23.0,0.5532359081419624,0.6083086053412463,6.0,20.0,1.8037383177570088,16.0,33.0,6.7,3.9,14.5,1.0,23.0,19.5,2.5,0.7021276595744681,0.575,21.0,5.5,0.6428451602080187,0.6863708121382214,7.0,17.0,3832.0,3913.0,28.0,7.0,106.0,908.0,747.0,7.5,20.0,104.0,18.0,19.5,0.059561128526645774,0.0755813953488372,22.0,25.0,5.6,6.1,30.0,10.5,958.0,1011.0,15.0,25.0,62.0,0.0,0.0,16.0,10.0,32.0,12.0,2773.0,2594.0,4.0,27.0,65.0,4.5,29.5,0.0,0.0,10.5,22.5,261.0,310.0,12.0,27.0,2.27,2.09,27.5,2.5,26.0,29.5,94.7,91.6,31.0,3.5,4019.0,7.0,0.5544041450777202,16.0,0.4467640918580376,0.3916913946587537,26.0,12.0,0.2978723404255319,0.425,11.0,26.5,0.3571548397919813,0.3136291878617786,25.0,15.0,428.0,396.0,8.0,17.0,14.0,17.0,25.5,14.0,2129.0,1788.0,15.0,6.0,12.404040404040403,6.0,39.7,38.2,26.0,3.0,0.0,0.0,35.0,6.6,5.0,28.0,14.0,187.0,214.0,23.0,7.0,31.0,23.5,14.0,23.0,29.0,11.0,27.5,22.0,25.0,16.0,21.0,28.0,14.9,9.4,31.0,18.5,18.0,31.0,-10.0,26.5,13.5,15.352617079889807,16.0,28362.0,29410.0,19.0,5961.0,5701.0,28.0,5.0,100.0,100.0,19.5,12.5,45.0,38.0,20.5,5.5,45.0,38.0,20.5,5.0,8.1,7.1,23.5,2.0,5.0,4.5,26.5,1.0,13.1,11.2,12.0,2.0,21.7,22.0,19.0,16.0,10.0,9.7,17.5,14.0,6.2,5.6,27.0,2.0,44.7,39.9,2.5,5.0,34.1,33.5,30.0,3.0,260.0,15.0,1.62,1.5777777777777775,21.5,20.0
2001.0,182.0,177.0,2.0,27.0,288.0,312.0,28.0,17.5,179.0,166.0,14.0,13.5,88.0,127.0,31.0,20.0,21.0,19.0,8.5,22.0,5.0,0.0,3.0,0.0,5.0,6.5,28.5,19.0,7443.0,9.0,5.9,7.4,27.0,17.5,35.0,154.0,167.0,13.5,-1.8000000000000007,23.0,29.2,31.0,17.0,28.0,335.0,60.4,60.9,26.0,10.5,291.0,9.0,6.0,12.0,24.0,28.25,30.0,-33.93,-19.57,-83.74,27.0,20.0,-2.92,11.52,23.0,5.0,-63.95,27.0,12.0,83.3,86.8,30.0,8.0,0.0,7.0,4.0,7.0,0.0,0.0,7.0,2.0,6.0,0.0,16.0,10.0,25.0,28.0,24.91666666666667,31.0,16.93125,22.0,11.8,9.0,22.0625,26.5,35.0,1.0,2.0,0.4571428571428571,17.0,23.663360881542697,29.0,26.2,29.0,23.0,4.1,1.7,31.0,25.5,1.0,2.0,8.0,31.0,27.5,77.0,59.0,8.5,5.0,0.0,1.0,26.5,20.0,1647.0,1266.0,9.5,7.0,5.9,6.6,27.0,14.0,17.666666666666668,18.0,0.0,0.0,290.0,390.0,26.0,-100.0,28.0,24.0,555.0,478.0,5.0,10.0,0.6155419222903885,0.515736040609137,28.0,4.0,2.034090909090909,11.0,23.0,4.1,3.3,11.5,12.0,16.0,8.5,9.5,0.696969696969697,0.4324324324324325,31.0,5.0,0.6896817743490838,0.5942463819272855,29.0,7.0,3576.0,3367.0,18.0,7.0,109.0,836.0,874.0,26.0,21.0,92.0,12.0,27.0,0.07291666666666667,0.0608974358974359,25.0,22.0,5.5,5.8,28.0,13.0,978.0,985.0,10.5,21.0,72.0,0.0,0.0,16.0,12.0,34.0,11.0,3029.0,2902.0,4.0,25.0,72.0,6.0,26.0,0.0,0.0,10.0,21.5,307.0,350.0,15.0,22.0,1.52,2.02,28.0,16.5,45.0,4.5,77.9,88.1,25.0,15.0,3854.0,8.0,0.4916201117318436,21.0,0.3844580777096115,0.484263959390863,4.0,28.0,0.303030303030303,0.5675675675675675,1.0,27.0,0.31031822565091616,0.4057536180727145,3.0,25.0,376.0,477.0,24.0,28.0,10.0,21.0,31.0,21.0,1609.0,2299.0,30.0,25.0,16.242424242424242,16.0,26.4,39.5,30.0,23.0,0.0,0.0,47.0,7.8,5.9,23.5,23.0,278.0,204.0,24.5,21.0,30.0,27.0,24.5,18.0,38.0,30.0,31.0,15.0,33.0,31.0,31.0,39.0,20.3,9.0,31.0,30.0,18.0,31.0,-21.0,31.0,30.0,21.1267217630854,28.0,28028.0,29559.0,23.0,5185.0,5666.0,27.0,12.0,96.7,100.0,22.5,24.0,30.0,39.0,24.0,20.5,29.0,39.0,24.0,21.0,6.9,7.5,26.0,12.5,4.3,4.8,30.5,8.5,11.5,12.3,24.0,16.0,21.4,21.5,15.5,16.0,6.8,10.3,20.0,30.0,5.3,5.8,30.0,7.0,42.1,40.3,2.0,15.0,28.4,31.8,30.0,7.0,-481.0,26.0,1.604651162790698,1.5625,26.0,19.5
2002.0,191.0,187.0,14.0,12.5,350.0,315.0,21.0,4.0,191.0,198.0,29.0,10.0,139.0,83.0,4.5,3.5,20.0,34.0,29.5,27.5,1.0,0.0,1.0,2.0,5.0,7.1,31.0,22.0,8481.0,1.0,5.9,7.8,31.0,21.5,46.0,160.0,148.0,12.0,0.1999999999999993,16.0,31.3,31.1,14.0,16.5,337.0,60.4,61.8,23.5,17.0,335.0,20.0,15.0,8.0,23.0,25.58333333333333,29.0,65.12,11.14,-135.76,32.0,21.0,68.92,35.16,8.0,1.0,-87.24,30.0,5.0,79.3,75.0,14.5,13.5,1.0,11.0,6.0,10.0,1.0,1.0,11.0,6.0,4.0,1.0,18.0,7.0,30.5,29.0,24.91666666666667,31.0,10.65625,5.0,15.5,19.0,5.8125,4.0,40.0,0.0,2.0,0.45,9.0,17.632920110192835,19.0,18.0,19.0,23.0,4.1,3.0,17.0,29.0,1.0,2.0,16.0,19.0,30.0,86.0,76.0,26.0,1.0,0.0,2.0,30.5,23.0,1775.0,1749.0,27.0,5.0,6.1,7.2,32.0,11.0,9.583333333333334,5.0,0.0,1.0,390.0,442.0,30.0,-52.0,24.0,8.5,558.0,542.0,17.0,13.0,0.562037037037037,0.5908618899273105,9.0,18.0,1.3741007194244603,27.0,19.0,3.4,6.1,31.0,24.0,33.0,32.0,21.5,0.4222222222222222,0.6875,4.5,32.0,0.5951227390180879,0.7112151152712776,4.0,29.0,3685.0,4103.0,29.0,9.0,137.0,1139.0,824.0,11.0,32.0,100.0,13.5,32.0,0.057142857142857134,0.10793650793650794,4.0,29.0,5.8,5.3,6.0,9.5,1080.0,963.0,3.0,3.0,63.0,1.0,0.0,16.5,21.5,21.0,2.5,2514.0,2541.0,5.0,29.0,65.0,5.5,28.5,0.0,0.0,10.5,24.5,283.0,131.0,2.0,23.0,2.01,2.13,30.0,7.0,28.0,29.0,76.1,94.6,31.0,24.0,3951.0,9.0,0.7277486910994765,6.0,0.437962962962963,0.4091381100726895,24.0,15.0,0.5777777777777777,0.3125,28.5,1.0,0.4048772609819121,0.28878488472872244,29.0,4.0,473.0,394.0,6.5,8.0,26.0,15.0,18.0,1.5,2507.0,1666.0,10.0,1.0,16.419191919191913,13.0,35.6,36.9,29.0,11.0,1.0,0.0,49.0,8.1,4.7,30.0,27.5,266.0,197.0,25.0,23.0,27.0,29.0,29.0,29.0,28.0,11.5,17.5,23.0,21.0,11.5,18.0,41.0,19.9,12.3,26.5,31.0,23.0,27.5,-18.0,31.0,31.0,17.265840220385673,19.0,30560.0,27676.0,7.0,6192.0,5769.0,26.0,2.0,93.2,97.8,13.0,32.0,44.0,46.0,28.5,3.5,41.0,45.0,29.0,8.0,7.1,7.9,32.0,10.0,5.3,4.2,17.0,1.0,11.7,12.8,32.0,9.0,20.6,23.0,29.0,23.0,10.1,6.2,6.5,14.0,5.7,6.0,32.0,4.0,39.9,39.1,4.5,26.0,32.3,30.7,27.0,6.0,423.0,12.0,1.339622641509434,1.880952380952381,1.0,31.0
2003.0,183.0,178.0,3.5,27.0,336.0,316.0,23.5,4.0,194.0,186.0,31.0,5.0,124.0,94.0,15.0,3.0,18.0,36.0,32.0,29.0,2.0,0.0,2.0,1.0,7.1,4.5,7.5,3.0,8180.0,1.0,8.1,5.3,7.5,2.0,51.0,172.0,146.0,2.0,-2.8999999999999986,27.0,29.9,32.8,27.0,28.0,333.0,64.0,58.6,12.0,3.0,311.0,20.5,6.0,28.0,5.0,21.58333333333333,25.0,91.52,91.9,-11.37,17.0,4.0,7.86,0.53,23.0,8.0,8.5,21.0,3.0,72.0,80.8,19.0,25.0,0.0,7.0,8.0,7.0,3.0,0.0,7.0,6.0,4.0,1.0,11.0,7.0,30.0,15.0,15.458333333333336,14.0,5.75625,1.0,3.7,3.0,7.8125,5.0,31.0,0.0,2.0,0.3548387096774194,5.0,12.889256198347105,10.0,10.2,8.0,13.0,2.5,5.3,1.0,7.0,4.0,1.0,28.0,2.0,6.5,71.0,75.0,24.0,10.5,0.0,0.0,11.5,22.0,1428.0,1608.0,24.0,18.5,7.0,6.1,22.0,4.0,4.583333333333333,2.0,0.0,0.0,416.0,353.0,23.0,63.0,11.0,6.0,520.0,531.0,25.5,15.5,0.5327014218009478,0.5947643979057592,4.0,21.0,1.564516129032258,17.0,32.0,6.2,3.2,7.0,2.0,17.0,7.0,1.5,0.6808510638297872,0.4358974358974359,32.0,11.0,0.6277407054337464,0.6491784914115011,10.0,16.0,3951.0,3477.0,26.0,4.0,127.0,1029.0,720.0,3.5,28.0,90.0,5.0,30.5,0.05357142857142857,0.1139240506329114,2.0,31.0,5.9,5.5,19.0,3.0,1055.0,955.0,5.0,2.0,64.0,1.0,0.0,16.5,22.5,29.0,4.0,2501.0,2579.0,2.0,32.0,64.0,1.0,30.5,0.0,0.0,9.5,22.5,247.0,310.0,12.0,27.0,2.09,1.89,26.5,4.5,36.0,19.0,99.0,68.8,4.0,2.5,4169.0,3.0,0.6391752577319587,16.0,0.4672985781990522,0.4052356020942408,29.0,12.0,0.3191489361702128,0.5641025641025641,1.0,22.0,0.3722592945662536,0.3508215085884989,23.0,17.0,493.0,387.0,3.0,7.0,15.0,22.0,32.0,12.5,2343.0,1879.0,17.0,4.0,22.232323232323235,31.0,35.5,33.7,25.0,8.0,2.0,0.0,42.0,7.5,6.5,15.0,23.5,218.0,245.0,10.0,17.0,37.0,12.0,22.0,25.0,26.0,9.0,26.0,18.0,21.0,11.0,27.0,24.0,13.1,19.1,3.0,12.0,35.0,7.0,11.0,5.0,8.0,15.578512396694212,15.0,31476.0,25988.0,3.0,6294.0,5356.0,23.0,1.0,100.0,100.0,23.0,8.5,48.0,36.0,20.0,3.5,48.0,36.0,21.0,3.5,8.0,7.0,23.5,1.5,4.8,4.9,31.0,4.5,12.5,12.0,27.0,2.0,20.1,21.4,17.5,26.0,6.9,10.7,22.0,27.0,6.0,5.6,28.5,1.0,39.1,40.3,10.0,27.0,34.3,30.0,28.0,1.0,938.0,5.0,1.6666666666666667,1.4285714285714284,27.0,14.5
2004.0,167.0,166.0,1.0,32.0,351.0,350.0,31.0,4.5,225.0,220.0,32.0,4.0,98.0,110.0,24.0,14.5,28.0,20.0,3.5,15.0,4.0,0.0,3.0,1.0,8.0,6.9,28.0,2.0,8335.0,4.0,9.0,7.8,28.5,2.0,50.0,174.0,175.0,3.5,-4.5,30.0,27.3,31.8,24.0,31.0,380.0,68.8,62.1,26.0,1.0,338.0,28.0,2.0,12.0,23.0,27.83333333333333,31.0,190.81,219.52,-122.99,31.0,2.0,-11.07,-21.34,31.0,9.0,-126.1,32.0,2.0,81.8,88.9,28.5,15.5,1.0,8.0,7.0,6.0,0.0,1.0,8.0,5.0,4.0,0.0,9.0,11.0,20.0,6.0,22.5,28.0,10.43125,7.0,2.8,2.0,18.0625,18.0,20.0,1.0,0.0,0.45,11.0,17.454545454545453,18.0,17.5,18.5,12.0,2.2,2.0,28.0,5.0,1.0,0.0,11.0,28.0,7.0,73.0,75.0,24.0,11.0,0.0,1.0,24.0,22.0,1448.0,1869.0,29.0,20.0,7.6,6.7,28.0,2.0,4.0,2.0,0.0,0.0,405.0,395.0,26.0,10.0,13.0,6.0,552.0,544.0,27.0,8.0,0.6071065989847716,0.5726915520628684,8.0,5.0,2.295918367346939,7.0,39.0,7.1,5.5,25.0,2.0,30.0,27.5,2.0,0.8297872340425532,0.6666666666666666,14.5,2.0,0.7124152074459694,0.6601152151812945,14.0,4.0,4516.0,3896.0,29.0,2.0,117.0,884.0,974.0,24.0,13.0,110.0,15.0,21.0,0.07977207977207977,0.057142857142857134,32.0,24.0,6.0,6.3,32.0,2.5,985.0,1018.0,22.0,22.0,57.0,0.0,0.0,16.5,12.0,26.0,3.0,2240.0,2490.0,2.0,31.0,59.0,2.0,29.0,1.0,0.0,12.0,6.0,275.0,169.0,3.0,20.0,2.29,2.33,32.0,4.0,31.0,25.0,109.8,95.5,28.0,2.0,4754.0,1.0,0.4355555555555555,26.0,0.3928934010152284,0.4273084479371316,25.0,28.0,0.17021276595744686,0.33333333333333337,18.5,31.0,0.2875847925540306,0.33988478481870554,19.0,29.0,387.0,435.0,13.0,28.0,8.0,15.0,21.5,29.0,1823.0,2006.0,21.0,18.0,21.388888888888886,30.0,38.9,41.6,32.0,5.0,0.0,1.0,46.0,7.7,6.7,18.0,22.0,238.0,234.0,15.0,17.0,39.0,12.5,25.0,22.0,27.0,14.5,31.5,18.0,24.0,21.5,27.0,21.0,12.0,13.3,20.0,9.0,22.0,25.5,1.0,18.5,5.5,17.40909090909091,19.0,29058.0,29050.0,15.0,6339.0,5902.0,28.0,4.0,100.0,100.0,21.5,12.0,45.0,43.0,25.0,6.5,45.0,43.0,25.0,6.5,8.6,7.6,28.0,2.0,4.7,4.6,28.5,2.0,12.5,12.2,25.5,6.5,19.8,24.9,31.0,29.0,8.9,6.5,5.5,14.5,6.4,5.8,29.5,2.0,39.3,42.2,20.5,31.0,37.6,35.3,32.0,1.0,437.0,11.0,1.8297872340425527,1.6521739130434785,20.0,10.0
2005.0,190.0,189.0,19.0,14.5,285.0,304.0,21.0,20.0,169.0,177.0,19.0,17.0,83.0,96.0,20.0,20.5,33.0,31.0,22.0,9.5,1.0,0.0,1.0,1.0,4.9,4.8,8.5,20.5,6825.0,23.0,6.1,5.5,7.0,17.0,33.0,145.0,158.0,28.0,-1.7999999999999972,22.5,31.6,33.4,28.5,11.5,323.0,63.3,59.8,20.0,6.0,319.0,22.0,11.0,18.0,13.0,17.083333333333332,18.0,-86.09,-7.19,-32.59,20.0,19.0,-63.2,34.61,19.0,27.0,19.54,18.0,19.0,73.5,84.8,23.0,28.0,0.0,11.0,8.0,10.0,5.0,0.0,11.0,3.0,8.0,3.0,14.0,11.0,19.5,23.0,15.75,13.0,19.8875,23.0,16.15,20.0,23.625,25.0,25.0,0.0,0.0,0.56,25.0,19.825482093663915,22.0,21.1,21.0,16.0,3.1,4.5,2.5,17.5,3.0,0.0,24.0,2.5,19.0,71.0,67.0,20.0,11.0,1.0,0.0,11.5,6.5,1549.0,1416.0,16.5,14.0,5.6,5.9,19.0,21.0,20.666666666666668,22.0,0.0,0.0,306.0,344.0,19.5,-38.0,19.0,19.0,510.0,533.0,22.0,16.0,0.5968253968253968,0.5510204081632653,19.0,7.0,2.036144578313253,9.0,18.0,3.5,4.3,22.0,18.5,23.0,24.5,21.0,0.6428571428571429,0.6216216216216216,14.0,12.0,0.6819856926078474,0.6441136671177267,16.0,9.0,3146.0,3332.0,22.0,20.0,128.0,1013.0,990.0,24.0,23.0,137.0,30.0,23.0,0.11578947368421053,0.10197368421052633,14.0,8.0,5.2,5.6,20.0,28.5,945.0,1029.0,23.5,27.0,81.0,0.0,0.0,16.5,12.0,45.0,25.0,3505.0,3010.0,9.0,10.0,72.0,10.0,12.0,1.0,0.0,12.5,5.0,344.0,495.0,31.0,14.0,1.43,1.81,23.0,22.0,41.0,14.5,81.7,75.2,10.0,14.0,3449.0,18.0,0.4911242603550296,24.0,0.4031746031746032,0.4489795918367348,14.0,26.0,0.3571428571428571,0.3783783783783784,19.0,21.0,0.31801430739215264,0.3558863328822733,17.0,24.0,381.0,462.0,21.0,28.0,10.0,14.0,18.5,23.0,1467.0,1841.0,19.0,27.0,17.686868686868692,22.0,27.9,34.4,25.0,21.0,0.0,1.0,54.0,9.6,6.0,23.5,29.0,303.0,207.0,20.0,28.0,34.0,22.0,31.0,34.0,33.0,24.0,6.0,25.0,28.0,24.0,13.0,30.0,14.2,15.9,8.0,20.0,35.0,5.0,5.0,12.0,21.5,18.550964187327825,21.0,27550.0,29862.0,25.0,4613.0,5173.0,21.0,25.0,100.0,100.0,22.5,10.0,31.0,34.0,14.5,20.5,31.0,34.0,16.5,19.0,6.8,6.6,11.0,15.0,3.9,4.0,17.0,17.5,10.7,11.1,10.5,23.5,21.8,21.1,9.0,19.0,8.4,11.0,31.0,14.5,4.9,5.0,14.0,22.0,43.3,41.8,14.0,11.0,24.3,27.3,18.5,25.0,-560.0,27.0,1.7435897435897436,1.65,20.0,12.0
2006.0,197.0,192.0,26.0,4.0,272.0,272.0,10.0,26.0,160.0,192.0,31.0,20.0,87.0,53.0,1.0,24.0,25.0,27.0,22.5,13.0,3.0,0.0,0.0,0.0,4.3,5.0,9.5,28.0,7120.0,20.0,5.1,5.6,7.0,27.5,32.0,155.0,143.0,16.0,-1.4000000000000021,21.0,29.9,31.3,23.5,21.0,332.0,61.5,59.3,15.5,13.0,355.0,32.0,7.0,36.0,2.0,9.083333333333334,6.0,-127.19,-80.73,14.75,12.0,29.0,-35.81,78.46,2.0,21.0,104.77,3.0,29.0,84.0,85.0,22.0,13.0,2.0,7.0,8.0,6.0,2.0,2.0,7.0,8.0,4.0,0.0,12.0,15.0,6.0,17.5,10.75,7.0,18.9,24.0,19.8,25.0,18.0,21.0,31.0,3.0,2.0,0.3870967741935484,6.0,15.802341597796145,15.0,14.5,15.0,20.0,3.7,3.5,12.5,23.5,3.0,4.0,21.0,5.0,25.0,66.0,59.0,10.5,13.0,0.0,1.0,28.0,20.0,1492.0,1369.0,12.0,14.0,5.4,6.1,18.5,25.5,23.16666666666667,28.0,0.0,0.0,282.0,327.0,14.0,-45.0,22.0,26.0,540.0,599.0,32.0,9.0,0.5687804878048779,0.6438075742067554,1.0,11.0,1.839080459770115,14.0,13.0,2.4,2.5,4.0,31.0,15.0,4.0,30.5,0.52,0.625,12.0,27.0,0.6318025490592758,0.7949198417655632,1.0,19.0,3123.0,3818.0,31.5,18.0,123.0,903.0,899.0,28.0,24.0,112.0,30.0,32.0,0.09191176470588236,0.09926470588235294,6.0,10.0,5.3,5.3,8.0,25.0,1025.0,977.0,8.0,9.0,94.0,0.0,0.0,16.5,11.5,50.0,29.5,3961.0,3587.0,22.0,4.0,79.0,18.0,2.0,1.0,1.0,25.0,7.0,374.0,485.0,29.0,10.0,1.24,1.41,5.0,29.0,38.0,14.0,72.2,73.1,5.0,26.0,3402.0,17.0,0.54375,19.0,0.431219512195122,0.3561924257932446,32.0,22.0,0.48,0.375,21.0,6.0,0.3681974509407242,0.2050801582344368,32.0,14.0,442.0,348.0,1.0,17.0,12.0,9.0,5.0,19.5,1820.0,985.0,1.0,16.0,19.71717171717172,25.0,23.9,30.2,14.0,29.0,0.0,1.0,43.0,7.4,4.8,29.5,21.0,279.0,197.0,24.0,23.0,30.0,25.5,23.5,25.0,40.0,31.0,28.5,21.0,34.0,31.5,24.5,32.0,15.7,16.7,6.5,24.0,36.0,3.0,4.0,10.5,24.0,17.104683195592287,18.0,30535.0,27456.0,4.0,4943.0,4803.0,8.0,23.0,96.4,100.0,20.5,29.0,28.0,31.0,7.5,26.5,27.0,31.0,7.5,27.0,6.3,6.7,13.5,25.5,4.1,2.8,1.0,14.5,10.2,11.3,14.5,29.5,22.6,23.2,23.0,17.0,9.8,9.7,23.0,9.0,4.8,4.9,8.0,26.0,42.1,45.4,31.5,24.5,25.1,25.0,7.0,27.0,140.0,15.0,1.5365853658536586,2.3928571428571432,1.0,21.0
2007.0,190.0,192.0,23.0,12.5,294.0,305.0,20.5,19.0,139.0,222.0,32.0,31.0,131.0,67.0,1.0,1.0,24.0,16.0,10.0,9.5,3.0,0.0,3.0,0.0,5.0,5.8,20.5,19.0,7369.0,15.0,5.9,6.6,21.0,19.5,43.0,149.0,154.0,24.0,-1.6999999999999993,21.0,27.7,29.4,8.0,31.5,249.0,57.6,64.2,28.0,25.5,415.0,31.0,32.0,50.0,1.0,13.666666666666664,14.0,-3.74,-18.07,-44.57,19.0,21.0,20.5,103.43,1.0,2.0,75.52,5.0,16.0,83.3,87.5,25.0,19.0,0.0,3.0,6.0,11.0,4.0,0.0,3.0,6.0,10.0,1.0,16.0,16.0,6.5,26.0,11.666666666666664,5.0,13.375,13.0,22.0,28.0,4.75,1.0,27.0,2.0,0.0,0.5925925925925926,28.0,16.181267217630857,14.0,17.2,15.0,14.0,3.2,2.3,27.5,15.5,6.0,0.0,15.0,21.0,8.0,59.0,65.0,15.5,23.0,1.0,0.0,7.0,11.5,1461.0,1441.0,17.0,17.0,5.8,6.2,18.0,19.5,14.583333333333336,15.0,0.0,2.0,365.0,311.0,12.0,54.0,10.0,15.0,432.0,646.0,32.0,32.0,0.48755186721991706,0.6434619002822202,1.0,31.0,1.0610687022900764,32.0,12.0,2.8,3.4,6.5,28.0,22.0,16.0,30.0,0.35294117647058826,0.7586206896551724,6.0,31.0,0.5103179029559398,0.7809611829944547,1.0,32.0,2745.0,4225.0,32.0,28.0,86.0,662.0,763.0,24.0,13.0,110.0,28.0,13.0,0.08163265306122447,0.052459016393442616,24.0,9.0,5.2,5.7,21.5,30.5,964.0,1063.0,29.0,30.0,81.0,0.0,0.0,16.5,11.5,43.0,28.0,3621.0,3780.0,30.0,8.0,82.0,25.5,8.5,0.0,1.0,24.0,22.5,242.0,440.0,30.0,22.0,1.57,1.49,8.0,20.0,29.0,24.0,74.2,86.3,23.0,21.0,2938.0,29.0,0.9424460431654677,1.0,0.5124481327800829,0.35653809971777983,32.0,2.0,0.6470588235294117,0.2413793103448276,27.0,2.0,0.4896820970440602,0.21903881700554528,32.0,1.0,494.0,379.0,4.0,6.0,22.0,7.0,4.0,1.0,2634.0,1185.0,1.0,1.0,17.92929292929293,20.0,28.4,29.7,13.0,22.0,1.0,2.0,38.0,8.1,5.6,22.5,26.0,193.0,275.0,5.0,14.0,38.0,8.0,20.0,24.0,32.0,18.0,28.0,20.0,28.0,23.0,29.0,30.0,15.3,16.1,10.0,19.5,31.0,9.5,1.0,14.0,20.0,15.162534435261712,15.0,28310.0,29568.0,23.0,5379.0,5410.0,20.0,13.0,97.5,100.0,21.5,26.0,40.0,31.0,7.0,13.5,39.0,31.0,8.0,14.0,6.8,7.0,17.5,17.5,5.3,3.1,2.0,1.0,11.8,10.8,10.0,7.5,24.8,22.2,12.0,5.0,8.3,10.2,24.0,21.0,5.6,5.1,14.5,6.5,44.7,46.1,30.0,8.0,28.2,28.0,18.0,13.5,-31.0,18.0,1.2830188679245282,2.2580645161290316,2.0,31.0
2008.0,190.0,191.0,25.0,7.5,292.0,255.0,4.0,18.0,150.0,163.0,8.5,24.0,119.0,72.0,2.0,5.0,23.0,20.0,19.5,9.0,1.0,0.0,0.0,1.0,5.3,5.6,14.0,20.5,7262.0,18.0,6.4,6.6,18.0,18.0,41.0,158.0,144.0,19.0,-2.7,24.0,29.3,32.0,26.5,23.0,267.0,59.1,61.1,17.0,23.5,324.0,21.0,25.0,24.0,11.0,8.833333333333334,5.0,-36.35,0.43,-17.9,12.0,21.0,-25.28,88.01,2.0,18.0,79.68,5.0,22.0,85.3,72.2,3.0,16.0,0.0,10.0,9.0,9.0,6.0,0.0,10.0,7.0,6.0,6.0,14.0,13.0,8.5,29.0,12.0,7.0,14.7,17.0,18.9,23.0,10.5,8.5,31.0,2.0,3.0,0.4516129032258064,18.0,15.211570247933883,17.0,16.2,17.5,17.0,3.8,2.3,24.0,30.0,0.0,2.0,12.0,23.5,23.0,61.0,78.0,30.0,20.5,0.0,0.0,11.0,22.5,1369.0,1830.0,30.0,25.0,6.0,6.0,13.0,18.0,16.5,17.0,1.0,2.0,379.0,333.0,13.0,46.0,13.0,12.0,452.0,530.0,22.0,28.0,0.4881656804733728,0.6078224101479915,2.0,28.0,1.2605042016806722,30.0,22.0,4.9,2.8,4.5,5.5,15.0,5.0,11.5,0.5945945945945946,0.6,15.5,15.0,0.5590015128593041,0.7371233169480659,1.0,29.0,2956.0,3449.0,18.0,25.0,90.0,692.0,1002.0,32.0,16.0,109.0,28.5,17.0,0.07876712328767123,0.0784313725490196,11.0,9.0,5.5,5.1,2.5,20.5,1014.0,946.0,8.0,11.0,74.0,1.0,0.0,16.5,26.5,42.0,27.0,3521.0,3480.0,24.0,10.0,80.0,24.5,17.5,1.0,4.0,32.0,7.5,273.0,624.0,32.0,20.0,1.82,1.4,5.0,16.0,34.0,15.5,81.5,82.5,16.0,18.0,3217.0,26.0,0.7933333333333333,3.0,0.5118343195266273,0.3921775898520085,31.0,5.0,0.4054054054054054,0.4,17.5,18.0,0.4409984871406959,0.2628766830519341,32.0,4.0,519.0,371.0,2.0,3.0,15.0,10.0,6.5,15.5,2332.0,1230.0,1.0,5.0,18.37373737373737,23.5,34.7,27.7,5.0,14.0,3.0,1.0,43.0,8.7,7.8,4.0,28.0,261.0,304.0,4.0,22.0,45.0,4.0,26.0,34.0,36.0,25.5,11.0,29.0,26.0,19.5,10.0,31.0,14.7,12.6,17.0,23.0,25.0,15.5,-6.0,24.0,28.0,14.223140495867767,11.0,30020.0,27504.0,11.0,5288.0,4679.0,6.0,17.0,100.0,100.0,19.0,13.5,40.0,35.0,15.0,16.0,40.0,35.0,15.5,15.5,7.1,7.1,21.0,14.0,4.5,3.3,1.5,6.0,12.0,11.6,19.5,8.0,22.4,23.5,21.0,20.0,8.0,14.9,32.0,24.5,5.2,4.9,6.0,18.0,47.6,43.5,15.0,4.0,27.7,24.5,5.0,19.5,609.0,9.0,1.5777777777777775,2.1515151515151514,1.0,20.0
2009.0,188.0,188.0,20.0,15.5,343.0,271.0,2.0,3.0,220.0,183.0,19.0,5.0,99.0,63.0,1.0,15.0,24.0,25.0,23.0,15.5,1.0,0.0,0.0,0.0,7.7,6.0,20.5,3.0,8117.0,5.0,8.6,7.2,23.5,2.5,56.0,168.0,140.0,8.0,4.800000000000002,2.0,32.5,27.7,6.0,1.0,377.0,68.2,63.7,25.0,2.0,341.0,21.5,6.0,8.0,25.5,10.416666666666666,7.0,136.0,214.74,-19.54,12.0,3.0,-65.49,67.02,3.0,32.0,59.48,6.0,5.0,92.9,84.6,20.5,2.0,1.0,10.0,6.0,9.0,2.0,1.0,10.0,5.0,8.0,2.0,11.0,13.0,9.0,19.0,13.083333333333336,9.0,8.59375,4.0,4.0,2.0,13.1875,12.0,19.0,1.0,2.0,0.5789473684210527,28.0,7.023553719008263,2.0,4.2,2.0,7.0,1.3,2.1,27.0,1.0,0.0,1.0,11.0,27.0,1.0,56.0,91.0,32.0,23.0,2.0,0.0,10.0,2.5,1297.0,2060.0,32.0,21.0,7.1,6.0,16.0,7.5,7.0,4.0,0.0,1.0,470.0,312.0,10.0,158.0,3.0,2.0,553.0,535.0,18.0,11.0,0.5569259962049335,0.6202127659574468,2.0,23.0,2.2222222222222223,8.0,34.0,6.1,4.9,24.0,2.0,26.0,23.0,2.0,0.6415094339622641,0.8387096774193549,2.0,17.0,0.6842278564372736,0.7148117839607201,1.0,13.0,4156.0,3494.0,19.0,8.0,101.0,757.0,902.0,26.0,13.0,109.0,28.0,24.0,0.06997084548104958,0.09225092250922508,7.0,22.0,5.8,5.1,1.0,9.0,1054.0,940.0,1.0,3.0,73.0,0.0,0.0,16.5,13.5,33.0,10.5,3202.0,3978.0,29.0,18.0,89.0,29.0,20.0,0.0,1.0,27.5,20.5,455.0,260.0,9.5,6.0,2.39,1.51,9.0,3.0,48.0,3.0,107.3,92.5,27.0,1.0,4403.0,9.0,0.45,25.0,0.4430740037950665,0.3797872340425532,31.0,10.0,0.3584905660377359,0.16129032258064513,31.0,16.0,0.3157721435627264,0.2851882160392799,32.0,20.0,467.0,357.0,1.0,9.0,19.0,5.0,1.5,7.5,1918.0,1394.0,2.0,13.0,12.883838383838382,4.0,42.0,28.2,9.0,2.0,1.0,0.0,34.0,5.8,8.2,2.0,12.5,247.0,318.0,1.0,21.0,48.0,1.0,16.5,28.0,26.0,9.5,20.0,26.0,22.0,14.0,11.0,18.0,9.0,11.7,23.0,2.0,24.0,22.5,6.0,9.0,3.0,9.847107438016527,3.0,31584.0,26320.0,3.0,6074.0,4888.0,6.0,5.0,98.2,96.8,8.0,17.0,55.0,31.0,7.5,2.0,54.0,30.0,6.5,2.0,8.0,7.1,20.0,7.0,4.1,3.9,6.0,21.5,11.7,11.2,13.5,10.0,23.2,22.6,15.0,12.0,9.5,7.9,12.0,11.5,5.8,5.2,13.5,10.0,43.9,44.7,23.0,13.0,32.2,25.9,6.0,8.0,1186.0,4.0,1.951219512195122,1.8205128205128205,7.0,5.0
2010.0,189.0,184.0,14.5,16.5,289.0,276.0,8.0,23.0,159.0,178.0,11.5,26.0,104.0,87.0,9.5,11.5,26.0,11.0,1.5,9.0,2.0,0.0,1.0,0.0,4.1,5.7,17.0,30.0,7047.0,25.0,4.8,6.4,14.0,30.0,33.0,154.0,156.0,17.5,0.3999999999999986,15.0,30.2,29.8,18.0,13.5,305.0,60.4,62.9,21.0,18.0,333.0,20.0,20.0,12.0,21.5,12.333333333333336,9.0,-89.86,-50.2,-21.22,9.0,30.0,-23.58,36.18,12.0,10.0,23.8,11.0,28.0,94.4,78.3,9.5,1.0,0.0,7.0,9.0,2.0,0.0,0.0,7.0,8.0,2.0,0.0,11.0,11.0,14.5,18.5,16.958333333333332,19.0,17.43125,20.0,24.3,30.0,10.5625,10.0,20.0,1.0,2.0,0.55,24.0,19.20922865013774,22.0,20.8,23.5,26.0,5.1,2.8,16.0,32.0,1.0,3.0,15.0,17.5,32.0,64.0,61.0,14.0,14.5,1.0,1.0,21.5,11.0,1427.0,1455.0,18.0,16.0,5.7,6.0,13.5,28.5,23.58333333333333,24.0,0.0,0.0,281.0,348.0,18.0,-67.0,25.0,29.0,505.0,529.0,14.0,21.0,0.5509164969450102,0.5731832139201638,16.0,22.0,1.5288461538461535,28.0,14.0,2.8,4.7,23.0,28.0,25.0,22.0,28.5,0.4666666666666667,0.7142857142857143,12.5,32.0,0.614606072633459,0.6731307477009196,14.0,27.0,3097.0,3367.0,9.0,26.0,100.0,769.0,786.0,17.0,15.0,98.0,20.0,20.0,0.08996539792387544,0.03985507246376811,31.0,10.0,5.3,5.4,10.5,23.0,982.0,977.0,9.5,23.0,83.0,0.0,0.0,16.5,12.5,32.0,12.5,3569.0,3748.0,28.0,11.0,85.0,25.0,10.5,0.0,1.0,26.0,21.0,361.0,241.0,8.5,14.5,1.38,1.63,13.0,28.5,42.0,7.0,67.7,86.4,21.5,30.0,3327.0,27.0,0.6540880503144654,5.0,0.4490835030549898,0.4268167860798362,17.0,11.0,0.5333333333333333,0.2857142857142857,20.5,1.0,0.3853939273665409,0.3268692522990804,19.0,6.0,441.0,417.0,15.0,12.0,16.0,10.0,10.5,7.0,1942.0,1635.0,9.0,10.0,16.71212121212121,20.0,24.9,28.8,9.0,30.0,0.0,0.0,36.0,6.7,5.5,20.5,21.0,230.0,177.0,29.0,19.0,31.0,21.0,17.5,18.0,23.0,6.0,32.0,17.0,18.0,5.0,31.0,37.0,19.0,12.5,20.5,30.0,26.0,18.0,-11.0,29.0,29.5,17.61845730027548,20.0,29106.0,28704.0,18.0,5039.0,5002.0,8.0,23.0,96.8,100.0,21.0,29.0,31.0,42.0,20.5,25.5,30.0,42.0,20.5,25.5,6.6,6.7,9.0,24.0,4.4,3.9,8.5,8.5,10.9,10.6,5.5,24.0,22.3,23.9,23.0,17.0,8.6,7.5,8.0,21.0,5.1,5.1,9.0,22.0,43.0,44.1,24.0,21.0,26.4,27.2,10.0,23.0,37.0,17.0,1.4999999999999998,1.717948717948718,13.0,26.0
2011.0,189.0,185.0,11.0,17.0,297.0,332.0,24.0,18.0,159.0,213.0,30.0,26.5,118.0,92.0,13.5,5.0,20.0,27.0,20.0,28.5,0.0,0.0,0.0,1.0,4.6,7.4,30.5,29.0,7312.0,14.0,5.7,8.7,32.0,24.5,39.0,146.0,163.0,24.5,-0.8999999999999986,20.0,29.1,30.0,26.0,9.5,286.0,56.1,68.2,31.0,27.5,367.0,27.0,27.0,2.0,30.0,21.416666666666668,23.0,-28.14,-64.13,-136.38,31.0,29.0,43.75,50.98,4.0,2.0,-81.04,26.0,18.0,78.6,91.4,30.0,24.5,0.0,7.0,8.0,10.0,3.0,0.0,7.0,7.0,6.0,2.0,9.0,15.0,1.5,18.0,19.5,25.0,14.375,15.0,22.0,28.0,6.75,3.0,20.0,0.0,1.0,0.45,17.0,21.342699724517907,26.0,23.6,25.0,17.0,3.3,1.5,31.0,22.0,0.0,3.0,8.0,31.5,21.5,53.0,57.0,27.5,5.0,1.0,1.0,28.0,5.0,1428.0,1403.0,30.0,2.0,5.3,6.8,25.0,27.5,17.25,17.0,0.0,0.0,340.0,449.0,31.0,-109.0,28.0,19.0,510.0,538.0,16.5,24.0,0.5551142005958292,0.572541382667965,18.0,22.0,1.347457627118644,28.0,20.0,3.9,6.3,32.0,18.5,34.0,32.0,20.0,0.5263157894736842,0.7727272727272727,3.0,28.5,0.560568720379147,0.7012737742104345,9.0,30.0,2957.0,4019.0,26.0,28.0,109.0,908.0,834.0,11.5,23.0,97.0,10.5,23.0,0.06734006734006734,0.08132530120481928,17.0,29.0,5.5,5.7,22.5,16.0,1007.0,1027.0,18.0,20.0,77.0,0.0,0.0,16.5,12.0,43.0,23.5,3517.0,0.0,16.5,18.0,67.0,5.5,18.0,0.0,1.0,23.0,24.0,277.0,532.0,26.0,24.0,1.76,2.18,30.0,16.0,33.0,19.0,74.6,107.6,32.0,22.0,3255.0,28.0,0.7421383647798742,5.0,0.4448857994041708,0.4274586173320351,15.0,11.0,0.4736842105263158,0.2272727272727273,30.0,4.5,0.4394312796208529,0.29872622578956554,24.0,3.0,448.0,439.0,19.0,13.0,18.0,10.0,10.0,4.0,2318.0,1712.0,11.0,4.0,18.424242424242426,25.0,31.7,41.1,30.0,18.0,1.0,1.0,49.0,8.8,8.5,2.0,25.0,298.0,342.0,1.0,26.0,50.0,1.5,27.5,28.0,35.0,25.0,23.0,22.0,32.0,29.5,26.5,26.0,13.2,10.8,24.0,20.0,23.0,20.5,-3.0,20.0,19.0,19.085399449035812,27.0,27594.0,30155.0,26.0,5275.0,5731.0,21.0,18.0,97.4,100.0,20.0,30.0,39.0,49.0,28.5,14.5,38.0,49.0,28.5,15.0,6.4,8.1,30.0,27.0,5.2,3.9,7.0,2.0,11.4,11.9,13.0,24.0,26.9,24.6,20.5,2.0,8.4,12.4,27.0,23.0,5.2,5.6,21.5,18.5,45.7,0.0,16.5,13.5,27.9,30.9,23.0,19.0,-456.0,24.0,1.2307692307692308,2.0769230769230766,1.0,32.0
2012.0,182.0,187.0,17.0,23.5,306.0,345.0,27.5,18.0,163.0,229.0,31.0,26.5,113.0,82.0,8.0,8.0,30.0,34.0,27.5,12.5,3.0,0.0,2.0,3.0,5.0,6.1,19.0,27.0,7027.0,19.0,5.7,7.0,21.0,28.0,39.0,152.0,162.0,20.5,0.5999999999999979,14.0,27.4,26.8,12.5,16.0,300.0,62.1,63.9,26.5,12.0,391.0,30.0,24.0,18.0,18.5,16.666666666666668,16.0,34.14,24.46,-110.94,25.0,19.0,12.36,48.68,6.0,6.0,-52.32,20.0,17.0,92.1,83.3,11.5,4.0,0.0,10.0,9.0,9.0,10.0,0.0,10.0,8.0,7.0,10.0,11.0,12.0,10.0,21.5,15.5,14.5,14.71875,15.0,21.75,28.0,7.6875,6.0,21.0,0.0,0.0,0.5238095238095238,24.0,16.94490358126722,17.0,18.5,19.0,12.0,2.5,1.6,29.5,14.5,3.0,1.0,10.0,28.0,8.5,44.0,33.0,6.5,12.5,1.0,0.0,11.5,7.0,1171.0,795.0,7.0,9.0,5.3,6.0,11.5,30.5,16.0,15.5,0.0,0.0,379.0,348.0,14.5,31.0,13.0,14.0,483.0,612.0,30.0,28.0,0.5144855144855145,0.605724838411819,6.0,28.0,1.4424778761061947,27.0,18.0,3.7,4.6,20.0,22.5,28.0,24.0,25.5,0.5294117647058824,0.7368421052631579,7.5,27.0,0.5108635097493036,0.6978571428571428,6.0,32.0,2751.0,3908.0,24.0,31.0,90.0,830.0,949.0,26.0,12.0,111.0,26.0,5.0,0.09803921568627452,0.09855072463768116,11.0,10.0,5.7,6.0,30.0,14.0,1001.0,1083.0,27.0,20.0,72.0,0.0,0.0,16.5,9.0,41.0,26.5,3237.0,0.0,16.5,22.0,76.0,16.0,22.5,1.0,0.0,9.5,9.0,287.0,341.0,14.0,24.0,1.88,1.82,18.0,14.0,32.0,22.0,81.2,92.3,25.0,22.0,2935.0,32.0,0.6932515337423313,6.0,0.4855144855144855,0.3942751615881809,27.0,5.0,0.4705882352941176,0.2631578947368421,25.5,6.0,0.4891364902506964,0.3021428571428572,27.0,1.0,486.0,427.0,16.0,8.0,16.0,10.0,9.5,9.5,2634.0,1692.0,11.0,2.0,12.873737373737375,3.0,37.9,33.7,17.0,8.0,0.0,0.0,32.0,6.2,6.7,7.0,16.0,184.0,284.0,6.5,6.0,44.0,5.5,11.0,38.0,30.0,13.5,4.0,35.0,25.0,12.5,1.0,23.0,12.6,11.8,19.5,17.0,22.0,22.0,-1.0,18.5,12.5,15.389807162534435,15.0,27664.0,30294.0,28.0,5385.0,5600.0,16.0,20.0,100.0,94.3,1.0,14.0,36.0,35.0,12.0,21.0,36.0,33.0,10.5,21.0,6.1,6.8,10.5,31.0,5.4,4.0,8.5,1.0,9.8,10.7,5.5,32.0,26.6,24.1,18.0,5.0,9.0,8.3,9.0,19.5,5.4,5.2,11.0,16.5,45.0,0.0,16.5,20.0,29.5,30.0,16.5,16.5,-215.0,19.0,1.1296296296296295,1.7,14.0,32.0
2013.0,195.0,197.0,22.0,15.0,309.0,368.0,30.5,19.0,173.0,247.0,32.0,23.0,106.0,101.0,20.0,11.5,30.0,20.0,1.5,16.0,1.0,0.0,0.0,0.0,5.0,7.0,28.0,22.0,7759.0,6.0,5.8,7.8,27.0,26.5,45.0,140.0,162.0,28.0,-1.6999999999999993,23.0,28.1,29.8,24.0,14.0,325.0,59.5,64.7,25.5,19.5,419.0,32.0,22.5,6.0,30.0,26.5,30.0,14.24,-4.7,-140.4,32.0,23.0,25.14,8.0,23.0,1.0,-125.25,32.0,17.0,86.7,93.1,27.0,19.0,0.0,7.0,12.0,6.0,5.0,0.0,7.0,12.0,5.0,2.0,13.0,8.0,23.5,28.0,23.66666666666667,29.0,15.7,18.0,21.65,26.0,9.75,7.5,23.0,1.0,1.0,0.5652173913043478,26.0,23.338016528925618,31.0,26.8,31.5,19.0,3.5,1.9,28.5,26.0,0.0,3.0,12.0,24.5,21.5,66.0,41.0,17.0,2.0,2.0,1.0,28.0,1.5,1646.0,1113.0,25.0,1.0,5.8,6.7,23.5,21.5,16.5,16.0,0.0,0.0,391.0,480.0,32.0,-89.0,23.5,14.5,546.0,648.0,31.0,20.5,0.5824284304047384,0.6086572438162544,8.0,18.0,1.6320754716981132,25.0,18.0,3.3,5.7,29.0,25.0,37.0,32.0,27.5,0.4390243902439024,0.7254901960784313,10.0,32.0,0.6221859114015976,0.7222571518390444,4.0,25.0,3427.0,4595.0,31.0,23.0,70.0,695.0,1003.0,30.0,6.0,100.0,18.5,3.5,0.0970873786407767,0.05434782608695652,32.0,14.0,5.3,5.9,28.0,29.5,1013.0,1132.0,31.0,22.5,75.0,0.0,0.0,16.5,9.0,36.0,18.0,3316.0,0.0,16.5,24.0,77.0,14.5,23.5,1.0,1.0,27.0,7.0,335.0,318.0,16.0,14.0,1.87,2.22,29.0,14.0,22.0,30.5,76.0,98.6,30.0,24.0,3645.0,23.0,0.6127167630057804,8.0,0.4175715695952617,0.3913427561837456,25.0,15.0,0.5609756097560976,0.27450980392156865,23.0,1.0,0.3778140885984024,0.2777428481609556,29.0,8.0,423.0,443.0,20.0,18.5,23.0,14.0,20.0,1.0,2081.0,1767.0,16.0,8.0,15.545454545454545,11.0,34.4,39.6,29.0,14.0,0.0,0.0,44.0,7.5,6.0,23.0,22.0,218.0,274.0,12.0,7.0,41.0,14.0,21.5,30.0,29.0,11.0,16.0,26.0,27.0,18.0,15.0,32.0,14.9,9.1,30.0,26.5,20.0,27.5,-12.0,28.5,29.0,19.876033057851238,27.0,27300.0,31914.0,30.0,5508.0,6362.0,31.0,13.0,97.7,100.0,19.0,30.5,44.0,53.0,29.5,9.5,43.0,53.0,29.5,11.0,6.7,7.5,23.0,22.5,4.9,4.0,14.5,2.0,11.2,11.6,13.5,25.5,24.9,27.1,31.0,7.5,15.2,8.8,14.0,1.0,5.4,5.6,23.5,12.0,44.2,0.0,16.5,22.5,28.3,32.2,27.0,18.0,-854.0,29.0,1.3673469387755102,1.875,6.0,32.0
2014.0,176.0,179.0,10.5,25.0,288.0,321.0,19.0,26.5,171.0,189.0,9.5,24.5,90.0,100.0,21.0,18.0,27.0,32.0,17.5,24.0,4.0,0.0,4.0,0.0,4.9,6.1,14.5,28.0,6819.0,22.0,6.0,7.0,15.5,28.0,35.0,157.0,169.0,16.5,-0.8999999999999986,23.0,27.3,28.2,21.0,20.0,322.0,62.3,66.1,27.0,18.0,353.0,19.0,23.0,36.0,3.0,17.416666666666668,21.0,-2.41,1.79,-57.96,17.0,26.0,4.02,7.87,26.0,3.0,-42.67,20.0,21.0,74.3,80.6,8.0,31.0,2.0,5.0,10.0,9.0,9.0,2.0,4.0,8.0,7.0,5.0,2.0,6.0,28.0,1.0,12.0,8.0,18.875,24.0,24.5,30.0,13.25,15.0,12.0,2.0,0.0,0.16666666666666666,1.0,19.58732782369146,25.0,21.8,25.0,18.0,3.5,2.4,19.5,31.0,2.0,1.0,13.0,19.0,27.5,54.0,28.0,7.0,3.0,0.0,0.0,13.5,19.0,1173.0,579.0,3.0,6.0,5.7,6.2,13.5,28.0,20.0,22.0,2.0,1.0,325.0,343.0,11.0,-18.0,18.0,20.0,517.0,534.0,5.0,22.0,0.5790010193679919,0.5609756097560976,26.0,21.0,1.9,24.0,17.0,3.3,4.9,21.0,28.5,26.0,18.0,29.0,0.5862068965517241,0.7222222222222222,12.0,27.0,0.6426307448494454,0.6476881233000906,26.0,24.0,3244.0,3572.0,7.0,28.0,100.0,836.0,938.0,23.0,11.0,112.0,25.0,10.0,0.09375,0.09968847352024922,18.0,17.0,5.8,5.9,23.0,14.0,981.0,1025.0,17.0,28.0,76.0,1.0,0.0,16.5,21.0,39.0,27.0,3318.0,3292.0,13.0,16.0,76.0,18.0,13.5,0.0,0.0,10.0,21.5,297.0,255.0,16.0,10.0,1.64,1.83,16.5,21.0,27.0,24.5,79.2,92.8,23.0,27.0,3566.0,24.0,0.5263157894736842,9.0,0.42099898063200814,0.4390243902439024,7.0,12.0,0.4137931034482759,0.2777777777777778,21.0,6.0,0.3573692551505546,0.3523118766999094,7.0,9.0,413.0,450.0,24.5,18.0,12.0,10.0,12.0,15.0,1804.0,1943.0,25.0,14.0,13.818181818181818,10.0,31.8,34.1,18.5,21.0,0.0,2.0,51.0,9.0,7.1,8.0,28.5,322.0,217.0,21.0,26.0,41.0,10.5,28.0,35.0,31.0,13.5,9.0,26.0,25.0,13.0,15.5,20.0,10.8,10.1,24.0,10.0,19.0,25.5,-1.0,18.0,7.5,17.37465564738292,19.0,27632.0,30251.0,26.0,5048.0,5515.0,14.0,27.0,100.0,97.3,3.0,13.5,29.0,37.0,13.0,27.0,29.0,36.0,11.5,27.0,6.9,7.1,14.0,25.0,4.4,4.3,21.5,11.0,11.1,10.7,4.5,23.0,21.7,20.7,4.0,26.5,11.0,6.5,4.5,6.0,5.1,5.4,16.0,26.5,43.7,43.3,5.0,24.5,28.5,30.6,18.0,22.0,-467.0,24.0,1.568181818181818,1.6511627906976745,21.0,25.0
2015.0,172.0,177.0,4.5,31.5,297.0,318.0,16.0,28.5,153.0,189.0,11.5,31.0,113.0,94.0,14.5,5.0,31.0,35.0,24.0,18.5,1.0,0.0,1.0,1.0,5.6,6.1,13.0,24.0,6958.0,20.0,6.9,7.0,14.5,20.0,38.0,170.0,162.0,5.0,4.699999999999998,5.0,30.2,25.5,5.0,3.0,294.0,64.8,64.0,18.0,11.0,359.0,18.0,31.0,18.0,15.5,14.666666666666664,11.0,34.58,18.21,-35.54,10.0,23.0,20.45,33.25,16.0,2.0,3.87,12.0,17.0,87.2,90.3,27.0,11.0,0.0,9.0,15.0,7.0,8.0,0.0,9.0,13.0,6.0,6.0,8.0,9.0,18.5,10.5,11.583333333333336,7.0,13.65,11.0,22.3,29.0,5.0,3.0,21.0,1.0,0.0,0.3809523809523809,8.0,14.253856749311293,10.0,13.1,8.0,9.0,2.0,2.3,17.0,12.0,2.0,0.0,13.0,18.0,6.0,42.0,40.0,23.0,5.5,2.0,0.0,13.5,1.5,1190.0,1043.0,26.0,3.0,5.9,6.2,12.0,25.5,18.0,19.0,0.0,0.0,365.0,302.0,5.0,63.0,9.0,16.0,454.0,561.0,15.5,32.0,0.512846865364851,0.5950738916256157,15.0,30.0,1.353982300884956,30.0,14.0,3.1,4.3,16.0,28.0,24.0,12.5,31.0,0.4375,0.7741935483870968,7.0,31.0,0.5697606538237011,0.6827586206896552,19.0,32.0,2928.0,3762.0,12.0,31.0,88.0,797.0,875.0,10.0,5.0,109.0,12.5,1.0,0.10437710437710436,0.110062893081761,7.0,14.0,5.9,5.9,27.0,9.0,973.0,1015.0,16.0,28.0,66.0,0.0,0.0,11.0,11.5,29.0,8.5,2746.0,3158.0,9.0,28.0,72.0,10.5,28.0,1.0,0.0,11.5,7.0,311.0,152.0,2.0,13.0,1.9,1.7,12.0,14.0,34.0,16.0,87.9,90.1,15.0,20.0,3246.0,31.0,0.7385620915032679,3.0,0.48715313463514903,0.40492610837438425,18.0,3.0,0.5625,0.22580645161290325,26.0,2.0,0.4302393461762989,0.3172413793103448,14.0,1.0,474.0,411.0,14.0,4.0,18.0,7.0,4.0,4.5,2211.0,1748.0,17.0,4.0,12.93939393939394,4.0,38.4,33.3,14.0,7.0,0.0,1.0,45.0,9.0,7.1,8.5,31.0,318.0,283.0,8.0,26.0,43.0,8.0,24.5,39.0,31.0,19.0,4.5,34.0,28.0,22.0,2.0,17.0,9.3,11.9,14.5,7.5,22.0,20.0,5.0,11.5,5.5,15.407713498622586,13.0,29240.0,28674.0,19.0,5139.0,5510.0,13.0,29.0,89.2,100.0,30.0,28.0,37.0,28.0,4.0,16.0,33.0,28.0,7.0,18.5,7.1,7.2,15.5,19.0,4.7,4.3,22.0,3.5,11.0,11.3,10.5,26.5,28.3,26.1,26.0,1.0,9.1,5.2,4.5,13.0,5.3,5.4,13.0,23.5,41.6,43.9,6.5,32.0,29.9,31.1,20.5,17.5,-371.0,21.0,1.5106382978723405,1.6744186046511629,21.0,31.0
2016.0,173.0,177.0,7.5,30.0,303.0,304.0,7.0,25.0,209.0,186.0,9.0,12.0,66.0,87.0,8.5,32.0,28.0,31.0,16.5,19.5,3.0,0.0,1.0,1.0,6.4,5.3,3.0,16.5,6580.0,24.0,7.3,6.3,4.5,14.0,36.0,170.0,162.0,4.5,3.6999999999999993,3.0,30.8,27.1,7.5,2.0,414.0,70.4,60.6,6.5,1.0,332.0,7.0,3.0,26.0,4.5,7.083333333333332,4.0,0.5,92.52,-22.74,4.0,14.0,-78.99,41.65,7.0,32.0,23.66,5.0,22.0,87.1,87.5,23.0,8.0,1.0,6.0,11.0,10.0,3.0,1.0,6.0,10.0,8.0,2.0,11.0,13.0,4.5,25.5,5.166666666666667,1.0,20.4375,26.0,11.75,10.0,29.125,32.0,20.0,2.0,0.0,0.55,27.0,13.405371900826445,12.0,12.1,11.0,5.0,0.9,2.6,12.5,2.0,2.0,0.0,14.0,13.0,2.0,33.0,38.0,21.5,15.5,1.0,1.0,29.0,4.0,902.0,980.0,29.0,5.0,6.1,5.6,2.0,21.0,22.66666666666667,24.0,0.0,0.0,327.0,307.0,6.0,20.0,15.0,23.0,588.0,548.0,10.5,12.0,0.6222664015904572,0.5931520644511581,17.0,9.0,3.1666666666666665,1.0,20.0,3.4,4.0,16.0,24.5,22.0,12.5,22.0,0.6896551724137931,0.7096774193548387,12.0,10.0,0.7609601269589367,0.6603811036125447,26.0,1.0,3836.0,3327.0,3.0,18.0,103.0,882.0,825.0,5.0,15.0,99.0,5.5,11.5,0.0924092409240924,0.10197368421052633,13.0,18.0,6.0,5.8,19.0,8.0,1006.0,993.0,6.5,23.0,74.0,0.0,0.0,13.0,13.5,26.0,8.0,3155.0,3290.0,18.0,19.0,72.0,17.5,17.0,2.0,0.0,12.0,2.0,354.0,209.0,9.0,4.0,1.64,1.7,7.5,23.0,34.0,12.0,97.7,83.0,4.0,6.0,4119.0,17.0,0.3157894736842105,32.0,0.3777335984095428,0.4068479355488419,16.0,24.0,0.31034482758620685,0.29032258064516125,21.0,23.0,0.2390398730410633,0.3396188963874553,7.0,32.0,380.0,404.0,14.0,25.5,9.0,9.0,3.5,27.0,1205.0,1711.0,20.0,32.0,14.272727272727273,9.0,32.4,33.3,9.0,21.0,1.0,0.0,38.0,6.1,7.0,6.0,23.0,283.0,310.0,2.0,27.0,41.0,5.0,23.0,31.0,32.0,19.0,19.5,27.0,28.0,21.5,16.5,16.0,7.5,14.1,4.0,4.0,27.0,8.0,11.0,4.5,7.0,14.710743801652892,11.0,29410.0,28674.0,20.0,5041.0,5038.0,3.0,28.0,78.8,100.0,30.0,32.0,33.0,29.0,5.5,23.0,26.0,29.0,7.0,28.0,7.0,6.6,3.0,18.5,3.2,4.2,16.5,32.0,9.9,11.0,12.5,31.0,27.3,25.8,31.0,1.5,10.4,8.0,8.0,8.0,5.0,5.1,6.0,28.5,42.6,45.7,18.0,29.0,29.1,28.4,8.0,21.0,3.0,18.0,2.1875,1.5714285714285712,27.0,1.0
