Year,#Dr,#Dr_Defense,#Dr_Defense_Low_Rank,#Dr_High_Rank,1stD,1stD_Defense,1stD_Defense_Low_Rank,1stD_High_Rank,1stDpass,1stDpass_Defense,1stDpass_Defense_Low_Rank,1stDpass_High_Rank,1stDrun,1stDrun_Defense,1stDrun_Defense_Low_Rank,1stDrun_High_Rank,1stPy,1stPy_Defense,1stPy_Defense_Low_Rank,1stPy_High_Rank,2PA,2PA_Defense,2PM,2PM_Defense,ANY/A,ANY/A_Defense,ANY/A_Defense_Low_Rank,ANY/A_High_Rank,APYd,APYd_High_Rank,AY/A,AY/A_Defense,AY/A_Defense_Low_Rank,AY/A_High_Rank,AllTD,AvgDriveTime,AvgDriveTime_Defense,AvgDriveTime_High_Rank,AvgFieldPositionDifferential,AvgFieldPositionDifferential_High_Rank,AvgStartingPosition,AvgStartingPosition_Defense,AvgStartingPosition_Defense_Low_Rank,AvgStartingPosition_High_Rank,Cmp,Cmp%,Cmp%_Defense,Cmp%_Defense_Low_Rank,Cmp%_High_Rank,Cmp_Defense,Cmp_Defense_Low_Rank,Cmp_High_Rank,DefensivePtsScored,DefensivePtsScored_High_Rank,Dscore,Dscore_Rank,ExpectedPoints,ExpectedPointsPassing,ExpectedPointsPassing_Defense,ExpectedPointsPassing_Defense_High_Rank,ExpectedPointsPassing_High_Rank,ExpectedPointsRunning,ExpectedPointsRunning_Defense,ExpectedPointsRunning_Defense_High_Rank,ExpectedPointsRunning_High_Rank,ExpectedPoints_Defense,ExpectedPoints_Defense_High_Rank,ExpectedPoints_High_Rank,FG%,FG%_Defense,FG%_Defense_Low_Rank,FG%_High_Rank,FGA019,FGA2029,FGA3039,FGA4049,FGA50Plus,FGM019,FGM2029,FGM3039,FGM4049,FGM50Plus,FL,FL_Defense,FL_Defense_High_Rank,FL_Low_Rank,FantasyDstScore,FantasyDstScore_Rank,FantasyOffenseScore,FantasyOffenseScore_Rank,FantasyPassScore,FantasyPassScore_Rank,FantasyRushScore,FantasyRushScore_Rank,Fmb,FmbTD,FmbTD_Defense,FumbleLostPercent,FumbleLostPercent_Low_Rank,GameControlPlusBalance,GameControlPlusBalance_Rank,GameControlScore,GameControlScore_Rank,Int,Int%,Int%_Defense,Int%_Defense_High_Rank,Int%_Low_Rank,IntTD,IntTD_Defense,Int_Defense,Int_Defense_High_Rank,Int_Low_Rank,KickRet,KickRet_Defense,KickRet_Defense_Low_Rank,KickRet_High_Rank,KrTD,KrTD_Defense,KrTD_Defense_Low_Rank,KrTD_High_Rank,KrYds,KrYds_Defense,KrYds_Defense_Low_Rank,KrYds_High_Rank,NY/A,NY/A_Defense,NY/A_Defense_Low_Rank,NY/A_High_Rank,Oscore,Oscore_Rank,OthTD,OthTD_Defense,PF,PF_Defense,PF_Defense_Low_Rank,PF_Differential,PF_Differential_High_Rank,PF_High_Rank,PassAtt,PassAtt_Defense,PassAtt_Defense_Low_Rank,PassAtt_High_Rank,PassPercent,PassPercent_Defense,PassPercent_Defense_High_Rank,PassPercent_High_Rank,PassRun1dRatio,PassRun1dRatio_High_Rank,PassTD,PassTD%,PassTD%_Defense,PassTD%_Defense_Low_Rank,PassTD%_High_Rank,PassTD_Defense,PassTD_Defense_Low_Rank,PassTD_High_Rank,PassTdPercent,PassTdPercent_Defense,PassTdPercent_Defense_High_Rank,PassTdPercent_High_Rank,PassYdPercent,PassYdPercent_Defense,PassYdPercent_Defense_High_Rank,PassYdPercent_High_Rank,PassYds,PassYds_Defense,PassYds_Defense_Low_Rank,PassYds_High_Rank,Pen,PenYds,PenYds_Defense,PenYds_Defense_Low_Rank,PenYds_Low_Rank,Pen_Defense,Pen_Defense_Low_Rank,Pen_Low_Rank,Penalty1dPercent,Penalty1dPercent_Defense,Penalty1dPercent_Defense_High_Rank,Penalty1dPercent_High_Rank,Plays/Drive,Plays/Drive_Defense,Plays/Drive_Defense_Low_Rank,Plays/Drive_High_Rank,Ply,Ply_Defense,Ply_Defense_Low_Rank,Ply_High_Rank,Pnt,PntBlck,PntBlck_Defense,PntBlck_Defense_Low_Rank,PntBlck_Low_Rank,PntRet_Defense,PntRet_Defense_Low_Rank,PntYds,PntYds_Defense,PntYds_Defense_Low_Rank,PntYds_High_Rank,Pnt_Defense,Pnt_Defense_Low_Rank,Pnt_High_Rank,PrTD,PrTD_Defense,PrTD_Defense_Low_Rank,PrTD_High_Rank,PrYds,PrYds_Defense,PrYds_Defense_Low_Rank,PrYds_High_Rank,Pts/Drive,Pts/Drive_Defense,Pts/Drive_Defense_Low_Rank,Pts/Drive_High_Rank,PuntRet,PuntRet_High_Rank,QbRating,QbRating_Defense,QbRating_Defense_Low_Rank,QbRating_High_Rank,RawPassYds,RawPassYds_High_Rank,RunPass1dRatio,RunPass1dRatio_High_Rank,RunPercent,RunPercent_Defense,RunPercent_Defense_High_Rank,RunPercent_High_Rank,RunTdPercent,RunTdPercent_Defense,RunTdPercent_Defense_High_Rank,RunTdPercent_High_Rank,RunYdPercent,RunYdPercent_Defense,RunYdPercent_Defense_High_Rank,RunYdPercent_High_Rank,RushAtt,RushAtt_Defense,RushAtt_Defense_Low_Rank,RushAtt_High_Rank,RushTD,RushTD_Defense,RushTD_Defense_Low_Rank,RushTD_High_Rank,RushYds,RushYds_Defense,RushYds_Defense_Low_Rank,RushYds_High_Rank,STscore,STscore_Rank,Sc%,Sc%_Defense,Sc%_Defense_Low_Rank,Sc%_High_Rank,Sfty,Sfty_Defense,Sk,Sk%,Sk%_Defense,Sk%_Defense_High_Rank,Sk%_Low_Rank,SkYds,SkYds_Defense,SkYds_Defense_High_Rank,SkYds_Low_Rank,Sk_Defense,Sk_Defense_High_Rank,Sk_Low_Rank,TFGA,TFGA_Defense,TFGA_Defense_Low_Rank,TFGA_High_Rank,TFGM,TFGM_Defense,TFGM_Defense_Low_Rank,TFGM_High_Rank,TO,TO%,TO%_Defense,TO%_Defense_High_Rank,TO%_Low_Rank,TO_Defense,TO_Defense_High_Rank,TO_Differential,TO_Differential_High_Rank,TO_Low_Rank,ThreePhaseScore,ThreePhaseScore_Rank,TimeOfPossession,TimeOfPossession_Defense,TimeOfPossession_High_Rank,TotalYds,TotalYds_Defense,TotalYds_Defense_Low_Rank,TotalYds_High_Rank,XP%,XP%_Defense,XP%_Defense_Low_Rank,XP%_High_Rank,XPA,XPA_Defense,XPA_Defense_Low_Rank,XPA_High_Rank,XPM,XPM_Defense,XPM_Defense_Low_Rank,XPM_High_Rank,Y/Apass,Y/Apass_Defense,Y/Apass_Defense_Low_Rank,Y/Apass_High_Rank,Y/Arun,Y/Arun_Defense,Y/Arun_Defense_Low_Rank,Y/Arun_High_Rank,Y/C,Y/C_Defense,Y/C_Defense_Low_Rank,Y/C_High_Rank,Y/KR,Y/KR_Defense,Y/KR_Defense_Low_Rank,Y/KR_High_Rank,Y/PR,Y/PR_Defense,Y/PR_Defense_Low_Rank,Y/PR_High_Rank,Y/Play,Y/Play_Defense,Y/Play_Defense_Low_Rank,Y/Play_High_Rank,Y/Pnt,Y/Pnt_Defense,Y/Pnt_Defense_Low_Rank,Y/Pnt_High_Rank,Yds/Drive,Yds/Drive_Defense,Yds/Drive_Defense_Low_Rank,Yds/Drive_High_Rank,Yds_Differential,Yds_Differential_High_Rank,YppYprRatio,YppYprRatio_Defense,YppYprRatio_Defense_High_Rank,YppYprRatio_High_Rank
1981.0,,,,,318.0,291.0,8.5,10.0,170.0,155.0,9.0,10.0,122.0,112.0,8.5,17.0,26.0,24.0,13.0,11.5,0.0,0.0,0.0,0.0,5.5,4.1,7.0,10.0,7119.0,18.0,6.3,5.7,9.0,11.0,40.0,,,,,,,,,,283.0,55.8,54.5,11.0,8.5,275.0,12.5,11.0,20.0,8.5,9.583333333333334,6.0,,,,,,,,,,,,,69.4,60.0,9.0,9.0,0.0,13.0,8.0,12.0,3.0,0.0,11.0,6.0,8.0,0.0,17.0,15.0,23.5,11.0,9.583333333333334,4.0,11.63125,9.0,9.95,10.0,13.3125,14.0,38.0,1.0,2.0,0.4473684210526316,5.0,,,,,14.0,2.8,4.2,13.0,3.0,2.0,0.0,21.0,14.0,3.5,58.0,63.0,16.0,16.5,0.0,0.0,12.5,16.5,1151.0,1415.0,24.0,17.0,5.7,5.3,4.0,21.0,12.166666666666664,11.0,0.0,0.0,355.0,287.0,8.0,68.0,9.0,9.0,507.0,505.0,14.5,11.0,0.4846570397111914,0.5511583011583011,4.0,21.0,1.3934426229508197,14.0,26.0,5.1,3.0,6.0,8.0,15.0,5.0,6.0,0.7027027027027027,0.4411764705882353,26.0,2.0,0.566160118606375,0.6167111476082939,12.0,20.0,3055.0,3004.0,8.0,19.0,112.0,936.0,935.0,21.0,21.0,106.0,18.0,23.0,0.08176100628930817,0.08247422680412371,14.0,11.5,,,,,1108.0,1036.0,9.5,5.0,81.0,0.0,0.0,14.5,11.5,31.0,2.5,3290.0,3798.0,23.0,14.0,94.0,23.5,13.5,0.0,0.0,10.0,18.5,337.0,149.0,1.0,18.0,,,,,50.0,8.0,81.1,69.1,12.0,7.0,3279.0,20.0,0.7176470588235294,15.0,0.5153429602888087,0.4488416988416989,25.0,8.0,0.2972972972972973,0.5588235294117647,3.0,27.0,0.43383988139362495,0.3832888523917061,17.0,9.0,571.0,465.0,3.5,5.0,11.0,19.0,21.5,24.0,2341.0,1867.0,7.0,6.0,13.888888888888886,12.0,0.0,0.0,14.5,14.5,1.0,1.0,30.0,5.6,11.6,1.0,9.0,224.0,518.0,1.0,7.0,66.0,1.0,9.0,36.0,20.0,1.0,2.5,25.0,12.0,1.5,3.5,31.0,0.0,0.0,14.5,14.5,36.0,17.5,5.0,10.0,4.5,11.696969696969695,7.0,,,,5396.0,4871.0,5.0,15.0,97.4,91.7,9.0,12.0,39.0,36.0,11.0,11.5,38.0,33.0,9.0,9.0,6.5,7.0,13.5,22.0,4.1,4.0,14.5,13.5,11.6,12.8,16.5,27.0,19.8,22.5,25.0,15.0,6.7,4.8,2.0,24.0,4.9,4.7,3.5,20.5,40.6,40.4,9.0,15.5,,,,,525.0,9.0,1.5853658536585369,1.75,14.0,23.0
1982.0,,,,,193.0,160.0,7.5,3.0,95.0,88.0,10.0,12.5,87.0,54.0,7.5,1.0,11.0,18.0,23.0,19.0,0.0,0.0,0.0,0.0,6.0,3.4,4.0,4.5,4363.0,4.0,7.2,4.2,4.0,4.5,31.0,,,,,,,,,,165.0,59.1,53.4,7.0,7.0,159.0,17.0,11.0,12.0,8.0,7.333333333333332,3.0,,,,,,,,,,,,,64.7,60.0,7.0,17.0,1.0,5.0,5.0,6.0,0.0,1.0,3.0,4.0,3.0,0.0,9.0,9.0,15.5,11.5,10.583333333333334,8.0,5.7125,2.0,6.55,4.0,4.875,1.0,18.0,1.0,0.0,0.5,14.5,,,,,9.0,3.2,5.7,4.0,5.5,1.0,3.0,17.0,5.0,5.0,33.0,35.0,14.0,19.0,0.0,1.0,27.5,15.5,667.0,743.0,16.0,16.0,6.3,5.2,6.0,9.0,4.75,2.0,0.0,0.0,245.0,166.0,10.0,79.0,2.0,3.0,279.0,298.0,22.0,15.0,0.4983498349834983,0.5417376490630323,11.0,19.0,1.0919540229885059,24.0,16.0,5.7,3.4,9.0,4.0,10.0,10.0,4.5,0.5517241379310345,0.6666666666666666,5.5,18.0,0.5907395898073338,0.6260935717002662,18.0,21.0,1901.0,1646.0,9.0,7.0,63.0,533.0,345.0,4.0,23.0,43.0,3.0,23.0,0.056994818652849735,0.1125,4.0,25.0,,,,,606.0,587.0,14.0,4.5,36.0,1.0,0.0,14.5,24.5,17.0,5.0,1387.0,1768.0,14.0,24.0,42.0,11.5,24.0,0.0,1.0,26.0,16.5,184.0,153.0,9.0,16.0,,,,,23.0,15.5,88.5,59.4,4.0,5.0,2107.0,6.0,0.9157894736842104,5.0,0.5016501650165017,0.4582623509369677,18.0,10.0,0.4482758620689655,0.33333333333333337,23.5,11.0,0.40926041019266624,0.37390642829973375,11.0,8.0,304.0,269.0,13.0,8.0,13.0,5.0,4.0,4.0,1317.0,983.0,11.0,4.0,17.848484848484848,23.0,0.0,0.0,14.5,14.5,0.0,0.0,23.0,7.6,6.3,19.0,14.0,206.0,171.0,18.0,15.0,20.0,18.0,13.0,17.0,15.0,12.0,13.0,11.0,9.0,8.0,11.5,18.0,0.0,0.0,14.5,14.5,26.0,5.5,8.0,2.5,7.0,9.261707988980717,2.0,,,,3218.0,2629.0,6.0,4.0,83.9,95.0,17.5,28.0,31.0,20.0,13.5,3.0,26.0,19.0,13.5,4.5,7.6,6.1,5.0,8.5,4.3,3.7,9.0,2.5,12.8,11.4,6.0,10.5,20.2,21.2,18.0,14.0,8.0,9.0,19.0,15.0,5.3,4.5,5.0,6.0,38.5,42.1,23.0,25.0,,,,,589.0,3.0,1.7674418604651163,1.6486486486486485,24.0,18.0
1983.0,,,,,313.0,298.0,11.0,14.0,171.0,151.0,6.5,11.5,126.0,126.0,16.0,14.0,16.0,21.0,12.0,22.0,0.0,0.0,0.0,0.0,4.3,4.6,11.0,18.5,7632.0,8.0,5.2,5.9,13.5,20.5,38.0,,,,,,,,,,330.0,59.0,58.1,20.0,8.0,269.0,7.0,5.0,30.0,5.0,13.75,15.0,,,,,,,,,,,,,66.7,71.4,12.5,19.5,4.0,4.0,7.0,8.0,1.0,4.0,3.0,5.0,4.0,0.0,19.0,14.0,25.0,17.0,10.875,10.0,15.275,21.0,13.55,15.0,17.0,19.0,29.0,1.0,0.0,0.6551724137931034,25.0,,,,,28.0,5.0,4.8,9.5,21.0,3.0,3.0,22.0,17.0,23.0,66.0,50.0,4.5,11.5,0.0,0.0,13.0,15.5,1375.0,1063.0,8.0,6.0,5.7,5.7,8.5,16.5,14.666666666666664,14.0,1.0,0.0,313.0,331.0,10.0,-18.0,16.5,19.0,559.0,463.0,4.0,6.0,0.5594795539033457,0.4829867674858223,24.0,9.0,1.3571428571428572,15.0,21.0,3.8,4.8,20.0,18.5,22.0,16.0,16.5,0.65625,0.6285714285714286,11.0,8.0,0.6235208447114511,0.5514053952084512,25.0,13.0,3425.0,2923.0,7.0,10.0,110.0,1059.0,784.0,10.0,27.0,96.0,13.0,20.0,0.051118210862619806,0.07046979865771813,15.0,24.0,,,,,1076.0,1058.0,16.0,7.0,82.0,1.0,0.0,14.5,21.0,47.0,18.5,3258.0,3493.0,20.0,16.0,85.0,21.5,13.0,1.0,1.0,22.5,6.5,420.0,367.0,16.0,10.5,,,,,38.0,22.5,70.8,76.2,17.0,18.0,3742.0,11.0,0.7368421052631579,14.0,0.4405204460966543,0.5170132325141776,5.0,20.0,0.34375,0.3714285714285713,18.0,21.0,0.376479155288549,0.4485946047915488,4.0,16.0,474.0,547.0,19.0,19.0,11.0,13.0,10.0,23.0,2068.0,2378.0,23.0,17.0,14.56060606060606,13.0,0.0,0.0,14.5,14.5,0.0,1.0,43.0,7.1,9.4,6.5,10.0,317.0,378.0,8.0,11.0,48.0,10.0,12.5,24.0,28.0,16.0,21.5,16.0,20.0,17.0,19.5,47.0,0.0,0.0,14.5,14.5,36.0,19.0,-11.0,22.0,21.5,14.304407713498618,13.0,,,,5493.0,5301.0,13.0,11.0,100.0,89.7,2.0,2.5,37.0,39.0,11.5,19.0,37.0,35.0,8.5,17.5,6.7,7.1,13.0,22.0,4.4,4.3,21.0,6.0,11.3,12.3,12.0,26.5,20.8,21.3,24.5,5.0,11.1,7.8,13.0,3.5,5.1,5.0,13.0,13.5,39.7,41.1,16.5,23.0,,,,,192.0,13.0,1.5227272727272727,1.6511627906976745,20.0,27.0
1984.0,,,,,310.0,341.0,24.0,11.5,176.0,198.0,27.0,12.5,118.0,117.0,16.0,11.5,16.0,26.0,22.0,25.0,0.0,0.0,0.0,0.0,4.5,6.0,21.0,19.5,7420.0,9.0,5.7,7.2,22.0,19.5,40.0,,,,,,,,,,272.0,55.7,61.1,25.5,14.0,312.0,21.0,21.0,14.0,15.0,20.83333333333333,24.0,,,,,,,,,,,,,70.8,70.3,12.0,20.0,2.0,6.0,8.0,5.0,3.0,2.0,5.0,7.0,2.0,1.0,13.0,18.0,7.5,6.0,16.583333333333332,20.0,11.95,9.0,15.65,20.0,8.25,5.0,26.0,2.0,0.0,0.5,16.0,,,,,21.0,4.3,2.9,25.5,16.5,0.0,0.0,15.0,23.0,13.5,65.0,48.0,4.5,11.0,1.0,0.0,12.0,3.0,1498.0,1030.0,5.0,3.0,5.5,6.3,21.0,22.0,13.416666666666664,11.5,0.0,1.0,332.0,364.0,20.0,-32.0,18.0,15.0,488.0,511.0,13.0,19.0,0.5172413793103449,0.5275665399239544,16.0,18.0,1.4915254237288136,14.0,20.0,4.1,4.7,18.0,13.5,24.0,19.0,16.0,0.5405405405405406,0.6,18.5,21.0,0.5747863247863247,0.6291771469637082,15.0,24.0,2959.0,3502.0,20.0,21.0,96.0,779.0,723.0,4.5,9.0,87.0,5.0,11.0,0.05161290322580645,0.07624633431085044,10.0,25.0,,,,,1044.0,1052.0,16.5,16.5,75.0,1.0,0.0,14.5,21.0,37.0,8.5,2975.0,2854.0,7.0,18.0,67.0,3.5,17.0,0.0,0.0,11.0,18.0,324.0,242.0,8.0,16.0,,,,,35.0,22.0,72.8,87.9,22.0,18.0,3341.0,21.0,0.6704545454545454,15.0,0.4827586206896552,0.4724334600760456,13.0,11.0,0.4594594594594594,0.4,10.5,8.0,0.4252136752136753,0.3708228530362918,14.0,5.0,504.0,497.0,14.0,11.0,17.0,16.0,19.5,10.5,2189.0,2064.0,18.0,5.0,14.949494949494948,15.0,0.0,0.0,14.5,14.5,1.0,0.0,52.0,9.6,7.9,16.0,21.0,382.0,360.0,15.0,18.5,44.0,15.5,18.0,24.0,37.0,27.0,21.5,17.0,26.0,27.0,22.5,34.0,0.0,0.0,14.5,14.5,33.0,18.5,-1.0,14.0,9.5,16.53168044077135,21.0,,,,5148.0,5566.0,21.0,16.0,100.0,97.6,18.0,6.5,39.0,41.0,18.5,13.0,39.0,40.0,19.0,11.0,6.8,7.6,22.5,19.0,4.3,4.2,20.5,6.5,12.3,12.4,11.5,18.0,23.0,21.5,22.5,1.0,9.3,6.5,7.0,8.0,4.9,5.3,24.0,15.5,39.7,42.6,26.0,22.0,,,,,-418.0,21.0,1.5813953488372092,1.8095238095238089,16.0,22.0
1985.0,,,,,344.0,276.0,6.0,4.5,201.0,154.0,4.0,4.0,121.0,85.0,4.0,10.0,22.0,37.0,27.0,17.5,0.0,0.0,0.0,0.0,6.7,4.7,13.5,1.5,7784.0,4.0,8.3,5.9,13.5,1.0,45.0,,,,,,,,,,303.0,61.0,52.7,9.0,2.0,267.0,10.0,8.0,14.0,12.0,6.916666666666668,5.0,,,,,,,,,,,,,76.5,72.0,11.0,12.5,2.0,11.0,8.0,8.0,5.0,2.0,11.0,6.0,4.0,3.0,21.0,20.0,6.5,25.0,10.333333333333334,7.0,8.025,4.0,4.8,3.0,11.25,10.0,35.0,1.0,1.0,0.6,22.5,,,,,8.0,1.6,4.3,13.0,1.0,1.0,1.0,22.0,13.0,1.0,53.0,58.0,9.0,23.5,0.0,0.0,11.5,17.0,1043.0,1135.0,6.5,27.0,6.4,5.9,15.0,5.5,5.916666666666668,4.0,0.0,0.0,393.0,264.0,3.0,129.0,3.0,7.0,497.0,507.0,13.0,20.5,0.4977738201246661,0.5621840242669363,8.0,21.0,1.6611570247933884,13.0,25.0,5.0,3.4,5.0,5.0,17.0,5.0,7.0,0.5813953488372093,0.6296296296296297,9.0,13.0,0.6078697421981004,0.6823134953897737,2.0,17.0,3584.0,3256.0,16.0,9.0,119.0,907.0,868.0,21.0,22.0,113.0,24.0,25.0,0.06395348837209303,0.13405797101449274,2.0,24.0,,,,,1123.0,989.0,3.0,4.0,74.0,0.0,0.0,14.5,9.0,36.0,8.5,2978.0,3678.0,19.0,22.0,88.0,18.0,21.0,0.0,1.0,24.5,17.5,386.0,319.0,10.0,14.0,,,,,39.0,15.5,96.3,68.9,8.5,1.0,3983.0,7.0,0.6019900497512438,16.0,0.5022261798753339,0.4378159757330637,21.0,8.0,0.41860465116279066,0.3703703703703704,20.0,16.0,0.3921302578018996,0.3176865046102263,27.0,12.0,564.0,433.0,4.0,5.0,18.0,10.0,6.0,11.5,2312.0,1516.0,3.0,7.0,15.444444444444445,18.0,0.0,0.0,14.5,14.5,1.0,0.0,62.0,11.1,8.8,10.5,26.0,399.0,370.0,11.0,20.0,49.0,11.0,26.0,34.0,25.0,6.0,6.0,26.0,18.0,7.5,4.5,29.0,0.0,0.0,14.5,14.5,42.0,7.5,13.0,2.0,1.5,8.878787878787879,2.0,,,,5896.0,4772.0,8.0,4.0,95.6,100.0,26.0,17.0,45.0,30.0,3.5,7.0,43.0,30.0,4.5,7.0,8.0,7.2,18.0,2.0,4.1,3.5,2.0,13.0,13.1,13.6,22.0,10.5,19.7,19.6,8.0,20.5,9.9,8.9,17.0,8.5,5.3,4.8,10.0,6.0,40.2,41.8,18.0,25.0,,,,,1124.0,3.0,1.951219512195122,2.0571428571428574,1.0,4.0
1986.0,,,,,319.0,349.0,27.0,8.5,191.0,216.0,28.0,6.0,104.0,92.0,4.0,13.0,24.0,41.0,27.0,16.0,0.0,0.0,0.0,0.0,5.6,6.6,25.5,9.5,7359.0,8.0,6.8,7.2,24.0,7.0,45.0,,,,,,,,,,334.0,62.2,57.7,20.0,1.0,348.0,28.0,5.0,2.0,24.5,20.08333333333333,23.0,,,,,,,,,,,,,84.2,59.3,5.0,2.0,1.0,5.0,4.0,8.0,1.0,1.0,5.0,4.0,5.0,1.0,16.0,18.0,9.5,15.0,20.375,24.0,11.39375,7.0,7.6,6.0,15.1875,15.0,37.0,0.0,0.0,0.4324324324324325,11.0,,,,,21.0,3.9,3.3,21.0,14.0,0.0,1.0,20.0,15.0,16.0,63.0,62.0,15.0,11.5,2.0,0.0,12.0,1.5,1189.0,1307.0,19.0,14.0,6.3,7.0,26.5,9.0,13.333333333333336,13.0,0.0,0.0,364.0,386.0,22.0,-22.0,17.0,11.0,537.0,603.0,27.0,12.0,0.542910447761194,0.5837187789084182,3.0,18.0,1.8365384615384608,9.0,27.0,5.0,5.8,27.0,6.5,35.0,28.0,4.5,0.627906976744186,0.7446808510638298,2.0,10.0,0.6783255813953488,0.7254545454545455,2.0,9.0,3646.0,4389.0,28.0,9.0,131.0,981.0,795.0,11.0,27.0,102.0,14.0,28.0,0.07523510971786834,0.1174785100286533,2.0,17.0,,,,,1072.0,1081.0,26.0,9.0,85.0,0.0,0.0,14.5,6.5,36.0,6.5,3353.0,2978.0,6.0,18.0,75.0,6.5,12.0,0.0,0.0,10.5,20.5,341.0,165.0,2.0,14.5,,,,,39.0,18.5,85.7,87.3,24.0,5.0,4032.0,8.0,0.5445026178010471,20.0,0.4570895522388061,0.4162812210915818,26.0,11.0,0.37209302325581395,0.25531914893617025,27.0,19.0,0.3216744186046512,0.2745454545454545,27.0,20.0,490.0,450.0,6.0,11.5,16.0,12.0,10.0,11.0,1729.0,1661.0,6.0,18.0,13.282828282828284,10.0,0.0,0.0,14.5,14.5,1.0,1.0,45.0,7.7,4.4,27.0,14.0,386.0,178.0,26.0,20.0,28.0,24.5,16.5,19.0,27.0,9.5,28.0,16.0,16.0,5.5,23.5,37.0,0.0,0.0,14.5,14.5,38.0,10.5,1.0,13.0,16.5,15.77410468319559,18.0,,,,5375.0,6050.0,26.5,11.0,100.0,100.0,25.5,5.0,44.0,48.0,26.0,7.5,44.0,48.0,26.5,4.5,7.5,7.6,24.0,8.0,3.5,3.7,8.0,24.0,12.1,13.1,20.0,21.5,18.9,21.1,23.0,22.0,8.7,4.6,1.0,10.0,5.0,5.6,26.0,13.5,39.4,39.7,9.0,24.0,,,,,-675.0,24.0,2.142857142857143,2.054054054054054,3.0,2.5
1987.0,,,,,292.0,300.0,21.0,16.0,169.0,153.0,9.5,8.0,97.0,117.0,21.0,20.0,26.0,30.0,20.5,13.0,0.0,0.0,0.0,0.0,4.5,5.7,22.5,22.0,6816.0,14.0,6.0,6.4,17.0,15.0,39.0,,,,,,,,,,302.0,58.4,53.3,10.0,5.0,260.0,12.0,5.0,14.0,14.5,19.416666666666668,22.0,,,,,,,,,,,,,76.9,69.0,18.5,10.0,0.0,12.0,8.0,5.0,1.0,0.0,12.0,6.0,2.0,0.0,19.0,11.0,26.0,21.0,17.666666666666668,24.0,14.43125,17.0,11.3,9.0,17.5625,20.5,33.0,1.0,1.0,0.5757575757575758,20.0,,,,,15.0,2.9,3.7,17.5,4.5,0.0,0.0,18.0,15.5,4.5,65.0,54.0,4.0,8.0,0.0,0.0,11.5,17.0,1221.0,1013.0,4.0,10.0,5.1,6.2,20.0,26.5,18.75,19.0,1.0,0.0,334.0,360.0,20.5,-26.0,17.0,14.0,517.0,488.0,15.0,5.5,0.5600384245917387,0.5206445115810675,16.0,6.0,1.7422680412371134,9.0,18.0,3.5,5.5,24.0,23.0,27.0,25.0,19.0,0.5142857142857142,0.6428571428571429,13.0,27.0,0.6390928725701944,0.6359849236262646,11.0,10.0,2959.0,3206.0,20.0,16.0,135.0,1055.0,881.0,20.0,26.0,96.0,9.5,27.5,0.08904109589041095,0.1,7.0,13.0,,,,,1041.0,993.0,13.0,6.0,82.0,0.0,0.0,14.5,5.5,33.0,7.0,3046.0,3072.0,18.0,15.0,80.0,19.0,10.5,2.0,0.0,10.0,1.5,497.0,162.0,3.0,4.0,,,,,42.0,9.0,77.7,78.7,17.0,9.0,3402.0,15.0,0.5739644970414202,20.0,0.4399615754082613,0.4793554884189325,13.0,23.0,0.4857142857142858,0.3571428571428571,16.0,2.0,0.3609071274298056,0.3640150763737354,18.0,19.0,458.0,476.0,17.0,21.0,17.0,15.0,18.0,5.5,1671.0,1835.0,16.0,22.0,11.550505050505052,3.0,0.0,0.0,14.5,14.5,1.0,0.0,66.0,11.3,5.6,24.0,27.0,443.0,206.0,23.0,26.5,29.0,24.0,27.0,26.0,29.0,16.0,20.0,20.0,20.0,17.0,13.5,34.0,0.0,0.0,14.5,14.5,29.0,21.0,-5.0,19.0,12.5,17.028925619834713,22.0,,,,4630.0,5041.0,19.0,20.0,100.0,97.7,21.5,6.0,38.0,43.0,21.5,14.0,38.0,42.0,22.0,11.5,6.6,7.0,14.0,21.0,3.6,3.9,15.0,23.5,11.3,13.1,19.5,27.0,18.8,18.8,12.0,19.5,11.8,4.9,1.0,2.0,4.4,5.1,19.5,28.0,37.1,38.4,10.0,27.0,,,,,-411.0,19.0,1.8333333333333333,1.794871794871795,14.0,10.0
1988.0,,,,,331.0,310.0,16.5,5.0,181.0,162.0,10.5,7.0,118.0,123.0,18.0,12.0,32.0,25.0,16.5,3.5,0.0,0.0,0.0,0.0,5.2,5.7,23.0,14.5,7355.0,11.0,6.1,6.9,25.5,13.0,43.0,,,,,,,,,,299.0,55.6,51.3,4.0,12.0,244.0,4.0,10.0,20.0,6.5,18.416666666666668,19.5,,,,,,,,,,,,,82.1,66.7,9.5,5.0,0.0,9.0,8.0,10.0,1.0,0.0,9.0,7.0,7.0,0.0,16.0,16.0,10.5,19.0,11.333333333333336,7.5,10.45625,6.0,11.1,12.0,9.8125,7.0,32.0,0.0,0.0,0.5,14.5,,,,,11.0,2.0,5.0,3.0,1.0,3.0,0.0,24.0,4.5,1.0,72.0,70.0,24.0,3.0,0.0,0.0,11.0,17.5,1404.0,1491.0,26.0,6.0,5.3,6.7,26.5,23.5,10.333333333333334,7.0,0.0,0.0,372.0,354.0,21.0,18.0,12.0,6.0,538.0,476.0,7.0,8.0,0.5301645338208409,0.5019267822736031,22.0,15.0,1.5338983050847457,15.0,20.0,3.7,5.9,27.5,16.5,28.0,26.0,15.5,0.5128205128205128,0.6511627906976745,7.0,18.0,0.5911792905081495,0.6229362684182496,14.0,18.0,3083.0,3509.0,23.0,19.0,115.0,931.0,757.0,9.0,23.0,89.0,5.0,23.0,0.09667673716012083,0.08064516129032258,13.0,7.0,,,,,1094.0,1038.0,15.0,3.0,85.0,0.0,0.0,14.5,8.5,34.0,4.0,3310.0,2743.0,7.0,10.0,72.0,10.0,9.0,1.0,0.0,11.5,3.5,418.0,201.0,1.0,6.0,,,,,38.0,15.0,78.4,76.9,20.0,10.0,3374.0,18.0,0.6519337016574586,14.0,0.4698354661791591,0.4980732177263969,7.0,14.0,0.4871794871794872,0.34883720930232553,22.0,11.0,0.4088207094918505,0.3770637315817504,15.0,11.0,514.0,517.0,22.0,9.0,19.0,15.0,14.5,6.0,2132.0,2124.0,21.0,8.0,10.611111111111109,3.0,0.0,0.0,14.5,14.5,1.0,0.0,42.0,7.2,8.6,3.0,16.0,291.0,314.0,9.0,16.0,45.0,6.0,17.5,28.0,30.0,18.5,16.5,23.0,20.0,12.5,11.0,27.0,0.0,0.0,14.5,14.5,40.0,5.5,13.0,3.0,4.0,13.34848484848485,11.0,,,,5215.0,5633.0,23.0,13.0,100.0,83.7,1.0,4.0,43.0,43.0,22.0,6.5,43.0,36.0,15.0,5.0,6.3,8.0,28.0,23.0,4.1,4.1,18.0,10.5,11.3,15.7,28.0,26.5,19.5,21.3,21.5,18.0,11.0,5.9,4.0,3.0,4.8,5.4,26.0,21.0,38.9,38.1,4.0,22.0,,,,,-418.0,21.5,1.5365853658536586,1.951219512195122,4.0,24.0
1989.0,,,,,292.0,328.0,23.0,17.0,189.0,178.0,18.5,6.0,91.0,127.0,26.0,22.0,12.0,23.0,15.5,28.0,0.0,0.0,0.0,0.0,4.1,7.0,26.0,24.0,7209.0,11.0,5.4,7.7,26.0,20.5,30.0,,,,,,,,,,338.0,59.3,54.9,12.0,5.0,282.0,15.0,3.0,32.0,3.5,24.33333333333333,27.0,,,,,,,,,,,,,66.7,67.7,7.0,24.5,1.0,7.0,4.0,8.0,1.0,1.0,6.0,3.0,4.0,0.0,17.0,9.0,27.0,20.5,20.166666666666668,23.0,17.3875,24.0,14.15,15.0,20.625,23.0,32.0,2.0,0.0,0.53125,17.0,,,,,24.0,4.2,2.9,24.5,18.5,2.0,2.0,15.0,25.0,21.5,75.0,47.0,3.0,4.0,0.0,0.0,11.0,19.0,1309.0,1029.0,6.0,7.0,5.4,7.1,26.0,23.5,19.666666666666668,23.5,1.0,0.0,253.0,411.0,25.0,-158.0,26.5,26.0,570.0,514.0,16.0,6.5,0.6124031007751938,0.5118035882908404,23.0,3.0,2.0769230769230766,5.0,14.0,2.5,6.0,27.0,26.5,31.0,28.0,25.0,0.56,0.6595744680851063,8.0,21.0,0.6815006984633806,0.6436436436436437,12.0,10.0,3415.0,3858.0,25.0,12.0,116.0,953.0,675.0,3.0,22.0,90.0,4.0,21.0,0.0410958904109589,0.0701219512195122,16.0,28.0,,,,,1032.0,1059.0,23.0,10.0,87.0,0.0,0.0,14.5,7.0,34.0,11.0,3426.0,2746.0,7.0,6.0,69.0,8.0,2.5,0.0,1.0,26.0,17.0,299.0,257.0,7.0,18.0,,,,,33.0,19.0,70.6,88.5,25.0,18.0,3892.0,9.0,0.4814814814814815,24.0,0.3875968992248062,0.4881964117091596,6.0,26.0,0.44,0.3404255319148937,21.0,8.0,0.31849930153661943,0.3563563563563563,17.0,19.0,400.0,517.0,24.0,24.5,11.0,16.0,19.5,21.0,1596.0,2136.0,24.0,22.0,17.50505050505051,24.0,0.0,0.0,14.5,14.5,1.0,1.0,62.0,9.8,5.2,28.0,26.0,477.0,177.0,28.0,27.0,28.0,28.0,28.0,21.0,31.0,17.5,24.5,14.0,21.0,14.5,26.5,41.0,0.0,0.0,14.5,14.5,24.0,25.0,-17.0,25.5,22.5,20.774104683195592,28.0,,,,5011.0,5994.0,27.0,17.0,96.7,92.0,2.0,20.5,30.0,50.0,26.0,22.5,29.0,46.0,24.5,22.5,6.8,7.9,25.0,18.5,4.0,4.1,20.0,12.0,11.5,14.3,25.0,27.0,17.5,21.9,26.0,24.0,9.1,7.6,4.0,13.5,4.9,5.7,26.0,18.0,39.4,39.8,11.0,22.5,,,,,-983.0,24.0,1.7,1.926829268292683,9.0,20.0
1990.0,,,,,295.0,318.0,26.0,9.5,143.0,186.0,28.0,19.0,128.0,112.0,20.0,3.0,24.0,20.0,17.5,5.0,0.0,0.0,0.0,0.0,5.2,5.6,18.0,13.5,6617.0,14.0,6.3,6.6,19.0,12.0,32.0,,,,,,,,,,246.0,54.5,60.3,26.0,18.5,311.0,26.0,18.5,8.0,22.5,22.25,25.0,,,,,,,,,,,,,88.5,75.0,13.5,3.0,2.0,12.0,7.0,5.0,0.0,2.0,12.0,6.0,3.0,0.0,13.0,11.0,22.5,8.0,18.5,22.0,11.2125,10.0,15.8,19.0,6.625,3.0,28.0,1.0,0.0,0.4642857142857143,8.0,,,,,11.0,2.4,3.5,14.0,5.0,0.0,0.0,18.0,12.5,4.5,61.0,61.0,16.0,13.0,0.0,1.0,25.5,17.0,1129.0,1185.0,17.0,15.0,5.6,6.2,18.5,20.5,12.25,13.0,0.0,0.0,295.0,345.0,17.0,-50.0,20.0,19.0,451.0,516.0,23.0,17.0,0.5077559462254395,0.5670419651995906,9.0,18.0,1.1171875,27.0,14.0,3.1,4.5,18.0,24.0,23.0,22.5,25.0,0.4666666666666667,0.6052631578947368,14.0,25.0,0.5646745804338927,0.6300641613198901,14.0,25.0,2759.0,3437.0,24.0,21.0,101.0,848.0,876.0,25.0,20.0,106.0,22.0,17.0,0.08135593220338982,0.06289308176100629,19.0,6.0,,,,,967.0,977.0,18.0,14.0,61.0,0.0,0.0,14.5,7.0,35.0,12.0,2398.0,2318.0,3.0,24.0,56.0,2.5,24.0,1.0,0.0,11.5,4.5,319.0,269.0,13.0,13.0,,,,,30.0,24.0,76.0,82.9,19.0,13.0,3059.0,21.0,0.8951048951048951,2.0,0.4922440537745605,0.4329580348004094,20.0,11.0,0.5333333333333333,0.3947368421052632,15.0,4.0,0.4353254195661073,0.3699358386801101,15.0,4.0,476.0,423.0,12.0,10.0,16.0,15.0,18.5,10.0,2127.0,2018.0,19.0,4.0,12.974747474747474,7.0,0.0,0.0,14.5,14.5,1.0,2.0,40.0,8.1,6.9,17.5,17.0,300.0,308.0,7.0,20.0,38.0,13.5,14.5,26.0,32.0,21.5,18.5,23.0,24.0,22.5,8.5,24.0,0.0,0.0,14.5,14.5,29.0,21.0,5.0,6.5,4.5,16.084022038567493,21.0,,,,4886.0,5455.0,23.0,16.0,100.0,89.7,2.0,7.0,32.0,39.0,18.0,20.5,32.0,35.0,16.0,20.0,6.8,7.3,20.0,19.0,4.5,4.8,28.0,4.0,12.4,12.0,8.5,14.0,18.5,19.4,16.0,17.0,10.6,7.7,10.0,4.0,5.1,5.6,26.0,13.5,39.3,41.4,22.0,19.5,,,,,-569.0,22.0,1.5111111111111108,1.5208333333333333,26.0,25.0
1991.0,,,,,331.0,298.0,16.0,4.0,169.0,185.0,24.0,9.0,133.0,94.0,12.0,1.0,29.0,19.0,15.0,1.5,0.0,0.0,0.0,0.0,5.3,5.5,16.5,13.0,6760.0,10.0,6.2,6.3,16.0,14.0,32.0,,,,,,,,,,295.0,58.6,61.3,25.0,12.0,331.0,26.0,8.0,18.0,9.5,12.25,9.0,,,,,,,,,,,,,69.8,68.4,6.0,19.0,3.0,19.0,12.0,7.0,2.0,3.0,15.0,10.0,2.0,0.0,13.0,19.0,5.0,8.5,12.25,9.0,8.5875,5.0,11.8,11.0,5.375,2.0,28.0,0.0,1.0,0.4642857142857143,9.0,,,,,12.0,2.4,3.3,17.5,4.5,2.0,0.0,18.0,12.0,5.5,58.0,60.0,18.5,7.0,0.0,1.0,24.5,18.5,1003.0,921.0,10.0,13.0,5.9,6.2,19.0,16.5,8.916666666666666,7.0,1.0,0.0,314.0,293.0,10.0,21.0,13.0,11.0,503.0,540.0,25.5,12.5,0.5061378659112371,0.6027253668763103,3.0,23.0,1.2706766917293233,26.0,12.0,2.4,3.9,21.0,25.0,21.0,21.5,25.0,0.4137931034482759,0.7241379310344828,4.0,28.0,0.5936794582392777,0.7104998996185505,1.0,24.0,3156.0,3539.0,24.0,12.0,103.0,814.0,774.0,14.0,19.0,93.0,10.0,19.0,0.08761329305135952,0.06375838926174497,15.5,5.0,,,,,1059.0,954.0,10.0,1.0,64.0,0.0,0.0,14.5,8.5,29.0,7.0,2521.0,2274.0,1.0,22.0,56.0,1.0,20.5,0.0,0.0,10.5,18.5,157.0,164.0,2.0,28.0,,,,,23.0,28.0,77.4,81.3,20.0,12.0,3429.0,11.0,0.7869822485207101,3.0,0.493862134088763,0.3972746331236897,26.0,6.0,0.5862068965517242,0.27586206896551724,25.0,1.0,0.4063205417607223,0.2895001003814495,28.0,5.0,523.0,379.0,3.0,2.0,17.0,8.0,7.0,6.0,2160.0,1442.0,4.0,5.0,15.050505050505052,16.0,0.0,0.0,14.5,14.5,0.0,0.0,33.0,6.2,6.1,18.0,13.0,273.0,226.0,19.0,21.5,35.0,14.0,13.0,43.0,38.0,25.0,1.5,30.0,26.0,21.5,3.0,25.0,0.0,0.0,14.5,14.5,37.0,7.5,12.0,4.0,6.5,11.801652892561982,6.0,,,,5316.0,4981.0,12.0,6.0,100.0,96.7,9.0,7.0,32.0,30.0,10.5,14.5,32.0,29.0,9.5,13.5,6.8,7.0,18.0,17.0,4.1,3.8,9.0,9.5,11.6,11.4,8.0,20.5,17.3,15.4,1.0,25.0,6.8,5.7,2.0,26.0,5.0,5.2,18.0,15.0,39.4,40.6,10.0,25.0,,,,,335.0,9.0,1.6585365853658538,1.842105263157895,8.0,23.0
1992.0,,,,,252.0,276.0,13.0,21.0,137.0,146.0,8.5,21.0,94.0,110.0,21.0,17.0,21.0,20.0,11.0,14.0,0.0,0.0,0.0,0.0,3.4,4.8,14.0,25.0,5912.0,24.0,4.3,5.7,14.0,25.5,23.0,,,,,,,,,,251.0,50.7,55.3,7.5,26.0,257.0,6.0,18.5,20.0,10.5,14.666666666666664,16.0,,,,,,,,,,,,,63.3,74.2,17.0,24.0,3.0,3.0,9.0,14.0,1.0,3.0,2.0,6.0,8.0,0.0,15.0,18.0,5.0,17.5,14.166666666666664,12.0,18.74375,25.0,21.05,27.0,16.4375,15.5,28.0,0.0,1.0,0.5357142857142857,16.0,,,,,24.0,4.8,4.5,8.5,23.0,3.0,2.0,21.0,8.5,25.0,54.0,33.0,2.0,8.5,0.0,0.0,12.0,17.0,950.0,552.0,2.0,14.0,5.0,5.9,16.5,23.5,21.08333333333333,24.0,0.0,0.0,220.0,315.0,18.0,-95.0,25.0,25.0,495.0,465.0,11.0,10.5,0.55741127348643,0.5213319458896982,20.0,11.0,1.4574468085106382,19.0,12.0,2.4,4.1,17.0,26.5,19.0,14.0,27.0,0.6,0.59375,16.0,13.5,0.6046039268788084,0.6067622950819672,19.0,19.0,2679.0,2961.0,13.0,22.0,107.0,873.0,808.0,20.0,23.0,82.0,4.0,22.0,0.08333333333333333,0.07246376811594203,15.0,8.0,,,,,958.0,961.0,15.0,13.5,73.0,0.0,0.0,14.5,9.0,26.0,7.0,2993.0,2863.0,9.0,16.0,70.0,10.5,15.5,0.0,0.0,8.0,20.5,232.0,189.0,5.0,21.0,,,,,30.0,21.0,57.2,71.6,11.0,27.0,2962.0,23.0,0.6861313868613139,10.0,0.44258872651357,0.4786680541103018,9.0,18.0,0.4,0.40625,13.0,15.5,0.3953960731211916,0.3932377049180328,10.0,10.0,424.0,460.0,18.5,17.0,8.0,13.0,16.5,21.5,1752.0,1919.0,19.0,12.0,15.464646464646465,19.0,0.0,0.0,14.5,14.5,1.0,1.0,39.0,7.3,7.2,17.0,12.0,283.0,240.0,21.0,15.5,36.0,19.5,12.0,30.0,31.0,21.5,7.5,19.0,23.0,22.0,15.5,39.0,0.0,0.0,14.5,14.5,39.0,3.5,0.0,14.0,24.0,17.217630853994493,18.0,,,,4431.0,4880.0,16.0,20.0,100.0,97.1,13.0,9.5,23.0,35.0,18.5,27.0,23.0,34.0,18.0,26.0,6.0,6.9,14.0,25.0,4.1,4.2,21.0,13.0,11.8,12.5,19.0,17.0,17.6,16.7,4.0,25.0,7.7,7.3,5.5,20.5,4.6,5.1,17.5,23.5,41.0,40.9,5.0,22.5,,,,,-449.0,18.0,1.4634146341463417,1.6428571428571428,18.0,25.0
1993.0,,,,,304.0,266.0,3.0,10.0,173.0,161.0,12.5,12.5,106.0,93.0,9.0,11.0,25.0,12.0,3.5,7.0,0.0,0.0,0.0,0.0,6.1,5.1,15.5,6.5,6325.0,20.0,6.7,5.8,13.5,8.0,31.0,,,,,,,,,,294.0,60.1,59.6,19.5,8.0,296.0,11.0,15.0,8.0,20.0,7.916666666666668,4.0,,,,,,,,,,,,,65.4,80.8,20.0,25.0,1.0,8.0,5.0,10.0,2.0,1.0,7.0,4.0,5.0,0.0,16.0,18.0,3.0,19.0,14.416666666666664,16.5,10.5625,7.0,11.25,12.0,9.875,7.0,38.0,0.0,0.0,0.42105263157894735,8.5,,,,,12.0,2.5,3.8,8.0,9.0,1.0,3.0,19.0,10.0,6.5,46.0,47.0,12.5,19.0,0.0,0.0,12.5,16.5,675.0,911.0,11.0,26.0,6.5,6.1,21.0,5.0,12.166666666666664,11.5,0.0,0.0,270.0,247.0,6.0,23.0,12.0,21.0,489.0,497.0,11.0,21.0,0.4946653734238604,0.5574288724973656,15.0,25.0,1.6320754716981132,14.0,16.0,3.3,3.0,8.5,20.0,15.0,6.0,21.0,0.5333333333333333,0.6521739130434783,13.0,23.0,0.639293937068304,0.6873938879456706,6.0,16.0,3332.0,3239.0,17.0,10.0,86.0,555.0,661.0,10.0,3.0,86.0,7.5,8.0,0.08223684210526316,0.045112781954887216,24.0,7.0,,,,,1031.0,949.0,2.0,8.0,73.0,0.0,0.0,14.5,11.0,26.0,3.0,2806.0,2858.0,4.0,24.0,66.0,3.0,19.5,0.0,0.0,9.5,19.0,256.0,156.0,2.0,25.0,,,,,31.0,25.0,82.6,74.6,12.0,7.0,3492.0,12.0,0.6127167630057804,15.0,0.5053346265761396,0.4425711275026344,14.0,4.0,0.4666666666666667,0.3478260869565217,16.0,6.0,0.3607060629316961,0.3126061120543294,23.0,13.0,521.0,420.0,9.0,3.0,14.0,8.0,9.0,4.5,1880.0,1473.0,5.0,9.0,20.16161616161616,27.0,0.0,0.0,14.5,14.5,1.0,1.0,21.0,4.1,6.0,19.5,2.0,160.0,195.0,24.0,2.0,32.0,21.5,1.0,26.0,26.0,4.0,23.5,17.0,21.0,9.0,22.0,28.0,0.0,0.0,14.5,14.5,37.0,5.5,9.0,7.0,9.0,12.801652892561982,10.0,,,,5212.0,4712.0,8.0,9.0,100.0,100.0,22.5,7.0,31.0,26.0,5.5,16.0,31.0,26.0,6.0,15.0,7.1,6.9,20.5,7.5,3.6,3.5,4.0,19.0,11.9,11.6,14.0,9.0,14.7,19.4,12.0,28.0,8.3,6.0,4.0,17.5,5.1,5.0,18.0,8.0,38.4,43.3,22.5,28.0,,,,,500.0,6.0,1.9722222222222217,1.9714285714285715,4.0,6.0
1994.0,,,,,265.0,315.0,22.0,26.0,164.0,189.0,20.0,16.5,90.0,105.0,21.0,17.5,11.0,21.0,10.5,28.0,2.0,0.0,2.0,2.0,4.7,5.7,17.5,23.5,6519.0,23.0,5.3,6.4,17.5,24.5,29.0,,,,,,,,,,310.0,57.5,63.8,27.0,16.5,333.0,20.0,12.0,18.0,10.5,17.333333333333332,19.0,,,,,,,,,,,,,87.0,77.8,10.0,4.0,0.0,8.0,7.0,8.0,0.0,0.0,8.0,6.0,6.0,0.0,10.0,21.0,2.0,8.0,14.25,13.0,16.90625,21.0,16.75,22.0,17.0625,19.0,28.0,0.0,0.0,0.35714285714285715,3.0,,,,,18.0,3.3,3.3,12.0,17.0,3.0,1.0,17.0,15.0,18.0,66.0,61.0,6.0,16.0,0.0,0.0,8.5,20.0,1282.0,1195.0,4.0,21.0,5.5,6.4,21.5,24.0,20.08333333333333,23.0,0.0,0.0,264.0,320.0,14.5,-56.0,21.0,25.0,539.0,522.0,10.0,14.0,0.5768056968463886,0.5433925049309665,19.0,14.0,1.8222222222222224,15.0,18.0,3.3,3.6,9.5,21.5,19.0,9.0,19.5,0.6923076923076923,0.5277777777777778,24.0,8.0,0.6670210503933659,0.6611090295991008,15.0,15.0,3137.0,3529.0,18.0,20.0,95.0,754.0,489.0,1.0,9.0,63.0,1.0,12.0,0.04150943396226415,0.06666666666666668,19.5,28.0,,,,,983.0,1014.0,16.0,19.0,84.0,0.0,0.0,14.5,12.5,38.0,12.0,3534.0,2672.0,3.0,9.0,62.0,2.5,8.0,0.0,0.0,9.0,20.5,345.0,260.0,5.5,14.0,,,,,39.0,15.5,72.9,83.6,19.0,21.0,3323.0,19.0,0.5487804878048781,14.0,0.4231943031536114,0.4566074950690335,10.0,15.0,0.3076923076923077,0.4722222222222222,5.0,21.0,0.3329789496066341,0.3388909704008992,14.0,14.0,416.0,463.0,19.5,22.0,8.0,17.0,26.5,23.0,1566.0,1809.0,21.0,16.0,13.232323232323234,10.0,0.0,0.0,14.5,14.5,0.0,0.0,28.0,4.9,5.3,16.5,10.0,186.0,201.0,17.0,12.0,29.0,18.5,10.5,23.0,27.0,11.5,25.5,20.0,21.0,11.5,21.0,28.0,0.0,0.0,14.5,14.5,38.0,2.5,10.0,5.0,12.5,17.214876033057852,20.0,,,,4703.0,5338.0,22.0,22.0,96.3,96.9,5.0,24.0,27.0,32.0,15.0,22.0,26.0,31.0,14.5,22.0,6.2,7.1,22.0,25.0,3.8,3.9,21.5,11.0,10.7,11.2,9.0,26.0,19.4,19.6,4.5,23.5,8.8,6.8,5.5,15.0,4.8,5.3,24.5,22.0,42.1,43.1,23.0,12.5,,,,,-635.0,25.0,1.6315789473684212,1.8205128205128205,16.0,23.0
1995.0,,,,,254.0,301.0,9.5,29.0,159.0,149.0,1.0,22.5,78.0,123.0,29.0,25.0,17.0,29.0,26.0,26.5,2.0,0.0,0.0,0.0,3.3,4.4,3.5,30.0,6353.0,30.0,4.2,5.5,6.0,30.0,26.0,,,,,,,,,,330.0,56.0,52.9,2.5,22.0,263.0,1.0,13.0,26.0,8.0,10.833333333333336,8.0,,,,,,,,,,,,,81.0,73.2,8.0,9.0,0.0,4.0,10.0,3.0,4.0,0.0,4.0,8.0,3.0,2.0,18.0,17.0,6.0,27.0,11.25,7.0,24.95,30.0,21.4,26.0,28.5,30.0,38.0,1.0,3.0,0.4736842105263158,9.0,,,,,24.0,4.1,3.4,11.0,27.0,3.0,3.0,17.0,14.0,28.5,77.0,42.0,1.0,2.0,0.0,0.0,12.5,19.0,1613.0,987.0,2.0,7.0,4.4,5.1,3.0,30.0,29.33333333333333,30.0,0.0,0.0,233.0,384.0,26.0,-151.0,30.0,30.0,589.0,497.0,2.0,11.0,0.6353646353646354,0.5065666041275797,29.0,2.0,2.0384615384615383,13.0,20.0,3.4,4.2,18.0,22.0,21.0,14.0,18.5,0.9090909090909092,0.5833333333333334,19.0,1.0,0.6855175805261864,0.5761143818334735,30.0,12.0,2788.0,2740.0,1.0,28.0,121.0,1078.0,759.0,12.0,30.0,97.0,9.0,27.5,0.06692913385826772,0.09634551495016612,4.0,19.0,,,,,1001.0,1066.0,24.0,23.0,105.0,1.0,0.0,15.5,25.0,62.0,30.0,4370.0,3493.0,24.0,1.0,85.0,23.5,1.0,0.0,0.0,11.0,20.5,323.0,737.0,30.0,15.0,,,,,38.0,10.0,65.2,71.6,7.0,27.0,3129.0,28.0,0.490566037735849,18.0,0.3646353646353646,0.4934333958724203,2.0,29.0,0.09090909090909094,0.4166666666666666,12.0,30.0,0.3144824194738136,0.4238856181665265,1.0,19.0,365.0,526.0,30.0,28.0,2.0,15.0,22.0,30.0,1279.0,2016.0,25.0,30.0,17.656565656565657,21.0,0.0,0.0,15.5,15.5,1.0,1.0,47.0,7.4,8.0,2.0,23.0,341.0,315.0,5.0,27.0,43.0,6.5,26.0,21.0,41.0,26.5,30.0,17.0,30.0,26.0,29.5,42.0,0.0,0.0,15.5,15.5,34.0,10.0,-8.0,28.5,29.0,19.421487603305785,25.0,,,,4067.0,4756.0,6.0,30.0,100.0,97.6,11.5,9.5,24.0,41.0,25.5,29.0,24.0,40.0,25.0,29.0,5.3,6.1,4.0,30.0,3.5,3.8,10.5,28.0,9.5,11.6,14.5,30.0,20.9,23.5,25.0,19.5,8.5,11.9,27.0,20.5,4.1,4.5,3.0,30.0,41.6,41.1,8.0,17.5,,,,,-689.0,25.0,1.5142857142857142,1.6052631578947367,24.0,26.0
1996.0,,,,,319.0,304.0,16.0,7.5,191.0,157.0,6.0,8.0,94.0,119.0,27.0,17.5,34.0,28.0,22.5,3.0,6.0,0.0,2.0,1.0,4.1,7.3,29.0,27.0,7123.0,16.0,4.8,8.1,29.0,28.0,33.0,,,,,,,,,,339.0,53.9,56.4,12.0,26.5,257.0,1.0,5.0,18.0,14.0,24.58333333333333,28.0,,,,,,,,,,,,,70.8,82.1,18.5,27.5,0.0,9.0,7.0,8.0,0.0,0.0,9.0,6.0,2.0,0.0,16.0,15.0,6.0,28.0,23.58333333333333,29.0,18.35625,25.0,14.15,16.0,22.5625,25.0,25.0,1.0,0.0,0.64,29.0,,,,,30.0,4.8,2.4,25.5,27.5,2.0,2.0,11.0,28.0,29.5,79.0,58.0,10.5,3.0,0.0,1.0,26.0,19.5,1504.0,1485.0,18.0,8.0,5.4,7.0,28.5,24.5,18.83333333333333,23.0,0.0,0.0,279.0,454.0,29.0,-175.0,30.0,27.0,629.0,456.0,1.0,1.0,0.6220984215413184,0.4731182795698925,30.0,2.0,2.0319148936170213,6.0,22.0,3.5,7.2,30.0,18.5,33.0,30.0,13.5,0.7333333333333333,0.6346153846153846,13.0,9.0,0.6960445468509985,0.6046010064701653,28.0,7.0,3625.0,3364.0,19.0,10.0,110.0,819.0,902.0,24.0,13.0,107.0,20.5,19.5,0.10658307210031348,0.09210526315789473,12.0,3.0,,,,,1077.0,1023.0,17.0,5.0,74.0,0.0,0.0,15.5,10.5,40.0,19.5,3293.0,3157.0,13.0,15.0,75.0,15.5,19.0,0.0,0.0,10.0,20.0,139.0,429.0,20.0,30.0,,,,,28.0,28.0,64.7,95.5,29.0,28.0,3911.0,7.0,0.4921465968586388,25.0,0.3779015784586816,0.5268817204301075,1.0,29.0,0.2666666666666667,0.3653846153846154,18.0,22.0,0.3039554531490015,0.39539899352983465,3.0,24.0,407.0,539.0,30.0,26.0,8.0,19.0,28.0,25.0,1583.0,2200.0,29.0,23.0,21.671717171717173,29.0,0.0,0.0,15.5,15.5,0.0,1.0,41.0,6.1,5.8,19.0,13.0,286.0,178.0,28.5,24.0,28.0,29.5,20.0,24.0,28.0,11.5,28.5,17.0,23.0,12.5,28.5,46.0,0.0,0.0,15.5,15.5,26.0,23.0,-20.0,30.0,30.0,21.698347107438018,29.0,,,,5208.0,5564.0,27.0,11.0,96.3,98.1,11.0,25.0,27.0,52.0,30.0,23.5,26.0,51.0,30.0,25.5,6.2,7.8,29.0,24.5,3.9,4.1,24.0,13.0,11.5,13.8,30.0,17.0,19.0,25.6,30.0,29.0,5.0,10.7,17.0,30.0,4.8,5.4,28.0,19.5,44.5,42.1,10.5,8.0,,,,,-356.0,21.0,1.58974358974359,1.9024390243902445,7.0,23.0
1997.0,,,,,291.0,301.0,22.0,18.0,173.0,177.0,19.0,11.5,97.0,103.0,18.0,16.0,21.0,21.0,12.0,21.5,2.0,0.0,0.0,2.0,5.2,5.2,16.0,16.5,6995.0,20.0,6.2,5.9,12.5,14.0,38.0,,,,,,,,,,319.0,56.6,54.5,11.5,13.0,304.0,20.0,7.5,30.0,7.0,18.33333333333333,23.0,,,,,,,,,,,,,68.3,66.7,2.0,26.0,1.0,11.0,17.0,6.0,6.0,1.0,10.0,11.0,2.0,4.0,12.0,7.0,28.5,15.0,16.833333333333332,16.0,16.175,21.0,11.1,12.0,21.25,23.0,27.0,0.0,1.0,0.4444444444444444,14.0,,,,,10.0,1.8,3.2,10.0,2.0,4.0,0.0,18.0,9.0,4.0,54.0,54.0,9.5,23.0,2.0,0.0,9.5,1.5,1236.0,1134.0,5.0,22.0,5.3,5.8,17.0,22.5,18.5,19.0,1.0,0.0,348.0,287.0,6.5,61.0,9.0,12.0,564.0,558.0,26.0,8.0,0.5867689357622243,0.5553453169347209,17.0,6.0,1.7835051546391754,17.0,20.0,3.5,4.1,15.5,18.5,23.0,19.5,15.5,0.6666666666666666,0.71875,5.5,10.0,0.6858472604188703,0.6430451127819549,15.0,7.0,3242.0,3421.0,19.0,16.0,83.0,678.0,832.0,15.0,3.0,99.0,13.5,3.0,0.07216494845360824,0.06976744186046513,19.0,22.0,,,,,1043.0,1057.0,23.0,8.5,75.0,1.0,0.0,15.5,23.0,47.0,22.0,3255.0,3864.0,25.0,22.0,92.0,24.5,23.5,1.0,0.0,10.0,7.0,674.0,459.0,22.0,1.0,,,,,59.0,1.0,79.9,75.1,11.5,13.0,3555.0,15.0,0.5606936416184971,14.0,0.4132310642377757,0.4446546830652791,14.0,25.0,0.33333333333333337,0.28125,25.5,21.0,0.3141527395811297,0.35695488721804514,16.0,24.0,431.0,470.0,19.5,20.0,10.0,9.0,4.5,20.5,1485.0,1899.0,21.0,25.0,12.08080808080808,8.0,0.0,0.0,15.5,15.5,0.0,2.0,48.0,7.8,4.9,29.0,20.5,313.0,242.0,22.0,20.5,29.0,29.0,23.0,41.0,27.0,9.5,1.5,28.0,18.0,5.5,6.0,22.0,0.0,0.0,15.5,15.5,25.0,23.0,3.0,12.5,8.5,16.68870523415978,18.0,,,,4727.0,5320.0,24.0,22.0,100.0,96.4,6.0,11.0,36.0,28.0,6.0,11.5,36.0,27.0,5.0,11.0,6.3,6.6,12.5,23.0,3.4,4.0,17.5,28.0,11.1,12.0,16.0,24.5,22.9,21.0,9.0,10.0,11.4,9.8,16.0,7.5,4.5,5.0,17.5,24.5,43.4,42.0,10.0,11.0,,,,,-593.0,26.0,1.8529411764705883,1.65,19.5,8.0
1998.0,210.0,209.0,25.0,6.0,338.0,263.0,5.0,3.0,207.0,150.0,6.5,4.0,99.0,87.0,12.0,12.0,32.0,26.0,12.0,5.5,3.0,0.0,0.0,0.0,7.0,4.2,2.0,3.5,7597.0,6.0,7.7,4.9,2.0,5.5,49.0,164.0,140.0,3.0,0.1999999999999993,13.0,31.3,31.1,16.0,13.5,318.0,59.8,52.4,4.5,4.0,285.0,13.0,6.0,26.0,7.0,8.25,6.0,,,,,,,,,,,,,71.4,80.0,14.5,24.0,0.0,9.0,13.0,10.0,3.0,0.0,9.0,9.0,6.0,1.0,11.0,9.0,19.5,13.5,12.416666666666664,8.0,8.51875,6.0,4.1,2.5,12.9375,12.0,23.0,2.0,0.0,0.4782608695652174,16.0,9.06129476584022,5.0,7.0,5.0,13.0,2.4,3.9,6.0,4.0,1.0,2.0,21.0,5.5,6.0,57.0,60.0,13.5,23.0,0.0,0.0,9.5,22.5,1285.0,1370.0,18.0,22.0,6.9,5.2,1.5,6.0,7.916666666666668,7.0,1.0,0.0,416.0,266.0,2.0,150.0,5.0,5.0,532.0,544.0,22.0,14.0,0.5269631031220435,0.5918367346938775,8.0,23.0,2.090909090909091,9.0,33.0,6.2,2.9,1.0,5.0,16.0,2.0,3.5,0.7333333333333333,0.5925925925925926,20.0,6.0,0.6712160979877515,0.6469461587571824,16.0,11.0,3836.0,3040.0,9.0,4.0,85.0,651.0,967.0,22.5,2.0,109.0,13.5,3.0,0.09467455621301776,0.0988593155893536,10.0,15.0,5.8,5.3,9.5,3.0,1057.0,980.0,7.5,4.0,65.0,0.0,0.0,15.5,11.5,30.0,5.5,2637.0,3587.0,18.0,29.0,85.0,19.0,28.5,0.0,1.0,22.5,21.0,315.0,309.0,8.0,20.0,2.03,1.35,3.0,5.0,43.0,10.0,94.0,64.7,2.0,3.0,4032.0,4.0,0.4782608695652174,22.0,0.4730368968779565,0.4081632653061225,23.0,8.0,0.2666666666666667,0.4074074074074073,11.0,25.0,0.3287839020122485,0.3530538412428176,15.0,20.0,500.0,400.0,7.0,5.0,12.0,11.0,12.0,13.5,1879.0,1659.0,14.0,13.0,19.227272727272727,26.0,36.7,25.8,2.5,6.0,1.0,0.0,25.0,4.5,6.2,25.0,4.5,196.0,259.0,14.5,8.0,36.0,23.5,5.0,35.0,25.0,5.0,5.0,25.0,20.0,7.0,12.0,24.0,14.3,15.8,10.0,15.5,30.0,14.0,6.0,10.0,9.5,11.122589531680438,5.0,34440.0,29260.0,2.0,5715.0,4699.0,7.0,4.0,97.8,96.3,7.0,20.0,46.0,27.0,3.0,5.0,45.0,26.0,3.0,5.5,7.6,6.1,1.0,6.0,3.8,4.1,20.0,20.0,12.7,11.6,11.0,7.5,22.5,22.8,19.0,15.0,7.3,10.3,17.5,27.0,5.4,4.8,6.5,6.5,40.6,42.2,5.5,29.0,30.2,24.4,6.0,5.0,1016.0,5.0,2.0,1.4878048780487805,27.0,3.0
1999.0,191.0,194.0,11.0,23.0,268.0,299.0,17.0,25.0,139.0,180.0,18.0,27.5,111.0,97.0,20.0,6.0,18.0,22.0,12.0,27.0,4.0,0.0,0.0,0.0,4.9,4.9,13.5,19.5,6832.0,23.0,5.7,5.4,10.0,18.0,33.0,154.0,145.0,9.0,4.800000000000002,2.0,33.6,28.8,4.5,2.0,272.0,57.1,55.6,10.0,17.0,319.0,20.5,27.0,26.0,8.5,16.416666666666668,16.0,,,,,,,,,,,,,81.8,83.9,25.0,14.0,0.0,4.0,17.0,12.0,0.0,0.0,3.0,17.0,7.0,0.0,6.0,11.0,19.0,1.0,15.333333333333336,15.0,16.125,17.0,19.0,22.5,13.25,13.0,22.0,1.0,1.0,0.2727272727272727,1.0,14.601239669421489,14.0,12.5,10.0,16.0,3.4,4.2,7.0,19.0,3.0,0.0,24.0,7.0,12.5,67.0,63.0,14.0,14.5,0.0,0.0,11.0,21.0,1571.0,1589.0,26.0,8.0,5.4,6.1,22.5,23.5,18.25,19.0,0.0,0.0,308.0,309.0,9.0,-1.0,17.5,19.0,476.0,574.0,23.5,29.0,0.5135135135135135,0.5825242718446602,13.0,28.0,1.2522522522522523,30.0,22.0,4.6,2.8,3.0,7.5,16.0,3.0,12.5,0.7586206896551724,0.5,30.0,5.0,0.5873316498316499,0.6833984011898122,12.0,29.0,2791.0,3676.0,24.0,28.0,87.0,771.0,685.0,1.0,6.0,76.0,1.0,4.0,0.06716417910447761,0.07357859531772576,23.0,24.0,5.4,5.5,23.5,16.0,999.0,1030.0,19.0,20.5,82.0,0.0,0.0,16.0,12.5,47.0,27.0,3693.0,3190.0,12.0,12.0,78.0,11.5,18.0,0.0,0.0,9.5,22.5,319.0,427.0,24.0,23.0,1.49,1.56,17.0,17.5,43.0,10.5,77.4,68.3,6.0,14.0,3001.0,28.0,0.7985611510791367,2.0,0.4864864864864865,0.41747572815533984,19.0,4.0,0.2413793103448276,0.5,2.0,27.0,0.4126683501683501,0.3166015988101878,20.0,3.0,486.0,430.0,15.0,8.0,7.0,16.0,26.0,27.5,1961.0,1703.0,17.0,11.0,15.020202020202019,13.0,29.3,29.9,20.0,14.0,1.0,0.0,37.0,7.2,4.3,31.0,18.0,210.0,184.0,29.0,7.0,26.0,30.0,13.0,33.0,31.0,16.5,11.0,27.0,26.0,21.5,8.5,22.0,10.5,18.0,6.0,3.0,35.0,8.0,13.0,3.0,3.0,16.702479338842974,20.0,29414.0,28130.0,13.0,4752.0,5379.0,21.0,25.0,93.1,100.0,21.5,31.0,29.0,33.0,15.0,20.0,27.0,33.0,15.5,24.0,6.3,6.7,14.5,23.0,4.0,4.0,21.0,14.0,11.0,12.1,19.0,24.0,23.4,25.2,31.0,6.5,7.4,9.1,15.0,26.5,4.8,5.2,21.0,21.5,45.0,40.9,7.5,4.0,24.7,27.6,22.0,19.0,-627.0,27.0,1.575,1.675,21.0,25.0
2000.0,205.0,202.0,28.5,2.0,308.0,267.0,7.0,13.5,192.0,152.0,6.0,11.0,84.0,98.0,17.0,24.5,32.0,17.0,3.5,6.5,3.0,0.0,2.0,1.0,4.7,4.2,7.5,18.5,7323.0,14.0,5.0,5.0,7.0,23.5,36.0,143.0,142.0,25.0,2.000000000000004,7.0,33.2,31.2,16.0,6.0,352.0,55.3,51.3,1.0,26.0,265.0,5.0,5.0,6.0,24.0,9.75,10.0,-83.24,-9.72,54.67,9.0,17.0,-66.9,47.94,11.0,24.0,111.46,8.0,20.0,67.6,85.3,24.5,28.5,1.0,9.0,8.0,13.0,3.0,1.0,8.0,6.0,7.0,1.0,11.0,14.0,11.5,10.5,14.833333333333336,14.5,16.81875,20.0,12.2,13.0,21.4375,23.0,18.0,0.0,1.0,0.6111111111111112,25.0,15.010192837465565,17.0,14.3,14.0,29.0,4.6,4.1,6.5,29.0,1.0,4.0,21.0,7.0,30.0,74.0,62.0,10.5,8.0,1.0,0.0,10.5,7.5,1552.0,1424.0,13.0,9.0,6.0,5.3,6.5,12.5,18.5,19.0,0.0,0.0,321.0,321.0,13.0,0.0,19.0,17.5,637.0,517.0,11.0,1.0,0.6111627906976744,0.5392061955469506,24.0,7.0,2.2857142857142856,5.0,23.0,3.6,3.3,9.0,17.5,17.0,9.5,8.0,0.6764705882352942,0.6538461538461539,10.0,11.0,0.7273401297497682,0.6082987551867219,27.0,5.0,3924.0,2932.0,6.0,6.0,76.0,626.0,832.0,14.0,1.0,100.0,12.0,1.0,0.1038961038961039,0.06367041198501873,27.0,7.0,5.4,5.3,10.5,21.5,1075.0,1033.0,22.0,4.0,83.0,0.0,0.0,16.0,10.0,42.0,23.0,3714.0,3520.0,20.0,8.0,88.0,24.0,14.0,0.0,2.0,29.5,22.5,276.0,660.0,29.0,25.0,1.5,1.37,9.0,21.0,38.0,13.0,67.5,64.3,4.0,23.0,4023.0,6.0,0.4375,27.0,0.3888372093023256,0.4607938044530494,8.0,25.0,0.32352941176470584,0.3461538461538461,22.0,21.0,0.2726598702502317,0.3917012448132781,5.0,27.0,418.0,476.0,25.0,19.0,11.0,9.0,7.5,21.5,1471.0,1888.0,23.0,24.0,19.97474747474748,24.0,27.8,27.7,11.0,22.0,0.0,1.0,20.0,3.0,7.2,13.0,1.0,99.0,234.0,19.0,1.0,40.0,15.5,1.5,34.0,34.0,27.5,7.0,23.0,29.0,26.5,19.0,40.0,19.0,16.3,11.0,28.0,35.0,9.0,-5.0,20.5,29.0,15.72038567493113,17.0,29315.0,28684.0,14.0,5395.0,4820.0,10.5,12.0,100.0,100.0,19.5,12.5,32.0,32.0,13.0,17.5,32.0,32.0,13.0,17.0,6.3,6.1,6.0,19.0,3.5,4.0,12.5,26.5,11.4,11.9,22.0,15.5,21.0,23.0,23.0,22.0,7.3,15.7,31.0,27.0,5.0,4.7,8.0,15.0,44.7,40.0,4.5,5.0,26.3,23.9,7.0,17.0,575.0,11.0,1.8,1.525,25.0,7.5
2001.0,176.0,182.0,5.5,31.0,274.0,284.0,13.5,24.5,151.0,155.0,6.0,24.0,105.0,116.0,28.0,8.0,18.0,13.0,2.0,26.0,2.0,0.0,0.0,1.0,5.1,4.3,5.0,16.5,6439.0,29.0,5.6,4.9,3.5,22.0,34.0,159.0,162.0,8.5,4.899999999999999,2.0,34.4,29.5,5.0,1.0,272.0,58.6,60.7,24.0,17.0,313.0,20.0,28.0,36.0,2.0,13.75,16.0,-14.32,6.05,37.42,11.0,11.0,-12.71,3.51,28.0,6.0,47.55,16.0,8.0,77.4,81.5,23.0,18.0,1.0,8.0,7.0,9.0,6.0,1.0,8.0,5.0,7.0,3.0,7.0,19.0,2.0,1.5,13.333333333333336,12.0,14.29375,12.0,20.15,26.0,8.4375,4.0,22.0,2.0,2.0,0.3181818181818182,1.0,13.823140495867767,13.0,12.2,12.0,14.0,3.0,3.9,8.5,12.0,2.0,1.0,20.0,10.0,8.5,56.0,63.0,11.5,25.0,0.0,0.0,11.5,20.0,1196.0,1355.0,16.0,23.0,5.7,5.5,8.5,17.0,14.75,12.0,2.0,0.0,308.0,295.0,12.0,13.0,12.0,17.0,464.0,516.0,15.0,26.0,0.5204741379310345,0.5330097087378641,23.0,26.0,1.4380952380952379,27.0,17.0,3.7,2.7,5.5,16.5,14.0,4.5,22.5,0.6071428571428571,0.4827586206896552,29.0,21.0,0.5716371220020855,0.5819910731612653,31.0,28.0,2741.0,2999.0,7.0,29.0,62.0,507.0,700.0,8.0,1.0,85.0,7.5,1.0,0.06569343065693431,0.045774647887323945,30.0,25.0,5.5,5.8,28.0,13.0,928.0,1030.0,26.0,31.0,76.0,0.0,0.0,16.0,12.0,34.0,11.0,2966.0,3053.0,7.0,27.0,75.0,10.5,20.5,0.0,1.0,25.5,21.5,323.0,446.0,22.0,21.0,1.52,1.48,15.0,16.5,34.0,19.5,76.4,71.1,10.0,20.0,2871.0,29.0,0.6953642384105961,5.0,0.4795258620689655,0.4669902912621359,9.0,6.0,0.3928571428571429,0.5172413793103448,3.0,11.0,0.4283628779979145,0.4180089268387347,1.0,4.0,445.0,481.0,25.5,14.0,11.0,15.0,24.0,16.5,2054.0,2154.0,28.0,4.0,18.63636363636364,23.0,29.5,28.0,14.0,16.0,0.0,1.0,19.0,3.9,6.0,22.0,2.0,130.0,171.0,27.0,3.0,33.0,22.0,2.0,31.0,27.0,6.0,15.0,24.0,22.0,9.5,14.5,21.0,10.8,20.9,1.0,4.5,39.0,3.0,18.0,1.0,3.0,15.446280991735534,14.0,27984.0,29484.0,24.0,4795.0,5153.0,19.0,24.0,100.0,90.0,1.0,8.0,32.0,30.0,12.0,15.0,32.0,27.0,8.5,14.5,6.2,6.1,4.0,26.0,4.6,4.5,26.5,3.0,10.6,10.1,1.0,25.5,21.4,21.5,15.5,16.0,9.5,13.1,29.0,15.0,5.2,5.0,16.5,9.5,39.0,40.7,6.0,29.0,27.0,28.1,21.0,12.5,-358.0,22.0,1.347826086956522,1.3555555555555554,29.5,31.0
2002.0,169.0,165.0,1.0,32.0,300.0,313.0,19.0,21.0,190.0,178.0,17.0,11.0,86.0,116.0,26.5,26.0,24.0,19.0,3.0,19.0,3.0,0.0,3.0,1.0,6.7,5.4,19.0,3.0,7415.0,17.0,7.6,6.1,17.0,3.0,41.0,164.0,181.0,7.5,1.6999999999999993,10.5,32.0,30.3,10.0,13.5,329.0,67.8,65.2,31.0,1.0,359.0,27.0,16.0,0.0,31.5,22.41666666666667,25.0,55.22,88.61,-37.28,22.0,4.0,-27.62,-24.29,30.0,15.0,-46.65,25.0,6.0,77.4,83.9,25.0,18.5,0.0,9.0,11.0,10.0,1.0,0.0,9.0,9.0,6.0,0.0,9.0,8.0,28.0,8.0,21.58333333333333,27.5,15.1,19.0,9.45,7.0,20.75,21.0,16.0,0.0,1.0,0.5625,27.0,16.97823691460055,17.0,17.4,18.0,10.0,2.1,2.7,21.0,6.0,0.0,1.0,15.0,20.5,3.5,72.0,74.0,22.0,13.5,2.0,1.0,24.0,2.5,1713.0,1574.0,19.0,8.0,6.6,6.0,22.5,5.5,15.166666666666664,15.0,0.0,0.0,359.0,336.0,14.0,23.0,16.0,15.0,485.0,551.0,19.0,24.0,0.5637949836423118,0.5763888888888888,14.0,17.0,2.2093023255813957,5.0,25.0,5.2,3.1,4.5,2.0,17.0,5.5,10.0,0.6756756756756757,0.5,29.5,11.0,0.6787132644956314,0.6388431264872779,17.0,10.0,3418.0,3490.0,21.0,17.0,79.0,685.0,809.0,9.0,2.5,99.0,9.5,3.0,0.08,0.06070287539936103,31.0,19.0,5.6,6.3,31.5,16.0,917.0,1008.0,17.0,32.0,64.0,0.0,0.0,16.5,7.5,33.0,14.0,2612.0,2499.0,2.0,26.0,62.0,2.0,27.0,2.0,0.0,10.5,3.5,464.0,203.0,6.0,5.0,1.96,1.92,25.0,9.0,29.0,25.0,98.3,83.2,21.0,1.0,3619.0,17.0,0.4526315789473685,28.0,0.43620501635768816,0.4236111111111112,19.0,16.0,0.32432432432432434,0.5,3.5,22.0,0.3212867355043686,0.361156873512722,16.0,23.0,400.0,427.0,13.0,27.0,12.0,17.0,24.5,19.0,1618.0,1973.0,18.0,22.0,10.595959595959595,2.0,36.1,36.4,26.5,7.0,0.0,0.0,32.0,6.2,5.2,26.0,16.5,201.0,195.0,26.5,12.0,30.0,26.0,11.0,31.0,31.0,19.5,13.5,24.0,26.0,24.0,14.5,19.0,10.7,12.7,23.0,5.5,23.0,27.5,4.0,11.5,4.5,16.556473829201103,16.0,27716.0,29865.0,26.0,5036.0,5463.0,24.0,22.0,94.6,97.1,7.0,28.5,37.0,35.0,14.5,13.5,35.0,34.0,14.0,17.0,7.5,6.7,18.5,4.0,4.0,4.6,27.5,23.0,11.0,10.3,2.5,21.5,23.8,21.3,9.0,5.0,16.0,6.2,6.5,1.0,5.5,5.4,25.5,6.0,40.8,40.3,12.5,19.5,29.8,33.1,30.5,11.0,-427.0,23.0,1.875,1.456521739130435,26.0,3.0
2003.0,170.0,168.0,1.0,32.0,274.0,316.0,23.5,22.0,181.0,168.0,17.0,9.5,78.0,134.0,32.0,30.0,15.0,14.0,1.0,31.5,5.0,0.0,1.0,1.0,5.9,5.7,23.0,9.0,6943.0,20.0,6.6,6.7,24.5,8.5,29.0,161.0,188.0,7.0,-1.3000000000000007,24.0,30.4,31.7,17.0,23.0,312.0,62.9,61.8,27.0,5.0,281.0,6.0,14.0,2.0,31.5,20.75,23.0,-5.4,31.25,-28.28,21.0,13.0,-26.65,-9.82,28.0,18.0,-28.62,25.0,13.0,84.4,74.1,8.0,10.0,0.0,5.0,15.0,8.0,4.0,0.0,5.0,15.0,7.0,0.0,6.0,9.0,26.0,3.0,20.916666666666668,25.0,16.66875,19.0,10.4,12.0,22.9375,24.5,18.0,0.0,0.0,0.3333333333333333,4.0,19.05137741046832,21.0,21.1,23.0,14.0,2.8,2.4,28.0,9.0,0.0,2.0,11.0,29.0,8.5,60.0,71.0,20.5,26.5,1.0,0.0,11.5,7.0,1461.0,1496.0,20.0,17.0,6.3,6.2,24.5,8.0,15.416666666666664,14.0,0.0,0.0,283.0,299.0,8.0,-16.0,18.0,23.5,496.0,455.0,2.0,24.0,0.563034188034188,0.4748062015503876,32.0,12.0,2.3205128205128207,2.0,20.0,4.0,3.1,5.5,14.5,14.0,4.0,15.0,0.7142857142857143,0.4516129032258064,31.0,8.0,0.6697636841042214,0.5687159240458732,32.0,10.0,3316.0,3025.0,10.0,13.0,69.0,550.0,620.0,1.0,1.0,79.0,2.0,1.0,0.05474452554744527,0.04430379746835443,32.0,30.0,5.7,6.3,32.0,6.5,936.0,1032.0,22.0,30.0,72.0,1.0,0.0,16.5,22.5,22.0,1.0,2692.0,2521.0,1.0,28.0,66.0,2.0,22.5,0.0,1.0,23.5,22.5,332.0,322.0,16.0,18.0,1.63,1.65,16.5,13.0,30.0,29.5,85.8,83.4,24.0,9.0,3524.0,14.0,0.4309392265193371,31.0,0.436965811965812,0.5251937984496124,1.0,21.0,0.2857142857142857,0.5483870967741935,2.0,25.0,0.3302363158957786,0.4312840759541268,1.0,23.0,409.0,542.0,31.0,29.0,8.0,17.0,24.5,27.0,1635.0,2294.0,28.0,25.0,14.12121212121212,9.0,32.4,30.4,18.0,12.0,1.0,0.0,31.0,5.9,7.1,6.5,13.0,208.0,218.0,16.0,15.0,35.0,18.0,12.5,32.0,27.0,11.5,12.0,27.0,20.0,8.0,7.0,20.0,11.8,11.9,23.0,7.0,20.0,29.5,0.0,15.5,2.5,17.002754820936634,20.0,27370.0,31584.0,26.0,4951.0,5319.0,21.0,19.0,100.0,100.0,23.0,8.5,24.0,33.0,12.5,29.0,24.0,33.0,14.5,28.5,7.1,7.1,26.0,7.0,4.0,4.2,18.0,17.5,11.3,11.5,21.0,19.0,24.4,21.1,12.5,2.0,11.1,14.6,31.0,10.5,5.3,5.2,20.0,10.5,37.4,38.2,2.5,32.0,29.0,31.4,31.0,12.5,-368.0,22.0,1.775,1.6904761904761902,12.0,8.0
2004.0,174.0,178.0,6.0,31.0,313.0,282.0,8.5,10.0,163.0,169.0,14.0,20.0,135.0,87.0,8.0,2.0,15.0,26.0,13.5,32.0,4.0,0.0,0.0,1.0,6.3,5.4,16.5,10.0,7001.0,21.0,7.1,6.2,16.0,10.5,38.0,179.0,155.0,2.0,0.8999999999999986,10.0,30.4,29.5,6.5,21.5,282.0,64.4,58.1,10.0,5.0,289.0,10.0,25.0,18.0,13.0,8.416666666666666,6.0,47.76,24.02,-22.71,16.0,15.0,33.71,70.85,4.0,3.0,55.74,10.0,10.0,82.8,84.2,18.0,12.5,0.0,10.0,6.0,11.0,2.0,0.0,9.0,4.0,10.0,1.0,5.0,14.0,7.5,1.0,12.75,8.0,10.14375,6.0,15.6,16.0,4.6875,2.0,19.0,1.0,0.0,0.2631578947368421,1.0,8.24435261707989,2.0,5.8,2.0,11.0,2.5,3.8,8.0,7.0,2.0,0.0,19.0,10.5,4.5,46.0,72.0,20.0,32.0,1.0,1.0,24.0,8.5,1038.0,1557.0,19.0,32.0,6.5,6.2,18.5,11.0,9.416666666666666,7.0,0.0,0.0,333.0,261.0,4.0,72.0,8.0,17.0,438.0,497.0,10.5,30.0,0.4708835341365462,0.5527950310559007,16.0,30.0,1.2074074074074077,30.0,19.0,4.3,4.2,14.0,16.0,21.0,15.5,21.5,0.5588235294117647,0.7241379310344828,5.5,23.0,0.5608679661640309,0.6789667896678967,6.0,29.0,3050.0,3312.0,14.0,22.0,91.0,693.0,720.0,1.0,2.0,86.0,1.0,2.0,0.04792332268370607,0.09219858156028367,21.0,32.0,5.9,5.5,17.5,5.0,996.0,966.0,6.0,16.5,80.0,0.0,0.0,16.5,12.0,34.0,13.5,3057.0,3569.0,23.0,22.0,89.0,25.5,13.0,0.0,0.0,12.0,20.5,313.0,221.0,5.5,18.0,1.78,1.41,11.5,12.0,41.0,11.5,90.5,78.3,14.5,9.0,3231.0,22.0,0.8282208588957055,3.0,0.5291164658634537,0.4472049689440993,17.0,3.0,0.4411764705882353,0.27586206896551724,27.5,10.0,0.4391320338359691,0.3210332103321033,27.0,4.0,527.0,432.0,11.0,3.0,15.0,8.0,6.0,10.0,2388.0,1566.0,5.0,3.0,15.414141414141413,13.5,33.3,25.3,5.0,10.0,0.0,1.0,31.0,6.6,6.9,16.5,14.0,181.0,220.0,21.5,9.0,37.0,18.5,7.5,29.0,19.0,3.0,9.0,24.0,16.0,2.5,10.5,16.0,8.6,16.9,8.5,1.0,33.0,9.0,17.0,2.0,1.0,10.68870523415978,2.0,31146.0,27590.0,3.0,5438.0,4878.0,7.0,12.0,97.1,100.0,21.5,28.0,34.0,29.0,8.0,17.5,33.0,29.0,8.5,18.5,7.4,7.1,19.5,12.5,4.5,3.6,3.5,5.5,11.5,12.2,25.5,20.5,22.6,21.6,15.5,10.5,7.6,6.5,5.5,23.0,5.5,5.0,10.0,10.0,38.2,40.1,3.5,32.0,31.2,27.3,12.0,8.0,560.0,6.0,1.6444444444444446,1.9722222222222217,3.0,22.0
2005.0,168.0,184.0,12.5,31.0,251.0,321.0,28.0,28.0,146.0,151.0,5.0,27.0,74.0,136.0,31.0,27.0,31.0,34.0,27.5,11.0,1.0,0.0,0.0,0.0,4.2,4.4,3.0,27.5,6324.0,30.0,5.4,5.1,3.0,24.5,25.0,153.0,175.0,23.0,-1.1000000000000014,18.0,31.5,32.6,23.5,13.5,268.0,57.0,61.3,24.0,24.0,284.0,6.0,28.0,18.0,13.0,16.666666666666668,17.0,-118.23,-43.37,11.01,11.0,23.0,-58.54,-10.87,28.0,24.5,10.15,23.0,26.0,78.6,85.7,26.0,20.0,0.0,9.0,7.0,10.0,2.0,0.0,8.0,7.0,7.0,0.0,19.0,7.0,32.0,31.5,17.25,20.0,25.26875,32.0,22.85,30.0,27.6875,31.0,36.0,1.0,1.0,0.5277777777777778,20.0,23.218732782369145,29.0,25.6,31.0,15.0,3.2,4.5,2.5,19.5,2.0,1.0,21.0,5.0,15.0,71.0,60.0,10.5,11.0,1.0,0.0,11.5,6.5,1728.0,1250.0,6.0,4.0,5.1,5.6,8.0,27.5,28.16666666666667,31.0,0.0,0.0,240.0,355.0,23.0,-115.0,28.0,29.0,470.0,463.0,3.0,24.0,0.5766262403528115,0.4708691499522445,31.0,11.0,1.9729729729729728,11.0,11.0,2.3,3.7,15.5,31.0,17.0,7.0,30.5,0.5238095238095238,0.4722222222222222,30.0,26.0,0.6654911838790932,0.5576923076923077,32.0,12.0,2642.0,2755.0,2.0,28.0,98.0,801.0,981.0,19.5,7.0,115.0,16.0,5.0,0.12350597609561753,0.1059190031152648,13.0,7.0,5.6,5.9,29.0,14.0,907.0,1047.0,29.0,31.0,75.0,0.0,0.0,16.5,12.0,36.0,13.0,3251.0,2790.0,5.0,17.0,62.0,2.5,19.0,0.0,0.0,12.5,20.5,219.0,305.0,16.0,25.0,1.27,1.86,24.0,29.0,34.0,22.0,70.6,73.1,6.0,27.0,2989.0,27.0,0.5068493150684932,22.0,0.4233737596471885,0.5291308500477555,2.0,22.0,0.4761904761904762,0.5277777777777778,3.0,7.0,0.3345088161209068,0.4423076923076923,1.0,21.0,384.0,554.0,32.0,27.0,10.0,19.0,27.5,23.0,1328.0,2185.0,29.0,31.0,16.62626262626263,16.0,25.6,35.9,27.0,28.0,0.0,0.0,53.0,10.1,6.1,21.5,30.0,347.0,193.0,24.5,31.0,30.0,25.0,30.0,28.0,35.0,27.5,22.5,22.0,30.0,29.0,22.5,34.0,16.7,15.2,11.5,26.0,28.0,16.0,-6.0,21.0,25.5,20.83746556473829,27.0,25704.0,32200.0,32.0,3970.0,4940.0,12.0,31.0,100.0,100.0,22.5,10.0,24.0,37.0,21.5,26.5,24.0,37.0,22.0,26.5,6.4,6.4,7.5,22.0,3.5,3.9,13.0,28.0,11.2,10.4,3.0,18.5,24.3,20.8,5.0,3.5,6.4,8.5,20.0,25.0,4.4,4.7,6.0,28.5,43.3,45.0,29.0,11.0,23.3,26.7,16.0,28.0,-970.0,29.0,1.8285714285714287,1.6410256410256412,22.0,8.0
2006.0,176.0,182.0,8.0,29.5,289.0,312.0,21.5,19.0,161.0,181.0,23.5,18.5,99.0,111.0,24.5,18.5,29.0,20.0,9.5,4.5,0.0,0.0,0.0,4.0,5.3,5.1,12.5,15.0,6815.0,24.0,6.1,5.8,9.5,16.5,35.0,169.0,153.0,2.5,1.0,13.0,30.8,29.8,14.5,15.0,313.0,64.1,59.4,17.0,3.5,316.0,19.0,16.0,6.0,28.0,18.33333333333333,18.0,-18.81,34.19,2.1,15.0,11.0,-48.67,-29.99,31.0,26.0,-18.88,24.0,15.0,88.9,75.0,9.0,7.0,1.0,7.0,12.0,4.0,3.0,1.0,7.0,10.0,4.0,2.0,9.0,9.0,25.5,7.5,19.166666666666668,22.0,15.7,16.0,16.15,18.0,15.25,16.0,21.0,1.0,0.0,0.42857142857142855,10.5,16.369972451790634,17.0,15.2,16.0,16.0,3.3,3.0,19.5,18.0,0.0,1.0,16.0,18.0,15.5,60.0,69.0,21.5,20.5,2.0,0.0,13.0,1.5,1445.0,1462.0,17.0,15.0,6.0,5.7,11.5,16.0,20.0,22.0,0.0,0.0,316.0,295.0,6.0,21.0,12.0,18.0,488.0,532.0,26.0,21.0,0.5153010858835143,0.5558823529411765,13.0,25.0,1.6262626262626263,17.0,17.0,3.5,3.6,10.5,22.0,19.0,12.5,23.0,0.53125,0.5757575757575758,20.0,26.0,0.6446534451032508,0.6072370900866944,25.0,16.0,3153.0,3222.0,14.0,17.0,70.0,560.0,843.0,23.0,2.0,105.0,29.0,3.0,0.10034602076124567,0.0641025641025641,25.0,4.0,5.9,5.7,21.0,4.0,1013.0,1020.0,22.5,13.0,74.0,1.0,0.0,16.5,26.5,28.0,5.0,3255.0,3263.0,14.0,21.0,74.0,12.5,23.0,0.0,0.0,10.0,22.0,243.0,205.0,2.0,25.0,1.68,1.57,14.0,14.0,29.0,28.0,82.1,78.0,12.0,14.0,3352.0,19.0,0.6149068322981367,16.0,0.4846989141164857,0.4441176470588235,20.0,8.0,0.46875,0.4242424242424242,13.0,7.0,0.3553465548967492,0.3927629099133057,8.0,17.0,491.0,453.0,17.0,7.0,15.0,14.0,19.5,9.5,1738.0,2084.0,24.0,20.0,13.202020202020204,5.0,31.8,28.0,8.0,15.0,0.0,0.0,34.0,6.5,6.2,20.0,18.5,199.0,230.0,15.0,15.0,35.0,17.0,16.0,27.0,24.0,4.0,22.5,24.0,18.0,5.0,16.0,25.0,13.6,13.7,19.0,14.5,25.0,24.0,0.0,18.5,12.0,17.53994490358127,19.0,29744.0,27846.0,10.5,4891.0,5306.0,20.0,25.0,97.1,100.0,20.5,27.0,35.0,29.0,5.0,15.5,34.0,29.0,5.0,16.5,6.9,6.5,7.0,13.5,3.5,4.6,27.0,30.0,10.7,10.9,5.5,26.5,24.1,21.2,9.0,4.5,8.4,7.3,9.5,20.0,4.8,5.2,16.0,26.0,44.0,44.1,25.0,13.0,27.7,29.1,21.0,15.0,-415.0,22.0,1.9714285714285715,1.4130434782608696,29.0,5.0
2007.0,171.0,169.0,2.0,29.0,286.0,315.0,25.0,21.0,173.0,174.0,12.0,19.0,92.0,128.0,31.0,20.0,21.0,13.0,3.5,16.0,2.0,0.0,1.0,2.0,4.4,5.7,16.0,26.5,6912.0,24.0,5.4,6.5,17.5,24.0,26.0,163.0,182.0,7.5,0.8000000000000007,14.0,30.3,29.5,9.5,19.0,310.0,60.5,61.5,20.0,18.5,289.0,5.0,21.0,12.0,24.0,22.33333333333333,23.0,-69.54,-42.96,-47.21,20.0,24.0,-18.4,-15.59,30.0,12.0,-49.32,29.0,22.0,80.6,90.6,29.0,23.0,1.0,11.0,12.0,8.0,4.0,1.0,11.0,10.0,6.0,1.0,6.0,6.0,31.5,3.5,22.5,30.0,20.6375,28.0,21.15,26.0,20.125,22.0,20.0,1.0,1.0,0.3,2.0,20.839393939393943,23.0,20.8,22.0,19.0,3.7,3.2,16.0,25.5,0.0,4.0,15.0,21.0,21.5,74.0,51.0,5.5,5.0,3.0,1.0,20.5,2.0,1695.0,1270.0,7.0,6.0,5.3,6.3,20.0,25.5,22.33333333333333,23.0,1.0,0.0,268.0,355.0,19.0,-87.0,22.0,25.0,512.0,470.0,5.0,23.0,0.5588526211671613,0.4911417322834646,30.0,21.0,1.880434782608696,16.0,15.0,2.9,3.8,14.0,26.5,18.0,6.5,26.5,0.7142857142857143,0.5625,28.0,11.0,0.6392364793213149,0.5939736346516008,28.0,21.0,3014.0,3154.0,9.0,25.0,63.0,486.0,761.0,23.0,2.0,93.0,21.0,2.0,0.07342657342657342,0.04126984126984127,31.0,12.0,6.1,6.2,30.5,4.0,1011.0,1016.0,22.0,14.0,72.0,1.0,0.0,16.5,26.5,32.0,11.5,3106.0,2904.0,10.0,16.0,68.0,11.0,19.5,0.0,0.0,9.0,22.5,183.0,268.0,10.0,30.0,1.37,1.84,19.0,24.0,20.0,31.0,73.9,82.6,16.0,22.0,3330.0,23.0,0.5317919075144508,17.0,0.4411473788328387,0.5088582677165354,3.0,12.0,0.2857142857142857,0.4375,5.0,22.0,0.360763520678685,0.4060263653483992,5.0,12.0,446.0,517.0,31.0,14.0,6.0,14.0,23.5,30.5,1701.0,2156.0,29.0,19.0,17.0,17.0,29.2,36.1,25.0,21.0,0.0,0.0,53.0,9.4,5.8,19.5,30.0,316.0,208.0,18.0,26.0,29.0,25.0,29.0,36.0,32.0,18.0,3.5,29.0,29.0,26.0,6.0,25.0,14.0,12.4,24.0,14.0,21.0,31.0,-4.0,20.0,12.0,20.87878787878788,26.0,27873.0,30758.0,26.0,4715.0,5310.0,18.0,26.0,95.8,100.0,21.5,30.5,24.0,36.0,15.5,29.5,23.0,36.0,17.0,30.0,6.5,7.2,24.5,21.5,3.8,4.2,21.0,24.5,10.7,11.6,22.0,24.0,22.9,24.9,27.5,14.0,9.2,8.4,14.0,13.0,4.7,5.2,18.5,25.0,43.1,42.7,10.5,17.0,27.5,31.4,30.0,17.5,-595.0,22.0,1.7105263157894737,1.7142857142857142,13.0,16.0
2008.0,177.0,177.0,12.0,21.0,308.0,315.0,24.5,11.5,186.0,209.0,31.0,8.5,94.0,86.0,9.5,22.0,28.0,20.0,19.5,3.0,6.0,0.0,2.0,3.0,4.8,5.8,16.5,26.0,7269.0,17.0,5.5,6.7,21.5,27.5,48.0,169.0,164.0,10.0,1.1999999999999993,12.5,31.4,30.2,15.5,10.0,347.0,65.6,64.3,26.0,5.0,368.0,30.0,8.0,30.0,6.5,14.5,14.0,27.89,29.53,-31.33,16.0,16.0,11.48,49.68,5.0,5.0,24.32,11.0,13.0,82.8,89.3,23.0,21.0,0.0,9.0,13.0,5.0,2.0,0.0,9.0,9.0,4.0,2.0,8.0,16.0,3.0,8.0,12.083333333333336,8.0,13.125,12.0,15.75,17.5,10.5,8.5,22.0,2.0,3.0,0.3636363636363637,8.0,15.181680440771348,16.0,15.3,15.0,23.0,4.3,2.4,22.5,32.0,3.0,4.0,14.0,15.5,32.0,61.0,73.0,23.5,20.5,1.0,0.0,11.0,7.0,1407.0,1568.0,19.0,21.0,5.9,6.1,15.5,21.0,15.083333333333336,15.0,0.0,0.0,405.0,356.0,18.0,49.0,12.0,9.0,529.0,572.0,29.0,13.0,0.5698267074413863,0.6009803921568627,6.0,14.0,1.9787234042553192,10.0,22.0,4.2,4.0,17.0,10.0,23.0,24.0,11.5,0.5238095238095238,0.696969696969697,6.0,25.0,0.6223855285472019,0.7119544592030358,3.0,20.0,3303.0,3752.0,29.0,16.0,77.0,569.0,663.0,14.0,3.0,93.0,22.5,6.5,0.09090909090909093,0.06349206349206349,19.0,4.0,5.7,5.9,24.5,13.0,981.0,1020.0,24.0,19.0,59.0,1.0,0.0,16.5,26.5,29.0,9.5,2533.0,2995.0,13.0,25.0,69.0,15.0,25.0,0.0,0.0,11.5,21.5,303.0,288.0,15.0,16.0,2.07,1.77,15.5,10.0,29.0,23.5,80.2,88.1,22.0,23.0,3516.0,16.0,0.5053763440860215,23.0,0.4301732925586137,0.3990196078431373,27.0,19.0,0.4761904761904762,0.303030303030303,27.0,8.0,0.3776144714527981,0.288045540796964,30.0,13.0,422.0,407.0,9.0,19.0,20.0,10.0,6.5,6.0,2004.0,1518.0,7.0,9.0,15.787878787878787,16.0,37.3,33.3,15.0,11.0,0.0,0.0,30.0,5.4,6.7,8.0,14.5,213.0,253.0,8.0,17.0,41.0,7.0,14.0,29.0,28.0,10.0,21.5,24.0,25.0,16.5,23.0,31.0,16.9,16.9,4.0,29.0,30.0,6.5,-1.0,19.0,28.0,15.0633608815427,14.0,29913.0,29028.0,13.0,5307.0,5270.0,16.0,16.0,100.0,100.0,19.0,13.5,41.0,37.0,17.5,11.5,41.0,37.0,17.5,11.5,6.6,7.0,18.5,22.0,4.7,3.7,6.5,5.0,10.1,10.9,8.0,31.0,23.1,21.5,7.0,14.5,10.4,9.9,18.5,7.0,5.4,5.2,14.0,13.0,42.9,43.4,13.5,23.0,29.8,29.5,18.0,12.0,37.0,20.0,1.404255319148936,1.891891891891892,4.0,29.0
2009.0,198.0,187.0,19.0,3.0,280.0,237.0,1.0,23.5,131.0,128.0,1.0,29.5,132.0,87.0,12.0,1.0,17.0,22.0,14.0,27.0,5.0,0.0,2.0,0.0,4.0,3.5,1.0,27.0,6969.0,23.0,4.8,4.2,1.5,27.0,37.0,156.0,147.0,15.0,3.5999999999999983,3.0,32.4,28.8,13.0,2.5,210.0,53.4,51.7,1.0,29.0,259.0,1.5,32.0,18.0,14.0,2.6666666666666665,1.0,-56.3,-38.37,105.99,1.0,25.0,-4.45,43.4,7.0,9.0,167.56,1.0,22.0,83.3,82.6,16.0,18.0,0.0,6.0,15.0,14.0,1.0,0.0,6.0,12.0,11.0,1.0,9.0,14.0,4.5,8.5,10.166666666666666,4.0,14.54375,16.0,25.9,31.0,3.1875,1.0,24.0,1.0,3.0,0.375,7.0,9.837603305785123,6.0,7.7,6.0,21.0,5.3,3.4,11.0,30.0,1.0,2.0,17.0,13.5,28.5,44.0,70.0,20.5,32.0,1.0,2.0,30.5,9.0,1074.0,1685.0,24.0,30.0,5.6,4.6,1.0,21.5,18.08333333333333,20.0,1.0,0.0,348.0,236.0,1.0,112.0,7.0,17.0,393.0,501.0,7.0,32.0,0.41067961165048544,0.559286463798531,18.0,32.0,0.9924242424242424,32.0,12.0,3.1,1.6,1.0,26.0,8.0,1.0,29.5,0.3636363636363637,0.42105263157894735,31.0,32.0,0.4633956386292835,0.6091156799603666,26.0,32.0,2380.0,2459.0,1.0,31.0,88.0,677.0,680.0,6.0,7.0,87.0,9.0,11.5,0.060714285714285714,0.09282700421940927,6.0,25.5,5.4,5.2,2.5,22.5,1030.0,953.0,4.5,11.0,80.0,0.0,0.0,16.5,13.5,27.0,5.5,3357.0,4277.0,31.0,14.0,99.0,32.0,11.0,0.0,0.0,11.5,20.5,457.0,238.0,7.0,4.0,1.62,1.02,1.0,18.0,50.0,1.0,62.0,58.8,1.0,28.5,2596.0,31.0,1.0076335877862594,1.0,0.5893203883495146,0.440713536201469,15.0,1.0,0.6363636363636364,0.5789473684210527,2.0,1.0,0.5366043613707165,0.39088432003963336,7.0,1.0,607.0,420.0,11.0,1.0,21.0,11.0,12.0,3.5,2756.0,1578.0,8.0,1.0,16.242424242424242,17.0,31.8,20.3,1.0,16.0,0.0,0.0,30.0,7.1,6.0,15.5,24.0,216.0,245.0,8.0,14.0,32.0,20.0,10.5,36.0,23.0,5.5,2.5,30.0,19.0,6.5,3.5,30.0,15.2,14.4,10.0,22.0,31.0,8.0,1.0,16.5,20.5,11.975206611570249,7.0,30888.0,27489.0,7.0,5136.0,4037.0,1.0,20.0,100.0,95.8,6.0,8.5,32.0,24.0,1.0,20.0,32.0,23.0,1.0,19.5,6.6,5.4,1.0,18.0,4.5,3.8,4.0,6.0,12.4,10.4,2.0,7.0,24.4,24.1,24.0,4.5,9.1,8.8,20.0,13.0,5.0,4.2,1.0,22.0,42.0,43.2,12.0,26.0,25.9,21.6,1.0,22.0,1099.0,5.0,1.4666666666666666,1.4210526315789476,30.0,23.0
2010.0,199.0,201.0,28.0,4.5,307.0,272.0,5.5,15.0,171.0,169.0,7.0,20.0,118.0,70.0,2.0,4.5,18.0,33.0,27.5,28.0,1.0,0.0,1.0,0.0,5.4,5.5,13.5,20.5,7940.0,6.0,6.1,6.4,14.0,22.5,39.0,157.0,136.0,16.0,4.699999999999996,2.0,32.8,28.1,5.0,2.0,288.0,54.9,50.7,1.0,30.0,269.0,2.0,25.0,22.0,8.0,5.166666666666667,2.0,19.75,39.6,-29.57,12.0,18.0,-7.46,83.56,1.0,6.0,64.52,6.0,15.0,76.9,78.3,9.5,27.5,1.0,11.0,16.0,6.0,5.0,1.0,10.0,14.0,3.0,2.0,7.0,18.0,2.0,5.0,6.416666666666668,1.0,12.425,9.0,18.85,21.0,6.0,4.0,23.0,0.0,0.0,0.3043478260869565,1.0,8.212672176308539,2.0,5.3,3.0,14.0,2.7,2.3,26.5,15.0,3.0,1.0,12.0,26.0,12.0,63.0,73.0,25.5,16.0,2.0,0.0,7.0,4.0,1588.0,1428.0,17.0,6.0,5.9,5.6,4.0,21.0,12.833333333333336,14.0,0.0,0.0,367.0,304.0,6.0,63.0,8.0,13.0,525.0,531.0,15.0,18.0,0.5087396504139834,0.5832482124616956,12.0,30.0,1.4491525423728813,29.0,20.0,3.8,4.5,21.0,22.5,24.0,19.5,23.0,0.5882352941176471,0.6857142857142857,15.5,25.0,0.5772792022792023,0.6882504288164666,8.0,28.0,3242.0,3210.0,6.0,22.0,103.0,934.0,679.0,4.0,27.0,74.0,1.0,24.0,0.05863192182410424,0.1213235294117647,2.0,28.0,5.7,5.0,2.0,13.0,1087.0,979.0,11.0,3.0,84.0,0.0,0.0,16.5,12.5,27.0,5.0,3578.0,4384.0,32.0,10.0,97.0,32.0,9.0,0.0,0.0,10.5,21.0,529.0,299.0,14.0,2.0,1.65,1.49,6.5,20.0,56.0,1.0,76.5,77.1,6.0,24.5,3420.0,23.0,0.6900584795321637,4.0,0.4912603495860166,0.4167517875383045,21.0,3.0,0.4117647058823529,0.3142857142857143,17.5,8.0,0.42272079772079774,0.3117495711835334,25.0,5.0,534.0,408.0,10.5,2.0,14.0,11.0,13.5,10.0,2374.0,1454.0,3.0,4.0,16.792929292929294,21.0,32.2,26.4,6.0,17.0,2.0,0.0,28.0,5.1,7.0,8.5,8.5,178.0,244.0,14.5,7.0,40.0,8.5,8.5,39.0,23.0,6.0,3.5,30.0,18.0,5.0,4.5,21.0,10.6,13.9,12.0,9.0,30.0,9.0,9.0,6.5,8.5,11.12534435261708,3.0,31243.0,27336.0,4.0,5616.0,4664.0,3.0,11.0,100.0,97.1,4.0,12.5,37.0,35.0,11.0,18.0,37.0,34.0,10.0,18.0,6.5,6.5,6.0,26.5,4.4,3.6,3.5,8.5,11.9,12.8,30.0,13.0,25.2,19.6,3.0,3.0,9.4,11.1,26.0,20.0,5.2,4.8,3.0,19.0,42.6,45.2,29.5,23.0,28.2,22.9,1.0,16.0,952.0,6.0,1.4772727272727268,1.805555555555556,5.0,27.0
2011.0,203.0,208.0,32.0,2.0,301.0,272.0,6.0,17.0,173.0,167.0,6.0,20.5,92.0,83.0,8.0,18.0,36.0,22.0,8.0,1.0,1.0,0.0,0.0,1.0,5.1,4.9,4.5,19.5,7299.0,15.0,5.9,5.6,3.5,22.0,45.0,146.0,135.0,24.5,1.3999999999999986,12.5,30.9,29.5,21.5,3.0,310.0,56.7,54.2,4.0,24.5,275.0,3.0,19.0,30.0,5.5,8.583333333333334,6.0,-66.18,-33.0,32.92,3.0,24.0,-31.61,47.65,5.0,17.0,89.9,4.0,23.0,76.0,96.7,32.0,27.5,0.0,6.0,6.0,7.0,6.0,0.0,5.0,6.0,5.0,3.0,16.0,12.0,5.0,30.5,10.166666666666666,5.0,18.775,22.0,17.05,18.0,20.5,20.0,25.0,1.0,4.0,0.64,29.0,15.057713498622588,14.0,14.3,14.0,18.0,3.3,3.7,6.5,22.0,2.0,3.0,19.0,10.5,23.5,62.0,61.0,32.0,1.0,1.0,0.0,12.0,5.0,1633.0,1291.0,26.0,1.0,5.6,5.9,6.5,25.5,23.16666666666667,25.0,1.0,0.0,377.0,363.0,20.0,14.0,15.0,13.0,547.0,507.0,8.5,17.0,0.5699029126213592,0.5458207452165156,23.0,18.0,1.880434782608696,17.0,26.0,4.8,3.0,4.0,8.0,15.0,2.5,9.0,0.65,0.46875,32.0,14.0,0.6608538785327721,0.6441017424394152,24.0,15.0,3297.0,3216.0,5.0,21.0,102.0,849.0,966.0,27.0,15.0,110.0,23.5,18.0,0.11960132890365448,0.08088235294117647,18.0,1.0,5.2,4.9,1.0,28.5,1030.0,993.0,12.0,10.0,92.0,0.0,0.0,16.5,12.0,32.0,10.5,3926.0,0.0,16.5,11.0,92.0,29.0,5.5,0.0,0.0,9.5,24.0,426.0,241.0,7.0,11.0,1.69,1.5,6.0,18.0,44.0,7.5,78.4,69.6,3.0,18.0,3542.0,20.0,0.5317919075144508,16.0,0.4300970873786408,0.4541792547834844,10.0,15.0,0.35,0.53125,1.0,19.0,0.3391461214672279,0.3558982575605848,9.0,18.0,443.0,451.0,21.5,16.0,14.0,17.0,27.5,13.0,1692.0,1777.0,13.0,22.0,15.65656565656566,13.0,29.6,29.3,8.0,22.0,3.0,1.0,40.0,6.8,6.5,13.5,21.0,245.0,198.0,25.0,18.0,35.0,17.5,20.0,25.0,30.0,15.0,29.0,19.0,29.0,22.5,30.5,34.0,13.8,13.9,10.0,21.0,31.0,7.0,-3.0,20.0,29.0,15.815426997245181,16.0,29638.0,28080.0,9.0,4989.0,4993.0,5.0,25.0,100.0,100.0,20.0,13.0,44.0,38.0,19.5,9.0,44.0,38.0,20.0,8.0,6.5,6.7,5.5,25.5,3.8,3.9,7.0,29.5,11.4,12.4,24.5,24.0,26.3,21.2,4.0,4.0,9.7,7.5,9.5,18.0,4.8,5.0,4.5,28.0,42.7,0.0,16.5,27.5,24.4,24.0,1.0,29.5,-4.0,15.0,1.7105263157894737,1.717948717948718,16.0,16.0
2012.0,194.0,193.0,26.5,7.0,299.0,293.0,7.0,22.0,162.0,161.0,2.0,28.0,102.0,96.0,15.0,14.0,35.0,36.0,30.0,8.0,1.0,0.0,0.0,0.0,4.3,5.6,11.0,30.0,6688.0,26.0,5.3,6.3,10.0,30.0,31.0,151.0,152.0,23.0,-0.8999999999999986,20.0,27.8,28.7,23.0,14.0,272.0,55.2,53.8,2.0,30.0,266.0,1.0,31.0,20.0,16.0,13.916666666666664,10.0,-93.73,-65.56,-26.39,10.0,29.0,-18.59,32.12,13.0,14.0,8.59,9.0,29.0,77.8,71.0,2.0,27.0,0.0,8.0,8.0,7.0,4.0,0.0,7.0,6.0,5.0,3.0,18.0,12.0,10.0,31.0,17.583333333333332,19.5,21.4,29.0,26.55,31.0,16.25,14.0,32.0,1.0,3.0,0.5625,26.0,20.97685950413223,23.0,22.4,23.5,19.0,3.9,2.2,21.5,31.0,2.0,1.0,11.0,24.5,29.0,50.0,54.0,27.0,7.5,1.0,1.0,26.0,7.0,1308.0,1184.0,24.0,4.0,5.4,5.8,8.5,28.5,27.41666666666667,31.0,0.0,1.0,281.0,375.0,20.0,-94.0,26.0,28.0,493.0,494.0,3.0,25.0,0.5222437137330754,0.5142296368989205,29.0,27.0,1.5882352941176472,26.0,14.0,2.8,4.0,12.0,28.5,20.0,10.5,29.0,0.5384615384615384,0.5405405405405406,27.0,25.0,0.6039273031125966,0.5867800541167375,32.0,25.0,2891.0,3036.0,2.0,30.0,83.0,708.0,805.0,13.0,3.0,109.0,25.0,4.0,0.11705685618729098,0.1228668941979522,1.0,4.0,5.5,5.4,4.5,23.0,1034.0,1019.0,16.0,11.0,86.0,2.0,0.0,16.5,29.5,31.0,10.5,3848.0,0.0,16.5,8.0,89.0,28.0,5.0,1.0,1.0,23.5,9.0,238.0,375.0,19.5,28.0,1.26,1.68,12.5,30.0,23.0,31.0,68.3,78.2,7.0,30.0,3178.0,30.0,0.6296296296296297,7.0,0.4777562862669246,0.4857703631010794,4.0,6.0,0.4615384615384616,0.4594594594594594,6.0,8.0,0.3960726968874034,0.4132199458832625,1.0,8.0,494.0,495.0,30.0,6.0,12.0,17.0,26.5,15.0,1896.0,2138.0,26.0,12.0,16.585858585858585,17.0,24.2,30.6,9.0,30.5,1.0,1.0,47.0,8.7,5.7,24.0,31.5,287.0,170.0,30.0,27.0,30.0,26.0,27.0,27.0,31.0,16.5,28.0,21.0,22.0,8.0,29.0,37.0,17.5,11.4,21.0,30.0,23.0,19.5,-14.0,29.0,31.0,19.553719008264466,24.0,29294.0,29336.0,14.0,4787.0,5174.0,8.0,30.0,100.0,100.0,19.0,14.0,30.0,43.0,22.0,24.0,30.0,43.0,22.5,24.0,6.4,6.5,6.0,28.5,3.8,4.3,20.5,25.0,11.7,12.1,23.0,11.5,26.2,21.9,5.0,6.5,10.3,12.1,27.0,12.5,4.6,5.1,7.0,31.0,44.7,0.0,16.5,21.5,24.6,26.8,8.0,30.0,-387.0,23.0,1.6842105263157896,1.5116279069767442,27.0,14.5
2013.0,196.0,192.0,16.0,12.5,280.0,293.0,9.0,27.5,154.0,198.0,20.5,30.0,105.0,68.0,2.5,13.0,21.0,27.0,12.5,28.0,0.0,0.0,0.0,0.0,4.2,6.2,20.5,32.0,6640.0,23.0,5.3,7.0,21.0,30.0,27.0,148.0,152.0,21.5,-4.600000000000001,30.5,26.0,30.6,26.5,30.0,266.0,55.4,58.9,8.0,32.0,345.0,17.5,31.0,14.0,26.5,14.833333333333336,11.0,-100.47,-68.88,-80.2,19.0,31.0,-23.34,66.66,1.0,20.0,-11.08,14.0,30.0,91.7,89.2,21.0,10.5,0.0,8.0,11.0,14.0,3.0,0.0,8.0,10.0,12.0,3.0,7.0,2.0,32.0,6.0,19.916666666666668,25.5,18.6,24.0,26.7,32.0,10.5,10.0,15.0,0.0,1.0,0.4666666666666667,13.0,21.919421487603305,27.0,25.5,28.5,22.0,4.6,2.2,24.0,31.0,1.0,5.0,13.0,22.5,29.0,45.0,42.0,18.0,6.5,0.0,0.0,12.5,19.0,1021.0,938.0,17.0,10.0,5.6,6.3,18.0,25.5,23.33333333333333,26.5,1.0,0.0,290.0,387.0,19.0,-97.0,26.0,29.0,480.0,586.0,22.0,29.0,0.5166666666666667,0.5982824427480916,12.0,28.0,1.4666666666666666,28.0,13.0,2.7,4.4,17.0,31.5,26.0,19.0,32.0,0.52,0.7428571428571429,7.0,29.0,0.5760314341846758,0.7365180070908751,1.0,30.0,2932.0,3947.0,22.0,31.0,108.0,837.0,833.0,15.0,17.0,92.0,9.5,23.0,0.075,0.09215017064846416,12.0,25.0,5.4,5.7,21.0,23.0,1020.0,1048.0,21.0,20.5,89.0,1.0,0.0,16.5,23.5,43.0,27.5,4018.0,0.0,16.5,9.0,82.0,19.5,5.5,0.0,0.0,12.0,22.5,224.0,488.0,29.0,26.0,1.4,1.79,17.0,28.5,25.0,27.5,66.6,86.5,20.0,32.0,3270.0,30.0,0.6818181818181818,5.0,0.4833333333333333,0.4017175572519084,21.0,5.0,0.48,0.2571428571428571,26.0,4.0,0.42396856581532416,0.2634819929091249,32.0,3.0,493.0,421.0,9.0,5.0,12.0,9.0,6.5,19.0,2158.0,1412.0,3.0,6.0,16.353535353535356,13.0,29.6,35.4,19.0,25.0,1.0,0.0,47.0,8.9,6.5,14.5,30.5,338.0,242.0,22.0,29.0,41.0,14.0,26.5,36.0,37.0,29.0,7.5,33.0,33.0,29.0,6.5,29.0,14.8,7.3,31.0,24.0,15.0,31.0,-14.0,30.0,23.0,18.33884297520661,22.0,29008.0,29184.0,20.0,5090.0,5359.0,11.0,25.0,100.0,100.0,19.0,14.0,27.0,40.0,18.0,29.0,27.0,40.0,18.0,29.0,6.8,7.1,16.0,20.0,4.4,3.4,1.0,10.0,12.3,12.1,22.0,6.0,22.7,22.3,10.5,18.5,9.0,11.3,27.0,15.5,5.0,5.1,9.0,26.0,45.1,0.0,16.5,17.0,25.8,28.0,14.0,26.0,-269.0,21.0,1.5454545454545452,2.088235294117647,2.0,28.0
2014.0,186.0,183.0,19.0,13.5,289.0,300.0,2.5,25.0,154.0,194.0,14.5,31.5,112.0,74.0,4.0,5.0,23.0,32.0,17.5,28.0,4.0,0.0,0.0,0.0,4.8,7.0,26.5,29.5,7076.0,17.0,5.7,8.2,30.5,30.0,27.0,160.0,154.0,13.5,-0.6999999999999993,21.5,27.8,28.5,24.0,16.5,287.0,57.6,64.1,21.0,29.0,345.0,15.0,30.5,2.0,31.0,14.75,10.0,-47.78,-10.34,-99.33,23.0,28.0,-19.76,21.38,15.0,14.0,-74.3,26.0,26.0,82.1,81.3,10.5,22.0,0.0,13.0,7.0,13.0,6.0,0.0,13.0,7.0,9.0,3.0,9.0,7.0,24.5,14.0,18.08333333333333,22.5,17.29375,20.0,25.4,31.0,9.1875,5.0,25.0,0.0,0.0,0.36,7.0,19.558677685950414,24.0,20.7,23.0,15.0,3.0,1.1,31.0,21.0,0.0,3.0,6.0,31.0,17.0,58.0,51.0,27.0,1.0,0.0,0.0,13.5,19.0,1342.0,1110.0,23.0,2.0,5.4,6.4,18.0,30.0,21.91666666666667,25.0,0.0,1.0,283.0,401.0,24.0,-118.0,26.0,28.0,498.0,538.0,7.5,27.0,0.5180608365019012,0.5973360655737705,9.0,28.0,1.375,30.0,16.0,3.2,5.8,30.0,30.0,31.0,30.0,30.0,0.5925925925925926,0.7560975609756098,8.0,26.0,0.563719862227325,0.7155682903533906,5.0,31.0,2946.0,3746.0,14.0,32.0,109.0,932.0,780.0,7.0,17.5,91.0,2.5,16.0,0.07958477508650519,0.10666666666666667,12.0,28.0,5.9,5.5,9.0,10.5,1052.0,976.0,3.5,10.0,79.0,1.0,0.0,16.5,21.0,25.0,5.5,3580.0,3757.0,27.0,11.0,81.0,23.0,10.5,0.0,0.0,10.0,21.5,273.0,250.0,14.5,16.0,1.53,2.03,24.0,26.0,43.0,3.0,75.1,101.5,30.0,29.0,3206.0,32.0,0.7272727272727273,3.0,0.4819391634980989,0.4026639344262295,24.0,5.0,0.4074074074074073,0.24390243902439024,25.0,7.0,0.4362801377726751,0.2844317096466093,28.0,2.0,507.0,393.0,7.0,4.0,11.0,10.0,12.0,18.5,2280.0,1489.0,5.0,3.0,18.641414141414145,21.0,31.7,37.2,24.0,22.0,1.0,1.0,47.0,8.6,7.7,5.0,25.0,260.0,310.0,4.0,23.0,45.0,6.5,24.5,39.0,32.0,17.0,1.0,32.0,26.0,16.0,3.5,24.0,11.8,5.5,32.0,16.0,13.0,32.0,-11.0,29.0,19.0,18.41735537190083,23.0,29760.0,28182.0,9.0,5226.0,5235.0,6.0,22.0,100.0,97.7,5.0,13.5,23.0,44.0,24.5,31.5,23.0,43.0,23.5,31.5,6.4,7.5,20.5,30.0,4.5,3.8,6.0,7.5,11.2,11.8,21.5,22.0,23.1,21.8,7.0,19.0,6.3,10.0,23.0,30.0,5.0,5.4,16.0,29.0,45.3,46.4,28.0,15.0,28.0,28.4,8.0,25.0,-9.0,18.0,1.4222222222222225,1.973684210526316,5.0,31.0
2015.0,199.0,194.0,26.0,3.5,329.0,271.0,1.0,14.0,210.0,185.0,9.0,9.5,99.0,62.0,1.0,10.0,20.0,24.0,5.0,30.5,0.0,0.0,0.0,1.0,6.4,5.4,7.0,13.5,7231.0,7.0,6.8,6.2,6.0,22.0,44.0,151.0,145.0,19.0,1.3999999999999986,12.0,29.2,27.8,19.0,8.5,362.0,59.9,57.1,1.0,26.5,343.0,9.5,15.0,0.0,31.5,4.666666666666667,2.0,55.82,95.9,-23.17,8.0,11.0,-27.8,71.94,2.0,14.0,54.43,4.0,13.0,81.8,89.7,26.0,23.0,0.0,6.0,10.0,14.0,3.0,0.0,6.0,10.0,9.0,2.0,8.0,12.0,9.5,10.5,12.0,8.0,12.88125,10.0,13.7,14.0,12.0625,11.0,17.0,0.0,2.0,0.4705882352941176,14.5,10.637052341597796,7.0,8.5,7.0,16.0,2.6,3.0,5.0,22.0,0.0,0.0,18.0,5.0,23.0,37.0,49.0,29.5,11.0,0.0,0.0,13.5,19.0,771.0,1168.0,30.0,17.0,6.5,5.9,7.0,14.5,13.583333333333336,11.0,0.0,1.0,387.0,314.0,9.0,73.0,8.0,11.0,604.0,601.0,23.0,15.0,0.5828677839851024,0.631786771964462,4.0,19.0,2.121212121212121,19.0,33.0,5.5,4.2,13.5,9.0,25.0,16.0,8.5,0.75,0.8620689655172413,1.0,12.0,0.6847257383966244,0.7381326010200079,2.0,21.0,4057.0,3763.0,13.0,13.0,96.0,787.0,767.0,3.0,4.0,90.0,1.0,5.5,0.06079027355623101,0.08856088560885607,22.0,31.0,5.6,5.4,3.5,20.5,1074.0,1013.0,14.0,6.0,80.0,1.0,0.0,11.0,27.0,37.0,19.0,3448.0,4042.0,29.0,15.0,86.0,27.5,13.0,0.0,2.0,31.0,22.5,422.0,470.0,29.0,6.0,1.95,1.45,4.5,11.0,49.0,2.0,88.0,79.0,6.0,19.0,4170.0,15.0,0.4714285714285714,14.0,0.4171322160148976,0.36821322803553796,29.0,14.0,0.25,0.13793103448275867,32.0,21.0,0.3152742616033756,0.2618673989799921,31.0,12.0,448.0,373.0,4.5,10.0,11.0,4.0,1.0,16.5,1868.0,1335.0,2.0,10.0,22.505050505050512,31.0,35.7,28.4,5.0,14.0,0.0,0.0,22.0,3.5,6.1,17.5,2.0,113.0,278.0,10.0,1.0,39.0,12.5,2.0,33.0,29.0,15.5,10.0,27.0,26.0,16.5,15.0,24.0,11.6,14.4,6.0,18.0,30.0,3.5,6.0,8.5,19.0,12.774104683195596,8.0,30049.0,28130.0,10.0,5925.0,5098.0,4.0,10.0,97.7,90.9,9.5,8.0,43.0,33.0,11.0,9.0,42.0,30.0,11.0,7.5,6.9,6.7,7.0,24.5,4.2,3.6,3.5,13.0,11.5,11.8,22.5,12.5,20.8,23.8,14.0,26.5,8.6,12.7,30.0,14.5,5.5,5.0,4.5,14.0,43.1,47.0,30.5,28.0,29.6,26.2,3.5,20.0,827.0,4.0,1.6428571428571428,1.8611111111111112,8.0,25.0
2016.0,184.0,181.0,11.0,18.5,291.0,318.0,12.5,27.0,166.0,203.0,19.5,29.0,97.0,86.0,7.0,14.0,28.0,29.0,13.0,19.5,1.0,0.0,1.0,1.0,4.5,7.2,28.5,30.5,6477.0,25.0,5.2,7.9,28.0,30.0,27.0,160.0,157.0,17.0,-2.599999999999998,27.0,27.1,29.7,26.0,27.0,311.0,56.5,63.7,19.0,31.0,347.0,13.0,28.0,6.0,22.5,18.25,20.0,-38.59,-25.88,-138.14,28.0,30.0,-8.5,56.13,3.0,10.0,-83.73,22.0,29.0,87.1,87.1,21.5,8.0,0.0,13.0,11.0,3.0,4.0,0.0,12.0,10.0,3.0,2.0,9.0,6.0,26.0,17.5,23.125,28.0,20.9125,27.0,25.7,31.0,16.125,17.0,24.0,0.0,3.0,0.375,8.5,23.677961432506887,30.0,25.9,28.0,25.0,4.5,1.5,28.0,32.0,0.0,1.0,8.0,30.0,32.0,43.0,29.0,13.0,2.0,0.0,1.0,29.0,19.5,881.0,665.0,14.0,7.5,5.9,6.8,25.0,24.0,25.25,30.0,1.0,1.0,275.0,409.0,28.0,-134.0,29.0,30.0,550.0,545.0,8.0,23.5,0.5832502492522432,0.5720000000000001,25.0,21.0,1.7113402061855667,26.0,16.0,2.9,5.5,27.5,27.5,30.0,26.0,28.5,0.6153846153846154,0.7317073170731707,6.0,21.0,0.6579347000759301,0.7114436941047636,11.0,25.0,3466.0,3898.0,17.0,27.0,93.0,837.0,651.0,1.0,8.0,74.0,1.0,4.5,0.09621993127147767,0.09119496855345913,18.0,17.0,5.6,5.7,15.5,24.0,1003.0,1000.0,10.0,24.0,76.0,1.0,0.0,13.0,29.0,35.0,21.0,3059.0,3184.0,16.0,22.0,72.0,17.5,14.0,0.0,0.0,12.0,20.0,149.0,319.0,23.0,32.0,1.47,2.03,21.5,28.0,27.0,23.5,67.6,98.5,30.0,32.0,3645.0,28.0,0.5843373493975904,7.0,0.4167497507477568,0.4280000000000001,8.0,12.0,0.3846153846153846,0.2682926829268293,27.0,12.0,0.3420652999240699,0.2885563058952364,22.0,8.0,418.0,428.0,23.0,13.0,10.0,11.0,11.0,23.5,1802.0,1581.0,11.0,12.0,20.671717171717173,28.0,29.3,37.6,20.0,27.0,0.0,0.0,35.0,6.0,4.7,28.0,21.0,179.0,179.0,27.0,8.5,27.0,29.0,17.0,31.0,31.0,15.0,19.5,27.0,27.0,18.0,16.5,34.0,17.9,7.2,29.0,31.0,14.0,28.5,-20.0,31.5,31.0,21.455922865013765,30.0,29440.0,28417.0,19.0,5268.0,5479.0,11.0,26.0,92.3,97.8,27.0,20.0,26.0,45.0,28.0,29.0,24.0,44.0,29.0,29.0,6.6,7.5,23.5,25.0,4.3,3.7,4.5,13.5,11.7,11.7,21.0,12.0,20.5,22.9,24.0,22.0,5.5,9.1,20.0,31.5,5.3,5.5,15.5,20.0,40.3,44.2,9.0,32.0,28.7,30.2,14.0,23.0,-211.0,23.0,1.5348837209302326,2.0270270270270268,2.0,26.0
