Year,#Dr,#Dr_Defense,#Dr_Defense_Low_Rank,#Dr_High_Rank,1stD,1stD_Defense,1stD_Defense_Low_Rank,1stD_High_Rank,1stDpass,1stDpass_Defense,1stDpass_Defense_Low_Rank,1stDpass_High_Rank,1stDrun,1stDrun_Defense,1stDrun_Defense_Low_Rank,1stDrun_High_Rank,1stPy,1stPy_Defense,1stPy_Defense_Low_Rank,1stPy_High_Rank,2PA,2PA_Defense,2PM,2PM_Defense,ANY/A,ANY/A_Defense,ANY/A_Defense_Low_Rank,ANY/A_High_Rank,APYd,APYd_High_Rank,AY/A,AY/A_Defense,AY/A_Defense_Low_Rank,AY/A_High_Rank,AllTD,AvgDriveTime,AvgDriveTime_Defense,AvgDriveTime_Defense_Low_Rank,AvgDriveTime_High_Rank,AvgFieldPositionDifferential,AvgFieldPositionDifferential_High_Rank,AvgStartingPosition,AvgStartingPosition_Defense,AvgStartingPosition_Defense_Low_Rank,AvgStartingPosition_High_Rank,Cmp,Cmp%,Cmp%_Defense,Cmp%_Defense_Low_Rank,Cmp%_High_Rank,Cmp_Defense,Cmp_Defense_Low_Rank,Cmp_High_Rank,DefensivePtsScored,DefensivePtsScored_High_Rank,Dscore,Dscore_Rank,ExpectedPoints,ExpectedPointsPassing,ExpectedPointsPassing_Defense,ExpectedPointsPassing_Defense_High_Rank,ExpectedPointsPassing_High_Rank,ExpectedPointsRunning,ExpectedPointsRunning_Defense,ExpectedPointsRunning_Defense_High_Rank,ExpectedPointsRunning_High_Rank,ExpectedPoints_Defense,ExpectedPoints_Defense_High_Rank,ExpectedPoints_High_Rank,FG%,FG%_Defense,FG%_Defense_Low_Rank,FG%_High_Rank,FGA019,FGA2029,FGA3039,FGA4049,FGA50Plus,FGM019,FGM2029,FGM3039,FGM4049,FGM50Plus,FL,FL_Defense,FL_Defense_High_Rank,FL_Low_Rank,FantasyDstScore,FantasyDstScore_Rank,FantasyOffenseScore,FantasyOffenseScore_Rank,FantasyPassScore,FantasyPassScore_Rank,FantasyRushScore,FantasyRushScore_Rank,Fmb,FmbTD,FmbTD_Defense,Fmb_Low_Rank,FumbleLostPercent,FumbleLostPercent_Low_Rank,GameControlPlusBalance,GameControlPlusBalance_Rank,GameControlScore,GameControlScore_Rank,Int,Int%,Int%_Defense,Int%_Defense_High_Rank,Int%_Low_Rank,IntTD,IntTD_Defense,Int_Defense,Int_Defense_High_Rank,Int_Low_Rank,KickRet,KickRet_Defense,KickRet_Defense_Low_Rank,KickRet_High_Rank,KrTD,KrTD_Defense,KrTD_Defense_Low_Rank,KrTD_High_Rank,KrYds,KrYds_Defense,KrYds_Defense_Low_Rank,KrYds_High_Rank,NY/A,NY/A_Defense,NY/A_Defense_Low_Rank,NY/A_High_Rank,Oscore,Oscore_Rank,OthTD,OthTD_Defense,PF,PF_Defense,PF_Defense_Low_Rank,PF_Differential,PF_Differential_High_Rank,PF_High_Rank,PassAtt,PassAtt_Defense,PassAtt_Defense_Low_Rank,PassAtt_High_Rank,PassPercent,PassPercent_Defense,PassPercent_Defense_High_Rank,PassPercent_High_Rank,PassRun1dRatio,PassRun1dRatio_High_Rank,PassTD,PassTD%,PassTD%_Defense,PassTD%_Defense_Low_Rank,PassTD%_High_Rank,PassTD_Defense,PassTD_Defense_Low_Rank,PassTD_High_Rank,PassTdPercent,PassTdPercent_Defense,PassTdPercent_Defense_High_Rank,PassTdPercent_High_Rank,PassYdPercent,PassYdPercent_Defense,PassYdPercent_Defense_High_Rank,PassYdPercent_High_Rank,PassYds,PassYds_Defense,PassYds_Defense_Low_Rank,PassYds_High_Rank,Pen,PenYds,PenYds_Defense,PenYds_Defense_Low_Rank,PenYds_Low_Rank,Pen_Defense,Pen_Defense_Low_Rank,Pen_Low_Rank,Penalty1dPercent,Penalty1dPercent_Defense,Penalty1dPercent_Defense_High_Rank,Penalty1dPercent_High_Rank,Plays/Drive,Plays/Drive_Defense,Plays/Drive_Defense_Low_Rank,Plays/Drive_High_Rank,Ply,Ply_Defense,Ply_Defense_Low_Rank,Ply_High_Rank,Pnt,PntBlck,PntBlck_Defense,PntBlck_Defense_Low_Rank,PntBlck_Low_Rank,PntRet_Defense,PntRet_Defense_Low_Rank,PntYds,PntYds_Defense,PntYds_Defense_Low_Rank,PntYds_High_Rank,Pnt_Defense,Pnt_Defense_Low_Rank,Pnt_High_Rank,PrTD,PrTD_Defense,PrTD_Defense_Low_Rank,PrTD_High_Rank,PrYds,PrYds_Defense,PrYds_Defense_Low_Rank,PrYds_High_Rank,Pts/Drive,Pts/Drive_Defense,Pts/Drive_Defense_Low_Rank,Pts/Drive_High_Rank,PuntRet,PuntRet_High_Rank,QbRating,QbRating_Defense,QbRating_Defense_Low_Rank,QbRating_High_Rank,RawPassYds,RawPassYds_High_Rank,RunPass1dRatio,RunPass1dRatio_High_Rank,RunPercent,RunPercent_Defense,RunPercent_Defense_High_Rank,RunPercent_High_Rank,RunTdPercent,RunTdPercent_Defense,RunTdPercent_Defense_High_Rank,RunTdPercent_High_Rank,RunYdPercent,RunYdPercent_Defense,RunYdPercent_Defense_High_Rank,RunYdPercent_High_Rank,RushAtt,RushAtt_Defense,RushAtt_Defense_Low_Rank,RushAtt_High_Rank,RushTD,RushTD_Defense,RushTD_Defense_Low_Rank,RushTD_High_Rank,RushYds,RushYds_Defense,RushYds_Defense_Low_Rank,RushYds_High_Rank,STscore,STscore_Rank,Sc%,Sc%_Defense,Sc%_Defense_Low_Rank,Sc%_High_Rank,Sfty,Sfty_Defense,Sk,Sk%,Sk%_Defense,Sk%_Defense_High_Rank,Sk%_Low_Rank,SkYds,SkYds_Defense,SkYds_Defense_High_Rank,SkYds_Low_Rank,Sk_Defense,Sk_Defense_High_Rank,Sk_Low_Rank,TFGA,TFGA_Defense,TFGA_Defense_Low_Rank,TFGA_High_Rank,TFGM,TFGM_Defense,TFGM_Defense_Low_Rank,TFGM_High_Rank,TO,TO%,TO%_Defense,TO%_Defense_High_Rank,TO%_Low_Rank,TO_Defense,TO_Defense_High_Rank,TO_Differential,TO_Differential_High_Rank,TO_Low_Rank,ThreePhaseScore,ThreePhaseScore_Rank,TimeOfPossession,TimeOfPossession_Defense,TimeOfPossession_High_Rank,TotalYds,TotalYds_Defense,TotalYds_Defense_Low_Rank,TotalYds_High_Rank,XP%,XP%_Defense,XP%_Defense_Low_Rank,XP%_High_Rank,XPA,XPA_Defense,XPA_Defense_Low_Rank,XPA_High_Rank,XPM,XPM_Defense,XPM_Defense_Low_Rank,XPM_High_Rank,Y/Apass,Y/Apass_Defense,Y/Apass_Defense_Low_Rank,Y/Apass_High_Rank,Y/Arun,Y/Arun_Defense,Y/Arun_Defense_Low_Rank,Y/Arun_High_Rank,Y/C,Y/C_Defense,Y/C_Defense_Low_Rank,Y/C_High_Rank,Y/KR,Y/KR_Defense,Y/KR_Defense_Low_Rank,Y/KR_High_Rank,Y/PR,Y/PR_Defense,Y/PR_Defense_Low_Rank,Y/PR_High_Rank,Y/Play,Y/Play_Defense,Y/Play_Defense_Low_Rank,Y/Play_High_Rank,Y/Pnt,Y/Pnt_Defense,Y/Pnt_Defense_Low_Rank,Y/Pnt_High_Rank,Yds/Drive,Yds/Drive_Defense,Yds/Drive_Defense_Low_Rank,Yds/Drive_High_Rank,Yds_Differential,Yds_Differential_High_Rank,YppYprRatio,YppYprRatio_Defense,YppYprRatio_Defense_High_Rank,YppYprRatio_High_Rank
1981.0,,,,,269.0,320.0,19.0,26.0,159.0,174.0,23.0,15.0,95.0,123.0,17.0,24.5,15.0,23.0,9.5,27.0,0.0,0.0,0.0,0.0,6.5,3.4,2.0,3.0,6444.0,27.0,7.1,3.8,1.0,5.0,38.0,,,,,,,,,,,239.0,50.5,58.6,24.0,23.0,317.0,27.0,23.0,30.0,3.5,10.583333333333334,8.0,,,,,,,,,,,,,60.7,75.8,22.0,20.0,0.0,7.0,6.0,13.0,2.0,0.0,5.0,4.0,6.0,2.0,14.0,14.0,26.5,4.5,13.25,11.0,15.4375,18.0,11.0,13.0,19.875,21.0,27.0,1.0,0.0,5.5,0.5185185185185185,14.5,,,,,14.0,3.0,5.9,2.5,6.0,4.0,0.0,32.0,2.0,3.5,46.0,64.0,17.0,26.0,0.0,0.0,12.5,16.5,912.0,1332.0,21.0,25.0,7.0,5.6,7.0,2.0,14.75,17.0,0.0,0.0,315.0,268.0,4.0,47.0,12.0,18.5,473.0,541.0,22.0,22.0,0.5178947368421053,0.5058295964125561,17.0,11.0,1.673684210526316,5.0,20.0,4.2,1.8,1.0,13.0,10.0,1.0,16.5,0.6060606060606061,0.38461538461538464,28.0,13.0,0.6645348837209303,0.5911144578313253,20.0,6.0,3429.0,3140.0,12.0,11.0,89.0,779.0,650.0,1.0,5.0,79.0,1.0,3.5,0.055762081784386616,0.071875,20.0,27.0,,,,,950.0,1115.0,26.0,27.0,82.0,2.0,0.0,14.5,27.0,52.0,23.5,3459.0,3008.0,8.0,10.0,73.0,8.0,12.0,0.0,1.0,23.0,18.5,244.0,668.0,28.0,24.0,,,,,38.0,22.0,77.4,57.8,3.0,10.0,3565.0,13.0,0.5974842767295597,24.0,0.4821052631578947,0.4941704035874439,12.0,18.0,0.3939393939393939,0.6153846153846154,1.0,16.0,0.3354651162790697,0.4088855421686747,9.0,23.0,458.0,551.0,23.0,25.0,13.0,16.0,15.0,18.0,1731.0,2172.0,22.0,24.0,19.11111111111111,27.0,0.0,0.0,14.5,14.5,0.0,2.0,19.0,3.9,4.1,27.0,3.5,136.0,157.0,27.0,2.0,23.0,26.0,2.5,28.0,33.0,23.5,15.0,17.0,25.0,25.5,17.5,28.0,0.0,0.0,14.5,14.5,46.0,8.5,18.0,2.5,3.0,14.424242424242426,16.0,,,,5160.0,5312.0,13.0,18.0,94.7,100.0,26.0,19.0,38.0,27.0,2.5,14.0,36.0,27.0,2.5,18.0,7.5,6.1,3.0,7.5,3.8,3.9,12.0,21.0,14.9,10.4,1.0,3.0,19.8,20.8,17.5,15.0,6.4,12.8,28.0,25.5,5.4,4.8,6.5,6.0,42.2,41.2,16.5,7.0,,,,,-152.0,17.0,1.973684210526316,1.5641025641025639,23.0,5.0
1982.0,,,,,163.0,160.0,7.5,18.0,105.0,76.0,4.0,5.0,52.0,72.0,22.0,22.5,6.0,12.0,15.5,27.0,0.0,0.0,0.0,0.0,5.1,3.9,5.5,10.0,3723.0,20.0,5.7,5.2,8.0,16.0,15.0,,,,,,,,,,,164.0,53.2,57.1,19.0,23.0,145.0,7.0,12.0,0.0,26.5,9.416666666666666,7.0,,,,,,,,,,,,,78.3,70.6,16.5,6.0,0.0,11.0,6.0,3.0,3.0,0.0,10.0,5.0,1.0,2.0,12.0,10.0,12.0,26.5,16.333333333333332,20.0,15.41875,19.0,10.65,10.0,20.1875,24.0,28.0,0.0,1.0,27.0,0.42857142857142855,8.0,,,,,11.0,3.6,4.3,16.0,9.5,0.0,1.0,11.0,21.0,10.5,33.0,40.0,20.5,19.0,0.0,0.0,13.5,15.5,548.0,870.0,24.0,25.0,6.1,5.0,3.0,11.0,15.75,17.0,0.0,0.0,158.0,178.0,16.0,-20.0,19.5,18.0,308.0,254.0,6.0,8.0,0.5434412265758092,0.4946808510638298,20.0,12.0,2.019230769230769,5.0,9.0,2.9,3.9,15.5,22.5,10.0,10.0,20.5,0.6,0.5263157894736842,19.0,12.5,0.6711571675302245,0.5667485667485668,23.0,9.0,1943.0,1384.0,4.0,6.0,38.0,297.0,325.0,2.0,3.0,38.0,1.0,2.5,0.03680981595092025,0.075,11.0,27.0,,,,,587.0,564.0,8.0,14.5,40.0,1.0,0.0,14.5,24.5,23.0,11.0,1662.0,1823.0,15.0,21.0,42.0,11.5,21.0,0.0,0.0,12.5,16.5,143.0,192.0,13.0,18.0,,,,,25.0,11.0,69.3,71.1,13.0,19.0,2071.0,10.0,0.4952380952380953,24.0,0.4565587734241908,0.5053191489361701,9.0,17.0,0.4,0.4736842105263158,10.0,16.5,0.3288428324697755,0.4332514332514332,6.0,20.0,268.0,285.0,17.0,18.0,6.0,9.0,18.5,18.5,952.0,1058.0,18.0,19.0,18.549382716049386,26.0,0.0,0.0,14.5,14.5,0.0,0.0,11.0,3.4,9.0,13.0,1.5,128.0,224.0,13.0,4.0,25.0,13.0,1.5,23.0,17.0,15.5,2.0,18.0,12.0,19.0,3.0,23.0,0.0,0.0,14.5,14.5,21.0,18.0,-2.0,20.0,15.0,14.210437710437711,16.0,,,,2895.0,2442.0,3.0,13.0,100.0,76.2,1.0,6.0,14.0,21.0,16.5,26.5,14.0,16.0,5.0,26.0,6.7,6.3,6.5,16.5,3.6,3.7,9.0,19.5,12.6,11.1,5.0,12.0,16.6,21.8,23.0,28.0,5.7,8.3,15.5,23.0,4.9,4.3,2.0,14.0,41.6,43.4,27.0,9.5,,,,,453.0,4.0,1.8611111111111112,1.7027027027027026,21.0,12.5
1983.0,,,,,249.0,320.0,18.0,28.0,157.0,172.0,18.5,15.0,72.0,124.0,15.0,28.0,20.0,24.0,19.0,15.5,0.0,0.0,0.0,0.0,4.2,4.8,14.0,21.0,6525.0,27.0,5.2,5.9,13.5,20.5,31.0,,,,,,,,,,,300.0,56.8,61.2,26.5,17.0,300.0,20.5,12.0,24.0,10.0,15.583333333333336,19.0,,,,,,,,,,,,,41.7,82.4,28.0,27.0,0.0,9.0,4.0,8.0,3.0,0.0,7.0,0.0,3.0,0.0,13.0,18.0,11.0,6.0,15.166666666666664,17.0,19.43125,27.0,15.05,20.0,23.8125,26.0,39.0,1.0,3.0,21.5,0.3333333333333333,2.0,,,,,24.0,4.5,4.7,12.0,12.5,3.0,4.0,23.0,13.5,18.5,68.0,50.0,4.5,8.5,0.0,0.0,13.0,15.5,1314.0,1039.0,7.0,12.0,5.4,6.2,18.5,24.5,24.16666666666667,28.0,0.0,0.0,241.0,380.0,22.0,-139.0,27.0,27.0,528.0,490.0,10.5,9.5,0.5741293532338309,0.4867337602927722,22.0,5.0,2.180555555555556,2.0,18.0,3.4,3.1,1.5,21.5,15.0,1.5,19.0,0.6666666666666666,0.4411764705882353,26.0,6.0,0.6977886977886978,0.6142301278488049,13.0,4.0,3124.0,3315.0,19.0,15.0,94.0,832.0,799.0,12.0,14.0,105.0,20.0,12.0,0.08032128514056225,0.075,14.0,9.0,,,,,1005.0,1093.0,22.0,26.0,96.0,1.0,0.0,14.5,21.0,59.0,28.0,4050.0,3215.0,12.5,2.0,79.0,14.5,1.0,0.0,1.0,22.5,20.5,299.0,603.0,27.0,20.0,,,,,42.0,17.5,69.4,74.6,15.0,20.0,3490.0,15.0,0.4585987261146497,27.0,0.4258706467661692,0.5132662397072278,7.0,24.0,0.33333333333333337,0.5588235294117647,3.0,23.0,0.3022113022113022,0.3857698721511951,16.0,25.0,428.0,561.0,23.0,24.0,9.0,19.0,21.0,25.5,1353.0,2082.0,15.0,27.0,18.62962962962963,26.0,0.0,0.0,14.5,14.5,0.0,2.0,49.0,8.5,7.9,13.0,17.0,366.0,309.0,17.0,22.0,42.0,15.0,20.0,24.0,34.0,24.5,21.5,10.0,28.0,26.5,27.0,37.0,0.0,0.0,14.5,14.5,41.0,12.0,4.0,10.0,10.0,19.535353535353533,26.0,,,,4477.0,5397.0,16.0,28.0,86.2,95.2,13.0,27.0,29.0,42.0,18.0,25.0,25.0,40.0,18.0,25.0,6.6,7.4,21.0,24.5,3.2,3.7,7.0,27.5,11.6,12.1,8.0,24.0,19.3,20.8,22.0,15.0,7.1,10.2,23.0,22.5,4.5,4.9,7.5,28.0,42.2,40.7,14.0,6.0,,,,,-920.0,26.0,2.0625,2.0,5.0,5.0
1984.0,,,,,344.0,311.0,15.0,5.0,209.0,157.0,6.5,3.0,114.0,139.0,26.0,16.0,21.0,15.0,4.0,17.0,0.0,0.0,0.0,0.0,4.9,5.4,19.5,13.5,7255.0,15.0,5.9,6.3,15.5,16.0,40.0,,,,,,,,,,,334.0,59.3,58.4,19.5,7.0,286.0,12.0,4.0,6.0,25.5,19.916666666666668,22.0,,,,,,,,,,,,,73.1,66.7,9.0,16.0,0.0,7.0,7.0,10.0,2.0,0.0,7.0,6.0,6.0,0.0,20.0,14.0,15.5,26.0,21.66666666666667,25.0,13.55625,14.0,9.55,7.0,17.5625,18.0,36.0,0.0,0.0,22.5,0.5555555555555556,24.0,,,,,23.0,4.1,3.7,15.5,13.5,1.0,0.0,18.0,18.5,19.5,68.0,67.0,17.5,9.0,0.0,0.0,12.0,17.0,1354.0,1336.0,18.0,8.0,5.8,6.2,20.0,13.0,14.833333333333336,14.0,0.0,0.0,335.0,380.0,21.0,-45.0,20.0,14.0,563.0,490.0,7.5,8.0,0.5572868927589367,0.505324298160697,19.0,9.0,1.8333333333333333,8.0,22.0,3.9,4.1,14.0,15.0,20.0,12.5,11.0,0.5641025641025641,0.425531914893617,27.0,19.0,0.6662281526028941,0.5920716112531971,23.0,9.0,3545.0,3241.0,13.0,8.0,118.0,875.0,1078.0,27.0,16.0,136.0,27.0,23.0,0.061046511627906974,0.04823151125401929,24.5,20.0,,,,,1091.0,1033.0,11.0,6.0,68.0,0.0,0.0,14.5,9.5,36.0,7.0,2849.0,2788.0,5.0,23.0,68.0,5.5,23.5,0.0,0.0,11.0,18.0,207.0,310.0,10.5,27.0,,,,,34.0,23.0,76.4,78.6,16.5,12.0,3907.0,7.0,0.5454545454545454,21.0,0.4427131072410633,0.494675701839303,10.0,20.0,0.4358974358974359,0.5744680851063829,2.0,10.0,0.33377184739710586,0.40792838874680304,6.0,20.0,483.0,511.0,17.0,18.0,17.0,27.0,27.5,10.5,1776.0,2233.0,25.0,19.0,15.654320987654323,19.0,0.0,0.0,14.5,14.5,0.0,0.0,45.0,7.4,6.1,25.0,7.5,362.0,239.0,25.0,16.0,32.0,25.5,12.0,26.0,27.0,11.0,20.0,19.0,18.0,8.0,21.0,43.0,0.0,0.0,14.5,14.5,32.0,20.5,-11.0,24.5,25.5,16.905723905723907,23.0,,,,5321.0,5474.0,20.0,10.0,95.0,95.7,9.0,22.0,40.0,46.0,21.0,12.0,38.0,44.0,21.0,12.5,6.9,7.1,14.0,17.5,3.7,4.4,23.0,21.5,11.7,12.2,8.0,26.0,19.9,19.9,12.0,10.5,6.1,8.6,14.0,27.0,4.9,5.3,24.0,15.5,41.9,41.0,15.0,14.5,,,,,-153.0,18.0,1.864864864864865,1.6136363636363635,25.0,10.0
1985.0,,,,,291.0,351.0,25.0,20.0,162.0,185.0,23.0,16.0,95.0,146.0,26.0,21.0,34.0,20.0,8.0,1.5,0.0,0.0,0.0,0.0,4.4,6.0,24.5,20.0,6930.0,21.0,5.3,6.9,23.5,21.5,33.0,,,,,,,,,,,269.0,53.0,63.0,28.0,20.0,318.0,25.0,15.5,0.0,27.5,23.58333333333333,26.0,,,,,,,,,,,,,68.8,74.4,14.0,17.0,1.0,5.0,10.0,10.0,6.0,1.0,5.0,8.0,5.0,3.0,22.0,22.0,3.5,27.0,21.66666666666667,28.0,19.01875,25.0,15.6,19.0,22.4375,25.0,37.0,0.0,0.0,22.5,0.5945945945945946,21.0,,,,,26.0,5.1,3.6,21.0,25.0,0.0,4.0,18.0,21.0,22.0,80.0,51.0,5.5,1.0,0.0,0.0,11.5,17.0,1622.0,1187.0,11.0,1.0,5.7,6.8,27.5,16.0,21.166666666666668,24.0,0.0,0.0,294.0,448.0,27.0,-154.0,26.0,21.5,508.0,505.0,12.0,17.5,0.5580448065173116,0.4967801287948482,23.0,13.0,1.7052631578947368,10.0,22.0,4.3,3.6,8.5,12.0,18.0,7.5,12.0,0.6666666666666666,0.39130434782608703,28.0,6.0,0.6550566512798993,0.6021611001964636,21.0,11.0,3122.0,3678.0,25.0,17.0,103.0,751.0,945.0,25.0,11.0,114.0,25.0,18.0,0.1168384879725086,0.056980056980056974,27.0,1.0,,,,,982.0,1087.0,24.0,24.5,79.0,2.0,0.0,14.5,26.0,47.0,22.5,3317.0,2620.0,3.0,17.0,59.0,1.0,19.5,0.0,0.0,10.5,17.5,229.0,519.0,24.0,25.0,,,,,25.0,27.0,67.4,84.2,26.0,19.0,3423.0,18.0,0.5864197530864198,19.0,0.4419551934826884,0.5032198712051518,6.0,16.0,0.33333333333333337,0.6086956521739131,1.0,23.0,0.3449433487201007,0.3978388998035364,8.0,18.0,434.0,547.0,24.0,21.0,11.0,28.0,28.0,23.5,1644.0,2430.0,25.0,21.5,18.75308641975309,28.0,0.0,0.0,14.5,14.5,0.0,1.0,40.0,7.3,6.5,23.5,9.5,301.0,277.0,23.0,8.0,35.0,25.0,8.0,32.0,43.0,28.0,9.5,22.0,32.0,28.0,14.0,48.0,0.0,0.0,14.5,14.5,40.0,11.5,-8.0,25.0,26.0,21.387205387205388,28.0,,,,4766.0,6108.0,26.0,23.0,93.8,100.0,26.0,23.0,32.0,50.0,23.5,23.0,30.0,50.0,25.0,23.5,6.7,7.8,26.5,19.5,3.8,4.4,24.5,20.5,12.7,12.4,9.5,15.0,20.3,23.3,24.0,18.0,9.2,11.0,23.5,14.0,4.9,5.6,24.5,18.5,42.0,44.4,28.0,11.0,,,,,-1342.0,27.0,1.7631578947368425,1.7727272727272725,12.5,14.0
1986.0,,,,,273.0,362.0,28.0,25.5,142.0,177.0,19.5,23.0,100.0,162.0,28.0,18.5,31.0,23.0,11.5,5.0,0.0,0.0,0.0,0.0,3.2,7.1,28.0,28.0,6182.0,27.0,4.4,7.7,27.0,27.5,27.0,,,,,,,,,,,245.0,53.4,59.7,25.0,19.0,289.0,14.0,24.0,12.0,15.5,27.0,28.0,,,,,,,,,,,,,70.8,70.0,15.0,13.5,0.0,5.0,8.0,6.0,5.0,0.0,5.0,7.0,3.0,2.0,17.0,19.0,4.5,19.5,23.33333333333333,27.0,19.2125,26.0,22.3,28.0,16.125,16.0,36.0,2.0,0.0,21.0,0.4722222222222222,14.0,,,,,25.0,5.4,2.7,25.5,24.0,0.0,1.0,13.0,25.5,23.5,75.0,46.0,4.0,2.0,0.0,1.0,25.5,17.0,1302.0,1009.0,8.0,9.0,4.9,7.3,28.0,25.0,22.33333333333333,27.0,0.0,0.0,239.0,473.0,28.0,-234.0,28.0,26.0,459.0,484.0,7.0,23.0,0.5309278350515464,0.4740810556079171,26.0,20.0,1.42,19.0,13.0,2.8,4.8,22.5,26.0,23.0,23.0,26.5,0.52,0.4259259259259259,27.0,19.0,0.5728044026599404,0.5818727301436918,24.0,22.0,2498.0,3685.0,24.0,27.0,83.0,661.0,941.0,23.0,4.0,116.0,24.0,2.0,0.11355311355311355,0.06353591160220995,23.0,3.0,,,,,970.0,1061.0,23.5,26.0,78.0,0.0,0.0,14.5,6.5,39.0,10.5,3132.0,2437.0,1.0,21.0,59.0,1.0,21.0,0.0,3.0,27.5,20.5,110.0,414.0,21.0,28.0,,,,,26.0,28.0,59.6,89.5,28.0,27.0,2892.0,26.0,0.7042253521126759,10.0,0.4690721649484536,0.5259189443920829,3.0,9.0,0.48,0.5740740740740741,2.0,10.0,0.4271955973400596,0.4181272698563082,5.0,7.0,455.0,558.0,26.0,20.5,12.0,31.0,28.0,18.5,1863.0,2648.0,28.0,12.0,21.81481481481481,28.0,0.0,0.0,14.5,14.5,0.0,0.0,56.0,10.9,3.8,28.0,26.0,394.0,153.0,28.0,21.5,19.0,28.0,23.5,24.0,30.0,16.0,24.0,17.0,21.0,16.5,20.0,42.0,0.0,0.0,14.5,14.5,32.0,22.0,-10.0,22.5,21.0,23.88888888888889,28.0,,,,4361.0,6333.0,28.0,27.0,96.3,96.6,16.5,21.0,27.0,58.0,28.0,26.0,26.0,56.0,28.0,26.0,6.3,7.9,26.5,21.5,4.1,4.7,28.0,9.5,11.8,13.3,23.0,25.0,17.4,21.9,26.0,27.5,4.2,10.6,25.0,28.0,4.5,6.0,28.0,24.0,40.2,41.3,17.5,20.5,,,,,-1972.0,28.0,1.5365853658536586,1.6808510638297869,23.0,24.0
1987.0,,,,,263.0,314.0,25.0,25.5,168.0,163.0,19.0,9.5,62.0,124.0,25.0,28.0,33.0,27.0,16.5,3.5,0.0,0.0,0.0,0.0,4.8,5.4,19.0,16.0,6097.0,25.0,5.9,6.6,20.5,17.0,33.0,,,,,,,,,,,264.0,51.1,59.3,25.0,25.0,271.0,17.0,14.0,24.0,6.5,18.33333333333333,20.0,,,,,,,,,,,,,79.2,60.0,3.0,6.0,0.0,3.0,8.0,11.0,2.0,0.0,3.0,7.0,8.0,1.0,14.0,20.0,6.5,9.5,15.25,17.0,18.0375,23.0,11.95,11.0,24.125,25.0,35.0,2.0,2.0,18.5,0.4,5.0,,,,,17.0,3.3,3.5,19.0,7.0,2.0,0.0,16.0,20.0,9.0,56.0,61.0,16.0,19.0,0.0,0.0,11.5,17.0,1037.0,1242.0,20.0,22.0,5.4,5.9,15.0,22.5,20.916666666666668,23.0,0.0,0.0,286.0,360.0,20.5,-74.0,24.0,19.0,517.0,457.0,8.0,5.5,0.5870020964360587,0.4979919678714859,23.0,3.0,2.7096774193548385,1.0,22.0,4.3,5.0,17.5,15.0,23.0,15.5,13.5,0.7586206896551724,0.5609756097560976,21.5,4.0,0.6884272997032641,0.5913374774413475,22.0,3.0,3016.0,2949.0,11.0,15.0,115.0,894.0,926.0,24.0,21.0,125.0,28.0,24.0,0.12547528517110265,0.08598726114649681,17.0,2.0,,,,,954.0,996.0,14.0,23.0,88.0,0.0,0.0,14.5,5.5,50.0,25.0,3455.0,2637.0,5.0,6.0,64.0,4.0,5.0,0.0,1.0,23.0,19.0,257.0,621.0,27.0,19.0,,,,,31.0,26.0,72.3,83.4,24.0,18.0,3377.0,16.0,0.3690476190476191,28.0,0.4129979035639413,0.5020080321285141,6.0,26.0,0.2413793103448276,0.4390243902439024,7.5,25.0,0.3115727002967359,0.4086625225586525,7.0,26.0,394.0,500.0,22.0,27.0,7.0,18.0,25.0,25.5,1365.0,2038.0,21.0,26.0,18.71604938271605,27.0,0.0,0.0,14.5,14.5,0.0,0.0,43.0,7.7,7.9,11.0,16.0,361.0,306.0,12.0,22.0,39.0,14.5,17.0,24.0,30.0,19.5,22.0,19.0,18.0,9.5,16.0,31.0,0.0,0.0,14.5,14.5,36.0,13.5,5.0,11.0,6.0,19.377104377104374,26.0,,,,4381.0,4987.0,16.0,27.0,93.9,95.5,15.0,24.0,33.0,44.0,24.0,18.5,31.0,42.0,22.0,20.0,6.5,7.1,16.5,23.0,3.5,4.1,20.0,25.5,12.8,12.0,5.0,9.5,18.5,20.4,20.0,21.0,8.3,12.4,24.0,17.0,4.6,5.0,15.5,23.5,39.3,41.2,24.5,18.0,,,,,-606.0,25.0,1.8571428571428568,1.7317073170731707,18.0,8.0
1988.0,,,,,295.0,293.0,9.0,18.0,173.0,169.0,16.0,13.0,91.0,104.0,10.0,24.0,31.0,20.0,8.5,5.0,0.0,0.0,0.0,0.0,3.7,5.6,21.0,25.0,6990.0,15.0,4.5,6.0,13.5,25.0,28.0,,,,,,,,,,,253.0,49.4,57.7,24.0,25.0,304.0,23.0,17.0,8.0,19.0,14.0,12.0,,,,,,,,,,,,,70.0,60.0,4.0,17.5,1.0,9.0,9.0,7.0,4.0,1.0,8.0,7.0,3.0,2.0,16.0,12.0,22.5,19.0,17.916666666666668,22.0,18.23125,24.0,15.9,18.5,20.5625,22.0,27.0,0.0,0.0,9.5,0.5925925925925926,25.0,,,,,36.0,7.0,4.0,14.0,27.0,1.0,2.0,21.0,11.0,28.0,64.0,52.0,6.5,7.5,0.0,0.0,11.0,17.5,1345.0,1129.0,13.0,10.0,6.1,6.6,25.0,10.5,18.83333333333333,22.0,0.0,0.0,261.0,350.0,19.0,-89.0,25.0,22.0,512.0,527.0,21.0,14.0,0.5470941883767535,0.5336585365853659,14.0,11.0,1.9010989010989008,6.0,16.0,3.1,3.6,11.5,21.0,19.0,13.5,18.5,0.5925925925925926,0.475,23.0,14.0,0.6536257656589607,0.6991270611057226,2.0,9.0,3308.0,3604.0,26.0,12.0,102.0,816.0,872.0,20.0,16.0,105.0,17.0,18.5,0.10508474576271186,0.06825938566552901,18.0,4.0,,,,,998.0,1025.0,14.0,22.0,68.0,0.0,0.0,14.5,8.5,38.0,12.5,2477.0,3003.0,16.0,26.0,77.0,15.0,20.5,0.0,0.0,11.5,17.0,328.0,273.0,8.0,15.0,,,,,36.0,18.5,53.7,75.2,15.0,27.0,3608.0,13.0,0.5260115606936416,23.0,0.4529058116232465,0.4663414634146341,15.0,18.0,0.4074074074074073,0.525,6.0,15.0,0.3463742343410393,0.3008729388942773,27.0,20.0,452.0,478.0,14.0,21.0,11.0,21.0,25.5,20.5,1753.0,1551.0,2.0,21.0,13.901234567901234,11.0,0.0,0.0,14.5,14.5,1.0,1.0,34.0,6.2,3.7,27.0,11.5,300.0,140.0,28.0,18.0,20.0,27.0,13.5,30.0,30.0,18.5,12.0,21.0,18.0,10.5,15.0,52.0,0.0,0.0,14.5,14.5,33.0,17.0,-19.0,26.0,28.0,15.730639730639727,15.0,,,,5061.0,5155.0,13.0,17.0,100.0,100.0,24.5,4.0,28.0,42.0,21.0,24.0,28.0,42.0,23.0,22.0,7.0,7.1,18.0,13.0,3.9,3.2,1.0,17.5,14.3,12.3,11.0,5.0,21.0,21.7,24.0,7.5,9.1,7.2,9.0,9.0,5.1,5.0,13.5,12.5,36.4,39.0,5.0,28.0,,,,,-94.0,15.0,1.794871794871795,2.21875,1.0,11.0
1989.0,,,,,288.0,317.0,20.0,19.0,174.0,170.0,12.0,12.0,84.0,115.0,17.0,25.0,30.0,32.0,27.0,3.0,0.0,0.0,0.0,0.0,4.1,5.6,18.0,24.0,6528.0,25.0,5.0,6.4,17.0,27.0,36.0,,,,,,,,,,,302.0,53.0,58.4,22.0,21.0,301.0,19.5,10.5,22.0,8.0,18.0,20.0,,,,,,,,,,,,,78.6,83.3,26.0,5.5,0.0,9.0,6.0,10.0,3.0,0.0,9.0,6.0,5.0,2.0,9.0,18.0,6.0,1.0,16.416666666666668,18.0,17.20625,22.0,14.35,16.0,20.0625,22.0,21.0,0.0,2.0,1.0,0.42857142857142855,8.0,,,,,28.0,4.9,4.1,13.0,22.0,2.0,2.0,21.0,13.0,27.0,62.0,55.0,6.5,13.0,0.0,0.0,11.0,19.0,1055.0,1143.0,9.0,20.0,5.4,6.3,15.5,23.5,19.666666666666668,23.5,1.0,0.0,320.0,419.0,27.0,-99.0,24.0,16.0,570.0,515.0,17.0,6.5,0.5980487804878049,0.5335929892891919,16.0,7.0,2.071428571428572,6.0,23.0,4.0,5.6,25.0,14.0,29.0,27.0,9.5,0.696969696969697,0.6170212765957447,12.0,5.0,0.6887649731515902,0.6294871794871795,18.0,7.0,3335.0,3437.0,14.0,14.0,104.0,881.0,869.0,20.0,17.5,109.0,21.0,15.0,0.10416666666666667,0.10094637223974763,4.0,1.0,,,,,1025.0,1027.0,15.0,14.0,86.0,2.0,0.0,14.5,26.0,54.0,28.0,3390.0,2781.0,8.0,8.0,69.0,8.0,4.0,0.0,0.0,12.0,17.0,296.0,492.0,27.0,19.0,,,,,32.0,22.0,66.0,82.2,20.0,24.0,3666.0,12.0,0.4827586206896552,23.0,0.4019512195121952,0.4664070107108082,13.0,22.0,0.303030303030303,0.3829787234042553,17.0,24.0,0.31123502684840976,0.3705128205128205,11.0,22.0,412.0,479.0,15.5,21.0,10.0,18.0,22.5,24.0,1507.0,2023.0,21.0,23.0,17.25925925925926,24.0,0.0,0.0,14.5,14.5,2.0,1.0,43.0,7.0,6.0,24.0,12.5,331.0,222.0,22.0,19.0,33.0,20.5,16.5,28.0,24.0,6.5,16.5,22.0,20.0,12.5,13.5,37.0,0.0,0.0,14.5,14.5,39.0,6.5,2.0,17.0,18.0,18.404040404040405,23.0,,,,4842.0,5460.0,17.0,22.0,97.1,100.0,24.5,17.5,35.0,51.0,27.5,17.5,34.0,51.0,28.0,18.0,6.4,7.1,14.0,25.0,3.7,4.2,22.0,19.5,12.1,12.2,10.5,23.0,17.0,20.8,21.0,27.0,9.3,9.1,16.0,12.0,4.7,5.3,19.0,24.5,39.4,40.3,15.5,22.5,,,,,-618.0,21.0,1.7297297297297298,1.6904761904761902,24.0,18.0
1990.0,,,,,238.0,313.0,24.0,28.0,142.0,168.0,18.0,21.0,83.0,129.0,24.0,24.0,13.0,16.0,8.0,27.5,0.0,0.0,0.0,0.0,4.2,5.1,13.5,24.0,6259.0,21.0,5.7,5.9,10.0,22.0,28.0,,,,,,,,,,,245.0,54.7,55.8,13.5,17.0,263.0,12.0,20.0,18.0,10.5,19.666666666666668,19.0,,,,,,,,,,,,,85.2,66.7,5.0,4.0,0.0,7.0,13.0,5.0,2.0,0.0,7.0,10.0,4.0,2.0,19.0,17.0,10.5,24.0,16.25,17.0,19.575,25.0,17.4,24.0,21.75,24.0,38.0,0.0,1.0,26.0,0.5,15.5,,,,,24.0,5.4,5.3,2.0,27.5,3.0,2.0,25.0,2.0,27.0,63.0,43.0,3.5,9.0,0.0,0.0,11.5,17.0,1175.0,1036.0,10.0,14.0,5.7,6.4,20.0,19.0,22.91666666666667,25.0,0.0,0.0,264.0,367.0,22.0,-103.0,25.0,25.0,448.0,471.0,12.0,19.5,0.5499451152579583,0.5044955044955045,23.0,13.0,1.7108433734939756,10.0,18.0,4.0,4.7,21.5,15.5,22.0,20.0,18.0,0.72,0.5238095238095238,24.0,5.0,0.6366480446927374,0.5942690271947436,23.0,11.0,2849.0,3256.0,18.0,17.0,77.0,651.0,617.0,3.0,7.0,78.0,2.0,3.0,0.0546218487394958,0.051118210862619806,23.0,24.0,,,,,911.0,1001.0,25.0,23.5,72.0,0.0,0.0,14.5,7.0,39.0,16.0,2902.0,2228.0,1.0,13.0,55.0,1.0,10.0,0.0,0.0,11.5,18.0,184.0,352.0,20.5,25.0,,,,,23.0,28.0,69.3,72.7,10.0,23.0,3282.0,16.0,0.5845070422535211,19.0,0.4500548847420417,0.4955044955044955,6.0,16.0,0.28,0.4761904761904762,5.0,24.0,0.3633519553072626,0.4057309728052564,6.0,18.0,410.0,496.0,22.0,21.0,7.0,20.0,24.5,26.0,1626.0,2223.0,25.0,19.0,16.0,20.0,0.0,0.0,14.5,14.5,0.0,0.0,53.0,10.6,6.7,19.5,28.0,433.0,204.0,24.0,26.0,34.0,18.0,26.0,27.0,27.0,11.0,16.0,23.0,18.0,9.0,8.5,43.0,0.0,0.0,14.5,14.5,42.0,3.5,-1.0,12.5,26.5,19.848484848484848,25.0,,,,4475.0,5479.0,24.0,24.0,100.0,95.6,9.0,7.0,27.0,45.0,23.0,25.5,27.0,43.0,23.0,25.0,7.3,7.3,20.0,8.5,4.0,4.5,24.5,15.0,13.4,13.2,20.0,3.0,18.7,24.1,28.0,16.0,8.0,9.0,19.0,16.5,4.9,5.5,23.5,21.0,40.3,40.5,13.0,17.0,,,,,-1004.0,26.0,1.825,1.6222222222222222,22.0,10.0
1991.0,,,,,249.0,295.0,14.0,24.5,147.0,147.0,4.5,25.0,79.0,120.0,24.0,25.0,23.0,28.0,26.5,7.0,0.0,0.0,0.0,0.0,2.8,5.6,19.0,28.0,5787.0,26.0,3.9,6.7,22.0,28.0,22.0,,,,,,,,,,,250.0,50.5,58.7,15.0,28.0,257.0,6.0,26.0,0.0,27.0,17.833333333333332,17.0,,,,,,,,,,,,,75.0,71.4,11.5,11.5,1.0,4.0,11.0,4.0,0.0,1.0,4.0,7.0,3.0,0.0,18.0,16.0,12.0,23.0,17.5,20.0,22.20625,27.0,23.35,28.0,21.0625,23.0,30.0,0.0,3.0,16.0,0.6,19.0,,,,,29.0,5.9,2.5,24.0,28.0,0.0,1.0,11.0,27.5,28.0,60.0,32.0,1.0,4.0,0.0,0.0,11.0,18.5,1047.0,720.0,3.0,11.0,4.7,6.0,14.5,27.0,24.5,26.0,0.0,0.0,199.0,365.0,25.0,-166.0,26.0,26.0,495.0,438.0,3.0,17.0,0.5976138828633406,0.4823053589484328,27.0,4.0,1.8607594936708856,11.0,13.0,2.6,3.4,11.5,22.0,15.0,6.0,22.0,0.5909090909090909,0.4166666666666667,26.0,12.0,0.6428392901774557,0.5768226551516369,26.0,17.0,2572.0,2872.0,5.0,28.0,88.0,780.0,925.0,27.0,13.0,110.0,26.0,7.5,0.09236947791164657,0.09491525423728814,3.0,2.0,,,,,922.0,989.0,20.0,26.0,84.0,0.0,0.0,14.5,8.5,49.0,27.0,3389.0,3046.0,16.0,8.0,71.0,15.5,4.0,0.0,1.0,24.0,18.5,361.0,559.0,28.0,6.0,,,,,39.0,9.5,53.4,81.7,22.0,28.0,2955.0,28.0,0.5374149659863946,18.0,0.4023861171366594,0.5176946410515673,2.0,25.0,0.40909090909090906,0.5833333333333333,3.0,17.0,0.35716070982254433,0.4231773448483631,3.0,12.0,371.0,512.0,26.0,26.0,9.0,21.0,26.0,20.5,1429.0,2107.0,25.0,19.0,20.067901234567906,28.0,0.0,0.0,14.5,14.5,0.0,2.0,56.0,10.2,8.2,5.0,27.0,383.0,258.0,10.0,26.0,39.0,9.5,26.0,20.0,35.0,23.5,27.0,15.0,25.0,19.5,26.5,47.0,0.0,0.0,14.5,14.5,27.0,24.0,-20.0,27.0,28.0,20.867003367003363,27.0,,,,4001.0,4979.0,11.0,26.0,100.0,97.6,17.0,7.0,22.0,41.0,23.0,25.0,22.0,40.0,22.5,25.0,6.0,7.1,20.0,26.5,3.9,4.1,18.5,15.5,11.8,12.2,19.0,14.5,17.5,22.5,26.0,24.0,9.3,11.4,27.0,10.5,4.3,5.0,11.5,26.0,40.3,42.9,26.0,21.5,,,,,-978.0,26.0,1.5384615384615383,1.7317073170731707,15.0,25.0
1992.0,,,,,281.0,296.0,23.0,12.0,165.0,175.0,26.5,10.0,100.0,100.0,15.0,15.0,16.0,21.0,14.0,22.5,0.0,0.0,0.0,0.0,4.5,5.7,21.5,19.0,6209.0,17.0,5.6,6.6,20.5,19.0,33.0,,,,,,,,,,,299.0,58.5,57.7,15.0,10.0,293.0,22.0,8.0,24.0,7.5,20.166666666666668,23.0,,,,,,,,,,,,,54.5,66.7,8.5,27.0,0.0,3.0,8.0,11.0,0.0,0.0,3.0,3.0,6.0,0.0,9.0,13.0,16.5,3.0,18.83333333333333,24.0,12.51875,12.0,12.6,13.0,12.4375,11.0,19.0,3.0,1.0,3.5,0.4736842105263158,10.0,,,,,20.0,3.9,3.9,13.0,13.5,1.0,1.0,20.0,11.5,16.5,50.0,49.0,11.0,13.5,0.0,1.0,25.5,17.0,881.0,1236.0,26.0,17.0,5.5,6.5,25.0,20.5,16.0,17.0,0.0,0.0,267.0,365.0,25.0,-98.0,26.0,21.0,511.0,508.0,22.5,7.0,0.5593561368209256,0.5522842639593909,12.0,10.0,1.65,11.0,17.0,3.3,4.9,24.5,20.0,25.0,28.0,14.5,0.5862068965517241,0.625,11.0,17.0,0.6424229721232446,0.6769527483124397,5.0,12.0,3065.0,3510.0,28.0,15.0,91.0,754.0,563.0,1.0,12.0,74.0,1.0,12.0,0.05693950177935943,0.07094594594594594,16.0,23.0,,,,,994.0,985.0,20.0,7.5,74.0,0.0,0.0,14.5,9.0,22.0,2.0,3015.0,2643.0,5.0,15.0,64.0,5.5,13.5,0.0,0.0,8.0,20.5,160.0,117.0,1.0,28.0,,,,,26.0,24.0,73.3,80.8,20.0,16.0,3399.0,11.0,0.6060606060606061,18.0,0.4406438631790745,0.4477157360406091,17.0,19.0,0.4137931034482759,0.375,18.0,12.0,0.3575770278767554,0.3230472516875603,24.0,17.0,438.0,441.0,15.5,14.0,12.0,15.0,22.0,11.5,1706.0,1675.0,11.0,14.0,19.771604938271608,27.0,0.0,0.0,14.5,14.5,0.0,2.0,45.0,8.1,6.6,21.5,17.0,334.0,230.0,22.0,21.0,36.0,19.5,19.5,22.0,30.0,18.5,25.0,12.0,20.0,15.0,27.0,29.0,0.0,0.0,14.5,14.5,33.0,13.5,4.0,11.0,10.0,18.54377104377105,25.0,,,,4771.0,5185.0,25.0,16.0,100.0,100.0,21.5,9.5,33.0,43.0,24.0,15.0,33.0,43.0,24.5,14.5,6.7,7.4,24.5,19.0,3.9,3.8,9.5,16.5,11.4,12.8,25.5,21.0,17.6,25.2,28.0,25.0,6.2,5.3,1.0,25.5,4.8,5.3,23.0,19.0,40.7,41.3,9.0,24.0,,,,,-414.0,17.0,1.717948717948718,1.947368421052632,4.0,14.0
1993.0,,,,,241.0,280.0,12.5,26.0,141.0,152.0,3.0,25.0,80.0,109.0,19.5,27.0,20.0,19.0,15.5,14.0,0.0,0.0,0.0,0.0,4.2,6.2,25.0,24.0,5825.0,27.0,5.0,6.8,24.0,23.0,27.0,,,,,,,,,,,262.0,51.6,59.6,19.5,27.0,300.0,14.0,24.5,12.0,17.5,21.416666666666668,24.0,,,,,,,,,,,,,72.7,91.4,28.0,20.5,0.0,5.0,6.0,6.0,5.0,0.0,5.0,5.0,3.0,3.0,11.0,13.0,16.5,9.5,21.83333333333333,25.0,21.31875,28.0,18.45,22.0,24.1875,27.0,28.0,0.0,2.0,15.0,0.3928571428571429,5.0,,,,,25.0,4.9,1.8,27.5,28.0,2.0,1.0,9.0,27.5,27.0,58.0,28.0,1.0,5.5,0.0,0.0,12.5,16.5,922.0,499.0,1.0,15.0,5.5,6.1,21.0,20.5,24.66666666666667,28.0,0.0,0.0,237.0,376.0,26.0,-139.0,26.0,23.0,508.0,503.0,12.0,16.0,0.5763962065331928,0.5262116716122651,20.0,6.0,1.7625,10.0,19.0,3.7,4.4,21.5,13.0,22.0,22.5,11.5,0.76,0.5945945945945946,20.0,4.0,0.7007654836464857,0.6199008768585589,20.0,4.0,3021.0,3252.0,18.0,20.0,89.0,765.0,913.0,26.0,17.0,126.0,26.0,10.0,0.08298755186721991,0.06785714285714285,13.0,6.0,,,,,949.0,1011.0,17.0,24.0,94.0,1.0,0.0,14.5,24.0,53.0,28.0,3813.0,3291.0,18.0,4.0,76.0,13.5,1.0,0.0,0.0,9.5,19.0,311.0,394.0,22.0,17.0,,,,,38.0,12.5,64.1,86.9,25.0,26.0,3295.0,20.0,0.5673758865248227,19.0,0.4236037934668072,0.4737883283877349,9.0,23.0,0.24,0.4054054054054054,9.0,25.0,0.2992345163535143,0.3800991231414411,9.0,25.0,402.0,479.0,20.0,25.0,6.0,15.0,24.5,25.0,1290.0,1994.0,23.0,27.0,17.641975308641978,22.0,0.0,0.0,14.5,14.5,0.0,1.0,39.0,7.1,5.5,23.0,19.0,274.0,132.0,27.0,21.0,29.0,24.5,14.5,22.0,35.0,22.0,27.5,16.0,32.0,28.0,25.5,36.0,0.0,0.0,14.5,14.5,22.0,25.0,-14.0,26.0,25.5,21.56902356902357,28.0,,,,4311.0,5246.0,22.0,25.0,100.0,95.0,6.5,7.0,27.0,40.0,23.5,22.0,27.0,38.0,23.5,21.0,6.5,6.7,17.0,17.0,3.2,4.2,22.0,28.0,12.6,11.3,11.5,5.0,15.9,17.8,7.5,26.0,8.2,7.4,5.0,19.5,4.5,5.2,22.5,25.0,40.6,43.3,22.5,23.0,,,,,-935.0,25.0,2.03125,1.5952380952380951,23.0,3.0
1994.0,,,,,276.0,298.0,14.0,19.0,149.0,179.0,15.0,24.0,104.0,100.0,17.5,8.0,23.0,19.0,7.0,14.5,6.0,0.0,3.0,2.0,5.5,6.7,27.0,12.5,6596.0,22.0,6.2,7.2,27.0,13.0,26.0,,,,,,,,,,,271.0,55.2,60.8,22.0,21.0,303.0,12.0,21.5,0.0,27.0,21.91666666666667,24.0,,,,,,,,,,,,,65.7,88.5,25.0,28.0,0.0,8.0,12.0,10.0,5.0,0.0,8.0,10.0,4.0,1.0,7.0,12.0,16.0,1.5,23.25,28.0,16.75,20.0,16.25,21.0,17.25,20.0,18.0,0.0,0.0,1.5,0.3888888888888889,5.0,,,,,16.0,3.3,1.8,28.0,17.0,0.0,2.0,9.0,28.0,13.0,70.0,44.0,1.5,11.0,0.0,0.0,8.5,20.0,1422.0,941.0,3.0,12.0,6.3,6.5,24.0,5.0,15.833333333333336,16.0,0.0,0.0,251.0,351.0,20.0,-100.0,26.0,26.0,491.0,498.0,5.0,22.0,0.5478443743427971,0.5253549695740365,25.0,16.0,1.4326923076923077,23.0,17.0,3.5,5.0,27.5,20.0,25.0,23.5,22.5,0.68,0.6578947368421053,11.0,9.0,0.6867900715187211,0.6319340329835083,25.0,12.0,3265.0,3372.0,11.0,17.0,93.0,805.0,690.0,6.0,12.0,94.0,7.0,11.0,0.08333333333333333,0.06375838926174497,21.0,12.0,,,,,951.0,986.0,6.0,25.0,74.0,0.0,0.0,14.5,12.5,19.0,1.0,2853.0,2904.0,7.0,23.0,68.0,5.5,19.5,1.0,0.0,9.0,8.5,248.0,103.0,1.0,23.0,,,,,28.0,25.0,75.2,91.2,28.0,19.0,3436.0,18.0,0.6979865771812079,6.0,0.4521556256572029,0.4746450304259635,4.0,13.0,0.31999999999999995,0.3421052631578947,18.0,20.0,0.3132099284812789,0.36806596701649175,4.0,17.0,430.0,468.0,22.0,17.0,8.0,13.0,19.0,23.0,1489.0,1964.0,26.0,22.0,17.061728395061728,23.0,0.0,0.0,14.5,14.5,0.0,0.0,30.0,5.8,3.9,27.5,15.0,171.0,114.0,28.0,10.0,20.0,28.0,13.0,35.0,26.0,9.0,5.5,23.0,23.0,15.5,12.0,23.0,0.0,0.0,14.5,14.5,21.0,26.0,-2.0,17.0,3.5,18.38047138047138,26.0,,,,4754.0,5336.0,21.0,20.0,100.0,100.0,19.5,10.5,20.0,38.0,22.0,27.0,20.0,38.0,22.5,27.0,7.0,7.0,20.0,8.0,3.5,4.2,26.5,21.5,12.7,11.5,13.5,2.5,20.3,21.4,14.0,20.5,8.9,5.4,1.0,14.0,5.0,5.4,26.0,11.5,38.6,42.7,21.0,27.0,,,,,-582.0,23.0,2.0,1.6666666666666663,24.0,7.5
1995.0,,,,,283.0,336.0,26.0,26.5,159.0,202.0,26.0,22.5,101.0,104.0,16.0,17.0,23.0,30.0,28.0,15.0,1.0,0.0,0.0,1.0,3.8,6.4,26.0,28.5,6737.0,26.0,5.0,6.9,25.5,26.0,26.0,,,,,,,,,,,267.0,52.7,62.1,26.0,27.0,346.0,23.0,27.0,12.0,23.0,20.916666666666668,23.0,,,,,,,,,,,,,73.1,77.5,15.0,22.0,1.0,6.0,7.0,9.0,3.0,1.0,5.0,5.0,5.0,3.0,14.0,16.0,9.0,19.5,20.875,25.0,18.7625,27.0,22.9,28.0,14.625,16.0,25.0,1.0,1.0,17.0,0.56,19.0,,,,,20.0,3.9,2.5,24.5,25.5,1.0,0.0,14.0,23.5,21.5,76.0,46.0,2.0,3.0,0.0,0.0,12.5,19.0,1443.0,856.0,1.0,18.0,5.2,6.8,29.0,25.0,23.58333333333333,27.0,0.0,1.0,238.0,335.0,12.5,-97.0,26.0,29.0,507.0,557.0,18.0,24.0,0.5858480749219563,0.5645004849660524,18.0,14.0,1.5742574257425743,21.0,5.0,1.0,3.4,11.0,30.0,19.0,10.5,30.0,0.2083333333333333,0.5757575757575758,20.0,30.0,0.6505944517833554,0.6929271708683473,9.0,20.0,2955.0,3958.0,26.0,26.0,113.0,882.0,698.0,5.0,21.0,87.0,4.0,23.0,0.0812720848056537,0.08928571428571429,6.0,10.0,,,,,961.0,1031.0,16.5,29.5,78.0,1.0,0.0,15.5,25.0,40.0,24.5,3339.0,2360.0,2.0,9.0,59.0,2.0,11.0,0.0,0.0,11.0,20.5,293.0,335.0,19.0,17.5,,,,,29.0,19.0,60.3,85.4,23.0,29.0,3341.0,24.0,0.6352201257861635,10.0,0.4141519250780437,0.4354995150339476,13.0,17.0,0.7916666666666666,0.4242424242424242,11.0,1.0,0.3494055482166446,0.3070728291316527,22.0,11.0,398.0,449.0,17.0,22.5,19.0,14.0,17.5,4.0,1587.0,1754.0,15.0,19.0,13.296296296296296,9.0,0.0,0.0,15.5,15.5,0.0,0.0,56.0,9.9,4.3,29.0,28.0,386.0,140.0,28.0,29.0,25.0,29.0,29.0,26.0,40.0,25.0,28.5,19.0,31.0,27.0,28.0,34.0,0.0,0.0,15.5,15.5,30.0,16.0,-4.0,22.0,22.0,19.80808080808081,28.0,,,,4542.0,5712.0,27.0,27.0,100.0,96.8,7.0,9.5,25.0,31.0,8.0,28.0,25.0,30.0,9.0,28.0,6.6,7.4,26.5,20.5,4.0,3.9,15.0,12.0,12.5,11.8,19.0,4.0,19.0,18.6,2.5,29.0,10.1,8.4,12.0,11.0,4.7,5.5,26.0,24.0,42.8,40.0,4.0,9.0,,,,,-1170.0,30.0,1.65,1.8974358974358976,4.5,21.0
1996.0,,,,,260.0,296.0,14.5,27.0,152.0,156.0,5.0,24.0,90.0,114.0,23.0,22.5,18.0,26.0,18.5,26.5,2.0,0.0,1.0,0.0,3.9,4.6,11.5,28.5,6299.0,29.0,4.6,5.4,12.5,29.0,21.0,,,,,,,,,,,274.0,55.5,61.8,26.0,22.0,311.0,16.0,23.0,0.0,29.5,14.416666666666664,13.0,,,,,,,,,,,,,78.1,70.4,5.5,16.0,2.0,8.0,11.0,8.0,3.0,2.0,7.0,8.0,7.0,1.0,14.0,12.0,18.5,22.0,15.958333333333336,15.0,22.74375,28.0,23.55,29.0,21.9375,23.0,28.0,0.0,1.0,22.0,0.5,16.0,,,,,20.0,4.0,3.4,16.0,24.0,0.0,3.0,17.0,17.5,21.0,55.0,51.0,3.0,25.0,0.0,0.0,11.5,19.5,1287.0,972.0,2.0,22.5,5.2,5.4,8.0,27.5,26.91666666666667,28.0,0.0,0.0,221.0,293.0,8.5,-72.0,25.0,30.0,494.0,503.0,7.0,21.5,0.5261044176706827,0.5512295081967213,17.0,22.0,1.6888888888888889,19.0,12.0,2.4,3.4,9.5,30.0,17.0,7.5,29.0,0.6,0.5666666666666667,22.0,18.0,0.6318350324374421,0.6076028250934774,27.0,22.0,2727.0,2925.0,4.0,29.0,95.0,787.0,810.0,13.0,9.0,101.0,11.0,9.5,0.06923076923076922,0.08783783783783784,14.0,21.0,,,,,996.0,976.0,5.0,22.0,71.0,1.0,0.0,15.5,24.5,38.0,16.5,3058.0,3212.0,15.0,23.0,74.0,12.0,22.5,1.0,0.0,10.0,6.5,481.0,248.0,6.0,6.0,,,,,41.0,9.5,64.4,76.7,18.0,29.0,2944.0,29.0,0.5921052631578947,12.0,0.4738955823293173,0.44877049180327866,14.0,9.0,0.4,0.43333333333333335,9.0,13.0,0.3681649675625579,0.3923971749065226,4.0,9.0,472.0,438.0,13.0,11.5,8.0,13.0,18.5,25.0,1589.0,1889.0,22.0,22.0,9.95679012345679,1.0,0.0,0.0,15.5,15.5,0.0,0.0,30.0,5.7,6.5,13.0,11.5,217.0,207.0,19.5,11.0,35.0,15.5,7.5,32.0,27.0,9.0,10.5,25.0,19.0,4.5,11.5,34.0,0.0,0.0,15.5,15.5,29.0,17.0,-5.0,22.0,23.5,17.745791245791246,19.0,,,,4316.0,4814.0,11.0,28.0,94.7,100.0,21.0,28.0,19.0,32.0,14.5,29.0,18.0,32.0,15.0,29.5,6.0,6.2,6.5,27.5,3.4,4.3,27.5,25.5,10.7,10.1,1.0,26.0,23.4,19.1,2.0,8.0,11.7,6.5,3.5,5.0,4.3,4.9,13.5,29.0,43.1,43.4,19.0,17.0,,,,,-498.0,24.0,1.7647058823529411,1.4418604651162792,29.0,15.5
1997.0,,,,,249.0,265.0,3.5,29.0,134.0,155.0,7.0,28.0,88.0,96.0,13.5,20.5,27.0,14.0,1.5,6.5,3.0,0.0,0.0,4.0,5.3,4.8,10.0,15.0,6290.0,28.0,6.2,5.8,9.0,14.0,38.0,,,,,,,,,,,224.0,55.4,62.7,30.0,20.0,325.0,25.5,29.0,6.0,25.0,8.5,4.0,,,,,,,,,,,,,76.5,62.1,1.0,19.5,0.0,5.0,3.0,6.0,3.0,0.0,5.0,2.0,5.0,1.0,11.0,13.0,15.0,11.5,12.75,9.0,15.39375,18.0,18.85,24.0,11.9375,11.0,31.0,0.0,1.0,23.5,0.3548387096774194,3.0,,,,,12.0,3.0,2.5,24.0,16.5,0.0,4.0,13.0,22.5,10.5,51.0,44.0,2.0,27.0,0.0,1.0,24.0,21.5,1075.0,957.0,2.0,29.0,5.6,5.4,8.0,17.0,20.58333333333333,23.0,1.0,0.0,299.0,263.0,2.0,36.0,12.0,23.5,404.0,518.0,14.5,30.0,0.4765027322404372,0.5723014256619144,10.0,27.0,1.5227272727272727,23.0,21.0,5.2,2.5,4.0,6.0,13.0,3.0,12.5,0.5833333333333334,0.5652173913043478,22.0,18.0,0.5580438756855576,0.6506050129645635,14.0,28.0,2442.0,3011.0,10.0,30.0,77.0,660.0,814.0,11.0,2.0,93.0,7.5,1.0,0.10843373493975904,0.052830188679245285,28.0,3.0,,,,,915.0,982.0,8.0,30.0,84.0,1.0,0.0,15.5,23.0,42.0,18.0,3621.0,3661.0,18.0,12.0,88.0,19.5,15.0,1.0,0.0,10.0,7.0,645.0,388.0,13.0,2.0,,,,,51.0,4.0,80.4,79.2,17.0,12.0,2638.0,30.0,0.6567164179104478,8.0,0.5234972677595628,0.4276985743380856,21.0,4.0,0.4166666666666666,0.4347826086956522,9.0,13.0,0.4419561243144424,0.3493949870354365,17.0,3.0,479.0,420.0,7.0,8.0,15.0,10.0,7.5,10.0,1934.0,1617.0,6.0,11.0,13.148148148148149,12.0,0.0,0.0,15.5,15.5,0.0,1.0,32.0,7.3,7.8,11.5,16.0,196.0,331.0,7.5,4.0,44.0,11.0,6.5,17.0,29.0,12.0,29.0,13.0,18.0,5.5,28.5,23.0,0.0,0.0,15.5,15.5,26.0,20.0,3.0,12.5,11.5,14.16161616161616,9.0,,,,4376.0,4628.0,3.0,29.0,91.4,100.0,20.5,30.0,35.0,25.0,3.0,14.0,32.0,25.0,3.0,19.5,6.5,6.5,9.5,19.5,4.0,3.9,14.5,13.5,11.8,10.3,1.5,19.0,21.1,21.8,13.0,23.0,12.6,9.2,14.0,4.0,4.8,4.7,7.5,17.5,43.1,41.6,5.0,13.0,,,,,-252.0,18.0,1.625,1.6666666666666667,17.0,18.0
1998.0,188.0,185.0,12.5,15.0,262.0,244.0,1.0,26.0,139.0,148.0,3.5,28.0,111.0,75.0,4.5,7.0,12.0,21.0,5.5,30.0,6.0,0.0,3.0,0.0,4.6,4.9,7.0,23.0,6903.0,20.0,5.3,5.9,9.5,24.0,36.0,160.0,142.0,6.5,7.0,2.3000000000000007,9.0,33.0,30.7,13.5,5.5,234.0,52.1,57.9,20.5,28.0,274.0,8.0,30.0,6.0,25.0,7.5,3.0,,,,,,,,,,,,,75.0,86.7,25.5,21.5,1.0,7.0,12.0,7.0,1.0,0.0,7.0,8.0,5.0,1.0,13.0,14.0,8.5,18.0,13.5,10.5,15.275,14.0,21.3,27.0,9.25,7.5,23.0,0.0,0.0,14.5,0.5652173913043478,26.0,12.543602693602693,11.0,12.2,11.0,18.0,4.0,2.5,24.0,25.5,1.0,2.0,12.0,27.0,20.5,59.0,62.0,16.0,20.5,0.0,1.0,22.5,22.5,1399.0,1333.0,16.0,12.0,5.5,5.4,6.0,21.0,19.33333333333333,19.0,0.0,0.0,314.0,295.0,5.0,19.0,12.0,18.0,449.0,473.0,5.0,29.0,0.477,0.5513513513513514,16.0,30.0,1.2522522522522523,28.0,21.0,4.7,3.2,4.0,10.0,15.0,1.0,15.0,0.6363636363636364,0.5555555555555556,25.0,17.0,0.5481699621371476,0.6356731875719217,18.0,30.0,2606.0,2762.0,2.0,27.0,99.0,840.0,669.0,1.0,7.0,88.0,1.0,7.0,0.04580152671755725,0.0860655737704918,18.0,30.0,5.4,5.0,2.5,17.0,1000.0,925.0,1.0,17.0,81.0,0.0,0.0,15.5,11.5,38.0,15.0,3340.0,3654.0,21.0,19.0,87.0,22.0,15.0,2.0,1.0,22.5,3.0,559.0,302.0,7.0,3.0,1.53,1.43,7.0,17.0,41.0,13.0,70.3,76.9,13.0,23.0,2787.0,28.0,0.7985611510791367,3.0,0.523,0.4486486486486486,15.0,1.0,0.3636363636363637,0.4444444444444444,6.0,14.0,0.4518300378628524,0.3643268124280783,13.0,1.0,523.0,415.0,11.0,3.0,12.0,12.0,16.0,13.5,2148.0,1583.0,8.0,4.0,11.47530864197531,4.0,28.2,28.1,12.0,17.0,0.0,1.0,28.0,5.9,7.3,15.5,7.5,181.0,252.0,17.0,4.0,37.0,21.5,7.0,28.0,30.0,13.5,15.0,21.0,26.0,21.5,19.0,31.0,16.0,11.4,24.0,20.0,26.0,20.0,-5.0,21.0,18.0,12.887205387205386,10.0,30080.0,26270.0,10.0,4754.0,4345.0,2.0,22.0,96.7,100.0,21.0,23.0,30.0,29.0,5.5,20.0,29.0,29.0,8.0,20.0,6.2,6.4,7.0,25.0,4.1,3.8,11.0,11.0,11.9,11.0,2.0,16.5,23.7,21.5,13.0,10.0,13.6,7.9,5.5,1.0,4.8,4.7,4.5,22.0,41.2,42.0,2.0,26.0,25.0,23.1,4.0,17.5,409.0,9.0,1.5121951219512195,1.6842105263157896,18.0,26.0
1999.0,206.0,198.0,22.0,5.5,245.0,228.0,1.0,29.0,132.0,144.0,2.5,30.0,97.0,75.0,5.0,14.5,16.0,9.0,1.0,30.0,2.0,0.0,0.0,0.0,4.3,3.5,1.0,24.5,6015.0,31.0,5.4,4.3,1.0,23.5,27.0,150.0,134.0,1.0,13.0,1.3000000000000045,13.0,32.2,30.9,12.0,15.0,268.0,60.0,52.7,1.0,4.5,302.0,12.5,30.0,14.0,21.5,6.666666666666668,4.0,,,,,,,,,,,,,84.4,77.4,16.5,9.0,0.0,8.0,12.0,8.0,4.0,0.0,8.0,10.0,6.0,3.0,19.0,10.0,22.5,29.0,12.5,9.0,21.05,27.0,22.6,29.0,19.5,19.0,25.0,0.0,3.0,15.5,0.76,29.0,14.206397306397307,12.0,13.3,12.0,16.0,3.6,3.7,11.0,21.5,2.0,1.0,21.0,9.5,12.5,55.0,61.0,12.0,27.0,0.0,0.0,11.0,21.0,1116.0,1074.0,4.0,26.0,5.1,4.7,2.0,26.0,26.25,29.0,0.0,0.0,270.0,235.0,3.0,35.0,14.0,27.0,447.0,573.0,22.0,31.0,0.4934409687184662,0.6305015353121801,2.0,31.0,1.3608247422680413,29.0,18.0,4.0,1.9,1.0,13.0,11.0,1.0,23.0,0.72,0.5789473684210527,24.0,8.0,0.5825105782792666,0.6712616822429907,15.0,30.0,2478.0,2873.0,2.0,30.0,75.0,583.0,727.0,5.0,2.0,88.0,3.5,2.0,0.0653061224489796,0.03947368421052632,31.0,25.0,5.0,5.1,7.5,27.5,991.0,977.0,7.0,24.0,90.0,0.0,0.0,16.0,12.5,49.0,28.0,3882.0,4151.0,29.0,8.0,101.0,30.0,7.0,0.0,0.0,9.5,22.5,357.0,360.0,16.0,19.0,1.24,1.04,1.0,27.0,43.0,10.5,76.5,60.1,1.0,17.0,2781.0,30.0,0.7348484848484849,3.0,0.5065590312815338,0.3694984646878199,30.0,1.0,0.28,0.42105263157894735,8.0,24.0,0.41748942172073344,0.3287383177570093,17.0,2.0,502.0,361.0,2.0,4.0,7.0,8.0,8.0,27.5,1776.0,1407.0,5.0,15.0,11.524691358024693,1.0,25.2,21.7,3.5,24.0,1.0,1.0,42.0,8.6,7.0,14.0,24.5,303.0,291.0,6.5,23.0,43.0,10.0,18.5,32.0,31.0,16.5,14.0,27.0,24.0,13.0,8.5,35.0,16.0,14.6,15.0,22.0,31.0,15.0,-4.0,17.5,24.0,15.112794612794614,15.0,30900.0,26532.0,3.0,4254.0,4280.0,3.0,28.0,100.0,100.0,21.5,10.5,25.0,23.0,3.5,28.0,25.0,23.0,4.0,28.0,6.2,5.5,1.5,26.0,3.5,3.9,16.0,23.5,10.4,10.5,3.0,29.5,20.3,17.6,2.0,19.5,8.3,7.3,7.0,22.0,4.3,4.4,3.0,28.5,43.1,41.1,9.5,8.0,20.5,21.6,2.5,28.0,-26.0,19.0,1.7714285714285716,1.4102564102564104,31.0,14.0
2000.0,196.0,203.0,30.0,7.0,275.0,283.0,11.0,23.0,144.0,180.0,18.0,24.0,111.0,84.0,8.5,10.0,20.0,19.0,6.0,23.5,1.0,0.0,1.0,2.0,5.0,3.6,2.5,15.0,6524.0,27.0,6.0,4.5,2.5,14.0,43.0,147.0,145.0,11.5,21.5,-0.1999999999999993,18.5,31.8,32.0,20.0,13.0,237.0,54.7,57.1,13.0,28.0,339.0,27.0,29.0,38.0,3.0,8.333333333333334,6.0,-51.6,-6.04,111.91,3.0,15.0,-36.14,14.34,21.0,16.0,141.19,4.0,16.0,82.4,68.8,3.0,11.5,0.0,8.0,10.0,9.0,7.0,0.0,8.0,8.0,7.0,5.0,11.0,16.0,8.0,10.5,7.75,2.0,13.6875,12.0,18.25,20.0,9.125,4.0,16.0,1.0,0.0,2.0,0.6875,29.0,12.427272727272728,10.0,12.4,10.0,13.0,3.0,4.2,5.0,14.0,4.0,1.0,25.0,3.5,6.5,55.0,74.0,26.0,25.5,0.0,0.0,10.5,22.5,1255.0,1688.0,26.0,23.0,5.5,4.9,2.0,18.0,14.583333333333336,12.0,1.0,0.0,388.0,269.0,7.5,119.0,4.0,6.5,433.0,594.0,31.0,30.0,0.490114464099896,0.6198662846227316,4.0,28.0,1.2972972972972974,27.0,18.0,4.2,2.5,5.0,9.5,15.0,7.0,20.5,0.5,0.5555555555555556,23.0,26.0,0.5556033555603356,0.6566666666666666,12.0,29.0,2583.0,3152.0,13.0,26.0,82.0,702.0,688.0,3.0,6.0,95.0,6.5,3.0,0.07272727272727272,0.06713780918727916,24.0,24.0,5.1,5.3,10.5,28.0,961.0,1047.0,25.0,24.0,85.0,0.0,0.0,16.0,10.0,41.0,22.0,3551.0,3560.0,22.0,13.0,89.0,25.0,12.5,1.0,1.0,24.0,8.0,337.0,408.0,23.0,17.0,1.71,1.26,5.5,12.0,39.0,10.5,76.2,65.0,5.0,16.0,2824.0,26.0,0.7708333333333334,5.0,0.509885535900104,0.3801337153772684,28.0,4.0,0.5,0.4444444444444444,9.0,6.0,0.4443966444396644,0.3433333333333334,20.0,3.0,490.0,398.0,9.0,10.0,18.0,12.0,13.5,5.5,2066.0,1648.0,9.0,9.0,15.111111111111109,18.0,32.7,24.1,5.0,11.0,1.0,0.0,38.0,8.1,8.5,5.5,22.0,241.0,332.0,3.0,14.0,55.0,2.5,16.0,34.0,32.0,20.5,7.0,28.0,22.0,13.5,6.5,24.0,10.2,19.7,3.5,2.0,41.0,4.5,17.0,3.5,5.5,12.454545454545455,7.0,28812.0,29435.0,17.0,4649.0,4800.0,9.0,21.0,100.0,100.0,19.5,12.5,42.0,25.0,7.0,7.0,42.0,25.0,7.5,7.0,6.5,5.9,2.0,16.0,4.2,4.1,16.0,13.5,11.9,10.3,1.0,12.5,22.8,22.8,22.0,9.5,8.6,10.0,19.0,20.5,4.8,4.6,4.5,19.0,41.8,40.0,4.5,16.0,23.7,23.4,4.0,23.0,-151.0,19.0,1.5476190476190474,1.4390243902439026,29.0,22.0
2001.0,184.0,190.0,17.0,23.5,298.0,262.0,4.0,9.0,189.0,156.0,7.0,4.5,84.0,86.0,9.0,25.0,25.0,20.0,12.0,9.0,4.0,0.0,3.0,3.0,4.8,3.9,2.0,22.0,6586.0,26.0,5.6,4.8,2.0,22.0,34.0,166.0,144.0,4.0,4.0,4.900000000000002,1.0,34.1,29.2,3.5,2.0,362.0,61.1,55.4,3.5,7.5,273.0,3.0,3.0,18.0,17.0,7.916666666666668,5.5,-33.5,0.6,40.33,10.0,13.0,-34.5,41.69,13.0,14.0,96.69,9.0,11.0,80.0,86.2,28.5,13.5,0.0,12.0,10.0,10.0,3.0,0.0,11.0,10.0,7.0,0.0,10.0,11.0,21.5,8.5,10.75,6.0,15.94375,17.5,12.7,11.0,19.1875,22.0,20.0,0.0,0.0,5.0,0.5,21.0,10.035858585858588,3.0,6.4,3.0,12.0,2.0,5.7,2.0,2.0,2.0,0.0,28.0,2.0,3.5,54.0,63.0,11.5,27.5,0.0,0.0,11.5,20.0,1208.0,1321.0,13.0,22.0,5.2,5.5,8.5,28.0,18.916666666666668,23.0,1.0,0.0,324.0,280.0,8.0,44.0,10.0,15.0,592.0,493.0,8.0,3.0,0.6108986615678776,0.5631578947368421,14.0,5.0,2.25,6.0,13.0,2.2,4.1,17.5,29.0,20.0,17.0,28.5,0.43333333333333335,0.7142857142857143,5.0,31.0,0.7079250106518961,0.6342144852783149,18.0,2.0,3323.0,2951.0,5.0,15.0,77.0,672.0,742.0,10.0,8.0,91.0,11.0,7.0,0.08389261744966442,0.07633587786259542,17.5,11.0,5.9,5.2,4.0,2.5,1046.0,950.0,3.0,4.0,83.0,0.0,0.0,16.0,12.0,44.0,23.5,3382.0,3237.0,12.0,16.0,78.0,15.0,12.0,1.0,1.0,25.5,6.5,396.0,380.0,18.0,15.0,1.6,1.43,10.0,12.0,38.0,15.5,77.4,65.3,2.0,16.0,3621.0,16.0,0.4444444444444444,26.0,0.3891013384321224,0.4368421052631579,18.0,27.0,0.5666666666666667,0.2857142857142857,27.0,1.0,0.29207498934810394,0.36578551472168497,14.0,30.0,407.0,415.0,10.0,25.0,17.0,8.0,6.0,2.5,1371.0,1702.0,12.0,30.0,14.351851851851851,12.0,31.5,27.9,12.5,11.0,0.0,0.0,47.0,7.4,7.9,7.0,18.0,298.0,272.0,12.0,24.0,42.0,12.0,24.5,35.0,29.0,11.5,6.0,28.0,25.0,19.0,6.5,22.0,10.3,18.9,3.0,2.0,39.0,3.0,17.0,2.0,5.0,13.671717171717177,8.0,30544.0,27360.0,4.0,4694.0,4653.0,6.0,26.5,100.0,100.0,22.5,8.0,30.0,25.0,7.0,20.5,30.0,25.0,7.0,18.5,6.1,6.5,11.0,27.0,3.4,4.1,18.0,30.0,10.0,11.8,20.0,29.0,22.4,21.0,12.0,11.0,10.4,8.6,11.0,13.0,4.5,4.9,12.5,28.5,40.7,41.5,13.0,25.0,25.5,24.3,6.0,20.5,41.0,15.0,1.7941176470588234,1.5853658536585369,23.0,10.0
2002.0,187.0,197.0,26.0,19.0,287.0,236.0,1.0,23.0,172.0,131.0,1.0,17.0,90.0,79.0,3.0,23.0,25.0,26.0,17.0,15.5,3.0,0.0,2.0,0.0,5.7,2.3,1.0,13.0,6750.0,26.0,6.5,3.1,1.0,12.5,35.0,165.0,140.0,3.0,5.5,3.5999999999999983,5.0,32.4,28.8,3.0,8.0,348.0,61.4,50.8,1.0,13.0,259.0,1.0,12.0,34.0,2.0,2.25,1.0,-38.42,49.78,234.62,1.0,12.0,-74.56,33.06,10.0,29.0,285.85,1.0,22.0,82.1,73.9,11.5,7.5,0.0,8.0,15.0,10.0,6.0,0.0,7.0,14.0,6.0,5.0,11.0,7.0,30.5,12.0,5.75,1.0,18.3875,23.0,11.4,13.0,25.375,29.0,24.0,1.0,0.0,12.5,0.4583333333333333,10.0,7.842424242424244,2.0,3.7,1.0,10.0,1.8,6.1,1.0,2.5,4.0,3.0,31.0,1.0,3.5,45.0,72.0,15.0,32.0,0.0,0.0,10.0,23.0,1085.0,1567.0,18.0,31.0,5.7,4.5,1.0,20.5,19.75,22.0,0.0,0.0,346.0,196.0,1.0,150.0,2.0,18.0,567.0,510.0,5.0,11.0,0.5949119373776908,0.5742471443406023,15.0,8.0,1.9111111111111112,13.0,23.0,4.1,2.0,1.0,14.5,10.0,1.0,14.5,0.7931034482758621,0.5555555555555556,24.0,1.0,0.6887245101959216,0.6157270029673589,24.0,8.0,3445.0,2490.0,1.0,15.0,103.0,789.0,749.0,5.0,9.0,93.0,3.0,14.5,0.08710801393728224,0.11016949152542373,3.0,17.0,5.7,5.0,1.5,13.0,1022.0,963.0,3.0,19.0,91.0,0.0,0.0,16.5,7.5,42.0,26.0,3879.0,4396.0,32.0,5.0,99.0,31.0,4.5,1.0,0.0,10.5,11.5,430.0,433.0,25.0,8.0,1.6,0.9,1.0,22.0,44.0,6.0,86.3,48.4,1.0,6.0,3665.0,15.5,0.5232558139534884,20.0,0.4050880626223092,0.4257528556593977,18.0,25.0,0.2068965517241379,0.4444444444444444,9.0,32.0,0.3112754898040784,0.38427299703264095,9.0,25.0,414.0,410.0,10.5,24.0,6.0,8.0,3.0,31.5,1557.0,1554.0,5.5,27.0,14.611111111111114,10.0,32.6,17.8,1.0,18.0,2.0,0.0,41.0,6.7,7.8,6.0,20.0,220.0,295.0,6.0,16.0,43.0,7.0,22.0,39.0,23.0,4.5,3.0,32.0,17.0,4.0,1.5,21.0,10.7,18.3,4.0,5.5,38.0,4.0,17.0,1.5,6.0,11.984848484848484,4.0,30855.0,27580.0,6.0,5002.0,4044.0,1.0,24.0,100.0,100.0,24.0,11.0,32.0,19.0,1.0,25.0,32.0,19.0,1.0,24.0,6.5,5.5,1.0,20.0,3.8,3.8,5.5,27.0,10.5,10.8,7.5,28.0,24.1,21.8,16.5,4.0,9.8,10.3,20.5,15.0,4.9,4.2,1.0,24.0,42.6,44.4,32.0,5.0,26.7,20.4,1.0,23.0,958.0,4.0,1.7105263157894737,1.4473684210526316,27.0,13.0
2003.0,188.0,189.0,17.0,17.5,307.0,249.0,4.0,11.0,190.0,140.0,3.0,6.5,86.0,89.0,8.5,26.5,31.0,20.0,5.5,5.5,2.0,0.0,1.0,0.0,5.5,4.2,3.0,13.0,6944.0,19.0,5.9,5.0,3.0,15.5,36.0,165.0,148.0,10.0,5.5,-2.599999999999998,26.0,29.8,32.4,23.5,29.0,369.0,62.3,57.7,9.0,8.5,274.0,4.0,3.0,26.0,6.5,6.416666666666668,4.0,-68.35,-5.47,76.34,4.0,16.0,-50.59,39.0,10.0,25.0,132.5,3.0,18.0,61.5,73.5,7.0,31.0,0.0,9.0,6.0,8.0,3.0,0.0,9.0,3.0,3.0,1.0,9.0,13.0,9.5,8.0,11.5,6.0,16.79375,20.0,9.9,10.0,23.6875,28.0,23.0,1.0,1.0,11.5,0.39130434782608703,7.0,13.613973063973065,12.0,12.1,11.0,22.0,3.7,4.2,7.5,21.0,3.0,4.0,20.0,10.0,29.5,55.0,59.0,9.0,32.0,0.0,0.0,11.5,22.0,1042.0,1393.0,13.0,32.0,6.2,5.3,6.5,10.5,15.583333333333336,15.0,0.0,0.0,301.0,264.0,4.0,37.0,14.0,18.0,592.0,475.0,4.0,3.0,0.5936293436293436,0.5311850311850311,23.0,4.0,2.209302325581396,4.0,27.0,4.6,3.4,9.0,9.0,16.0,5.0,5.5,0.84375,0.7272727272727273,3.5,1.0,0.6977810379607555,0.6068069861173311,23.0,4.0,3805.0,2710.0,3.0,6.0,117.0,1104.0,817.0,13.0,31.0,104.0,16.0,25.0,0.1009771986970684,0.08032128514056225,23.0,8.0,5.6,5.3,8.5,10.0,1036.0,962.0,6.0,10.0,83.0,0.0,0.0,16.5,8.5,39.0,20.0,3590.0,3559.0,24.5,9.0,82.0,21.5,14.0,0.0,0.0,9.5,22.5,242.0,489.0,29.0,28.0,1.45,1.25,5.0,21.0,35.0,20.5,81.5,69.7,6.0,12.0,3941.0,6.0,0.4526315789473685,29.0,0.4063706563706564,0.4688149688149689,10.0,29.0,0.15625,0.2727272727272727,29.5,32.0,0.3022189620392445,0.393193013882669,10.0,29.0,421.0,451.0,17.0,23.0,5.0,6.0,1.5,31.0,1648.0,1756.0,13.0,24.0,26.135802469135804,32.0,25.5,25.4,5.0,24.0,1.0,0.0,23.0,3.7,7.0,8.5,3.0,136.0,234.0,11.0,4.5,36.0,14.5,5.0,26.0,34.0,26.5,23.0,16.0,25.0,20.0,30.5,31.0,16.0,16.4,8.0,25.0,33.0,9.0,2.0,11.5,22.0,15.127946127946132,13.0,31020.0,27972.0,5.0,5453.0,4466.0,5.0,10.0,97.1,100.0,23.0,21.5,34.0,27.0,5.5,16.5,33.0,27.0,6.0,16.5,6.7,6.2,9.5,16.0,3.9,3.9,10.0,22.0,10.7,10.7,6.5,27.0,18.9,23.6,28.0,32.0,6.9,12.5,29.0,27.0,5.3,4.6,5.0,10.5,43.3,43.4,31.5,6.0,29.0,23.6,5.0,12.5,987.0,4.0,1.717948717948718,1.58974358974359,17.0,10.0
2004.0,194.0,187.0,16.5,9.0,271.0,258.0,4.5,25.5,175.0,131.0,2.0,14.0,74.0,101.0,17.0,31.0,22.0,26.0,13.5,26.5,4.0,0.0,1.0,0.0,5.7,4.7,6.0,13.0,6975.0,24.0,6.7,5.8,8.5,14.0,37.0,147.0,155.0,16.5,22.0,-1.8999999999999984,26.0,30.1,32.0,25.0,23.0,340.0,66.4,56.7,8.0,3.0,247.0,2.0,7.0,18.0,13.0,9.75,7.0,-94.19,-3.75,46.38,4.0,18.0,-80.9,31.02,15.0,30.0,91.42,7.0,25.0,62.5,64.5,1.0,31.5,0.0,7.0,9.0,6.0,2.0,0.0,6.0,5.0,2.0,2.0,18.0,11.0,20.0,29.0,12.625,6.0,20.3875,27.0,12.65,12.0,28.125,31.5,32.0,2.0,1.0,26.5,0.5625,24.0,18.72878787878788,21.0,19.7,22.0,18.0,3.5,3.7,11.0,21.0,1.0,4.0,16.0,17.5,21.0,60.0,58.0,9.0,26.0,0.0,1.0,24.0,22.0,1450.0,1315.0,11.0,18.5,6.2,5.4,3.5,16.5,23.16666666666667,26.0,0.0,0.0,301.0,304.0,9.5,-3.0,17.0,23.0,512.0,436.0,2.0,20.0,0.5858798735511064,0.5005202913631633,29.0,9.0,2.3648648648648654,2.0,24.0,4.7,4.8,21.0,12.0,21.0,15.5,11.5,0.7272727272727273,0.7241379310344828,5.5,9.0,0.6999798508966351,0.5665641476274165,30.0,6.0,3474.0,2579.0,1.0,14.0,117.0,916.0,897.0,16.0,16.0,112.0,16.5,21.0,0.08118081180811808,0.1007751937984496,12.0,21.0,5.0,5.3,10.0,29.5,949.0,961.0,5.0,29.5,83.0,1.0,0.0,16.5,27.0,31.0,7.0,3514.0,3863.0,28.0,11.0,87.0,24.0,12.0,1.0,0.0,12.0,6.0,213.0,279.0,11.0,27.0,1.42,1.41,11.5,24.0,33.0,23.5,89.1,77.2,11.0,10.0,3773.0,12.0,0.4228571428571429,31.0,0.4141201264488936,0.4994797086368367,4.0,24.0,0.2727272727272727,0.27586206896551724,27.5,24.0,0.3000201491033649,0.4334358523725835,3.0,27.0,393.0,480.0,23.5,27.0,9.0,8.0,6.0,27.0,1489.0,1973.0,19.0,29.0,21.222222222222225,31.0,24.7,26.2,8.0,28.0,0.0,0.0,44.0,7.9,9.4,1.0,23.5,299.0,264.0,7.5,25.0,45.0,4.5,23.5,24.0,31.0,25.5,25.5,15.0,20.0,11.0,31.5,36.0,18.6,13.4,18.5,28.5,27.0,21.0,-9.0,24.5,26.0,17.75757575757576,21.0,28518.0,28985.0,19.0,4963.0,4552.0,5.0,22.0,97.0,97.1,4.5,29.0,33.0,35.0,12.5,19.5,32.0,34.0,12.0,20.5,7.4,6.5,6.0,12.5,3.8,4.1,15.0,26.0,11.1,11.5,12.5,22.0,24.2,22.7,23.0,4.0,6.5,9.0,22.0,27.0,5.2,4.7,3.5,16.5,42.3,44.4,31.0,13.5,25.5,24.3,7.0,22.0,411.0,12.0,1.9473684210526316,1.5853658536585369,25.0,4.0
2005.0,190.0,184.0,12.5,14.5,268.0,254.0,1.0,25.0,161.0,148.0,3.0,21.0,83.0,75.0,3.5,20.5,24.0,31.0,22.0,23.0,1.0,0.0,1.0,1.0,4.9,4.8,8.5,20.5,6725.0,27.0,5.9,5.7,8.5,20.0,33.0,158.0,155.0,17.5,12.5,-1.7999999999999972,22.5,29.6,31.4,18.0,27.0,303.0,62.2,57.8,10.5,10.0,275.0,4.0,16.0,20.0,7.0,6.0,4.0,-90.62,-44.87,33.63,6.0,24.0,-39.4,73.86,2.0,15.0,116.24,3.0,20.0,81.5,78.8,12.5,15.0,0.0,5.0,8.0,12.0,2.0,0.0,3.0,8.0,10.0,1.0,9.0,13.0,12.0,7.0,10.166666666666666,4.0,16.025,17.0,17.8,22.0,14.25,13.0,16.0,3.0,0.0,2.0,0.5625,26.0,13.925757575757576,12.0,14.2,13.0,14.0,2.9,3.6,8.0,12.5,0.0,2.0,17.0,11.5,11.0,59.0,63.0,14.5,26.0,0.0,1.0,27.0,21.5,1148.0,1368.0,12.0,28.0,5.5,5.7,11.5,24.5,18.916666666666668,20.0,0.0,0.0,300.0,274.0,8.0,26.0,14.0,20.0,487.0,476.0,7.0,20.5,0.5360406091370559,0.5389473684210526,22.0,20.0,1.9397590361445785,13.0,17.0,3.5,3.2,5.5,18.5,15.0,3.5,24.0,0.5666666666666667,0.6,16.5,22.0,0.6128074639525021,0.6590909090909091,10.0,23.0,2890.0,2929.0,6.0,25.0,131.0,1085.0,830.0,7.0,27.0,108.0,10.0,24.5,0.08955223880597014,0.1220472440944882,4.0,16.0,5.3,5.3,8.0,26.5,985.0,950.0,4.0,22.0,90.0,0.0,0.0,16.5,12.0,49.0,27.5,4101.0,3512.0,18.0,3.0,80.0,18.5,4.0,0.0,0.0,12.5,20.5,492.0,458.0,27.0,1.0,1.45,1.38,5.0,20.0,51.0,3.0,80.7,73.5,7.0,16.0,3171.0,24.0,0.515527950310559,20.0,0.4639593908629441,0.4610526315789474,11.0,13.0,0.43333333333333335,0.4,16.5,11.0,0.3871925360474979,0.3409090909090909,23.0,10.0,457.0,438.0,16.5,15.0,13.0,10.0,8.5,15.0,1826.0,1515.0,6.0,14.0,16.833333333333332,18.0,27.4,27.7,10.0,22.0,1.0,0.0,41.0,7.8,7.0,14.5,23.5,281.0,229.0,17.0,22.0,36.0,18.5,19.5,27.0,33.0,24.0,25.0,22.0,26.0,21.5,22.5,23.0,11.6,15.2,11.5,10.0,30.0,12.0,7.0,9.5,7.5,13.651515151515154,10.0,30020.0,28520.0,9.0,4716.0,4444.0,1.0,23.0,100.0,96.3,5.0,10.0,32.0,27.0,6.0,18.5,32.0,26.0,6.0,17.5,6.5,6.6,11.0,19.5,4.0,3.5,2.5,13.5,10.5,11.5,19.0,27.0,19.5,21.7,14.0,30.0,9.6,9.3,24.0,6.0,4.8,4.7,6.0,25.0,45.6,43.9,25.0,3.0,24.8,24.2,4.5,23.0,272.0,16.0,1.625,1.8857142857142857,6.0,21.5
2006.0,190.0,186.0,14.0,10.0,237.0,300.0,18.0,31.0,133.0,174.0,17.5,29.0,82.0,108.0,21.0,28.0,22.0,18.0,5.5,19.5,0.0,0.0,0.0,0.0,4.0,6.5,31.0,30.0,6197.0,32.0,4.6,7.2,30.0,31.0,23.0,144.0,167.0,28.5,30.5,-2.3999999999999986,28.0,29.0,31.4,25.0,26.0,296.0,55.3,61.1,22.0,28.0,301.0,14.5,20.0,18.0,13.0,20.166666666666668,21.5,-165.95,-122.54,-56.16,24.0,31.0,-42.14,37.96,10.0,23.0,-8.93,22.0,30.0,77.3,73.3,6.5,21.0,0.0,8.0,3.0,9.0,2.0,0.0,8.0,3.0,5.0,1.0,14.0,9.0,25.5,22.5,21.75,29.0,25.25,30.0,23.0,30.0,27.5,29.0,27.0,0.0,2.0,24.0,0.5185185185185185,18.5,25.81632996632997,32.0,29.2,31.0,18.0,3.4,2.2,29.5,19.5,3.0,1.0,11.0,29.0,20.5,61.0,46.0,3.0,19.0,0.0,0.0,13.0,20.0,1307.0,846.0,1.0,24.0,4.9,6.5,26.5,31.0,28.25,30.0,0.0,0.0,211.0,353.0,21.0,-142.0,31.0,31.0,535.0,493.0,6.0,11.0,0.5843621399176955,0.5103448275862069,27.0,7.0,1.6219512195121952,18.0,14.0,2.6,5.3,30.0,30.0,26.0,30.5,28.5,0.7,0.7027027027027027,6.0,5.0,0.6475352927563064,0.6363118952760387,19.0,15.0,2798.0,3354.0,19.0,26.0,87.0,732.0,658.0,2.0,12.0,83.0,3.0,8.5,0.09282700421940927,0.06,28.0,9.0,5.2,5.6,16.5,27.5,972.0,1015.0,20.0,25.0,93.0,0.0,0.0,16.5,11.5,50.0,29.5,4045.0,3370.0,18.0,2.0,81.0,20.0,3.0,0.0,1.0,25.0,22.0,353.0,487.0,30.0,14.0,1.01,1.75,21.0,31.0,54.0,1.0,66.2,91.0,29.0,30.0,2994.0,28.0,0.6165413533834586,15.0,0.4156378600823045,0.4896551724137931,6.0,26.0,0.30000000000000004,0.2972972972972973,27.0,28.0,0.3524647072436936,0.3636881047239613,14.0,18.0,404.0,497.0,28.0,28.0,6.0,11.0,9.5,31.0,1523.0,1917.0,17.0,28.0,17.69753086419753,22.0,19.5,31.7,17.0,31.0,0.0,0.0,33.0,5.8,4.8,29.5,12.0,196.0,166.0,28.0,13.5,25.0,30.5,15.0,22.0,30.0,19.0,32.0,17.0,22.0,11.5,32.0,32.0,16.3,10.2,30.0,27.0,20.0,30.0,-12.0,30.0,24.0,22.432659932659934,30.0,27360.0,31062.0,28.0,4321.0,5271.0,17.0,29.0,95.7,100.0,20.5,31.0,23.0,41.0,27.5,30.0,22.0,41.0,28.5,30.5,5.6,7.1,22.0,32.0,3.8,3.9,8.5,23.5,10.1,11.7,21.0,31.0,21.4,18.4,1.0,25.0,6.5,9.7,23.0,30.0,4.4,5.2,16.0,31.0,43.5,41.6,5.5,17.0,22.7,28.2,16.0,30.0,-950.0,29.0,1.4736842105263157,1.8205128205128205,8.0,26.0
2007.0,185.0,182.0,12.5,19.0,281.0,258.0,2.5,23.5,162.0,158.0,3.5,24.5,98.0,93.0,16.0,14.0,21.0,7.0,1.0,16.0,2.0,0.0,0.0,0.0,6.4,4.5,4.0,7.0,6940.0,23.0,7.3,5.3,4.0,7.0,36.0,158.0,156.0,18.0,16.5,5.600000000000001,1.0,33.1,27.5,2.0,3.0,316.0,64.5,60.6,15.0,6.0,297.0,9.0,20.0,12.0,24.0,3.4166666666666665,1.0,-3.17,18.21,24.41,7.0,16.0,-8.18,50.81,4.0,9.0,87.4,2.0,15.0,84.8,83.3,15.0,16.0,0.0,12.0,11.0,7.0,3.0,0.0,11.0,11.0,6.0,0.0,12.0,19.0,1.0,16.0,11.833333333333336,9.0,12.04375,8.0,13.15,14.0,10.9375,9.0,18.0,1.0,0.0,5.0,0.6666666666666666,30.0,8.372390572390572,3.0,6.6,4.0,8.0,1.6,3.3,13.5,2.0,1.0,2.0,16.0,18.0,1.5,48.0,68.0,19.0,31.5,1.0,1.0,20.5,11.5,1119.0,1328.0,11.0,30.0,6.4,5.2,2.5,12.0,14.0,13.5,0.0,0.0,334.0,270.0,3.0,64.0,9.0,19.0,490.0,490.0,6.5,25.0,0.5394871794871795,0.5353121801432958,26.0,24.0,1.6530612244897958,23.0,18.0,3.7,3.7,11.5,19.0,18.0,6.5,21.5,0.5454545454545454,0.6206896551724138,21.0,26.5,0.6419965576592083,0.6122219725904291,27.0,20.0,3357.0,2725.0,1.0,16.0,81.0,614.0,706.0,15.0,7.0,86.0,12.5,10.0,0.07473309608540925,0.02713178294573644,32.0,11.0,5.4,5.5,13.0,20.5,975.0,977.0,7.0,26.5,78.0,1.0,0.0,16.5,26.5,38.0,22.0,3426.0,3610.0,25.0,12.0,83.0,27.0,12.5,0.0,0.0,9.0,22.5,334.0,280.0,12.0,12.0,1.7,1.36,1.5,16.0,50.0,3.0,91.7,76.2,8.0,8.0,3579.0,16.0,0.6049382716049383,10.0,0.4605128205128205,0.4646878198567042,7.0,9.0,0.4545454545454546,0.3793103448275862,12.0,6.5,0.3580034423407917,0.3877780274095709,6.0,13.0,449.0,454.0,21.5,11.0,15.0,11.0,14.0,8.0,1872.0,1726.0,17.0,11.0,13.97530864197531,9.0,33.0,24.2,3.0,13.0,0.0,1.0,36.0,6.8,6.3,14.0,20.0,222.0,210.0,17.0,19.5,33.0,17.0,18.5,33.0,18.0,2.0,10.0,28.0,15.0,3.5,8.5,20.0,9.7,18.7,4.0,2.0,35.0,4.0,15.0,4.0,3.0,10.144781144781149,3.0,29230.0,28392.0,13.0,5229.0,4451.0,2.0,18.0,100.0,96.9,7.0,12.0,34.0,32.0,8.5,18.0,34.0,31.0,8.0,18.0,7.3,6.0,4.0,8.5,4.2,3.8,6.5,8.5,11.3,9.9,3.0,16.0,23.3,19.5,2.5,11.5,6.7,7.4,7.0,28.0,5.4,4.6,2.0,14.0,43.9,43.5,20.5,11.5,28.2,24.3,2.0,13.5,778.0,6.0,1.738095238095238,1.5789473684210529,26.0,15.0
2008.0,189.0,192.0,27.0,10.0,298.0,259.0,5.5,16.0,184.0,153.0,5.0,10.5,100.0,87.0,11.0,17.0,14.0,19.0,15.5,28.5,2.0,0.0,1.0,1.0,5.7,4.9,6.5,16.0,7581.0,11.0,6.3,5.6,7.0,19.5,38.0,163.0,147.0,5.5,16.0,3.0999999999999983,8.0,32.4,29.3,11.5,3.5,355.0,63.2,58.1,8.5,11.0,276.0,2.5,7.0,30.0,6.5,10.416666666666666,8.0,-27.62,11.21,37.84,5.0,18.0,-28.96,31.41,11.0,22.0,77.11,6.0,20.0,84.2,93.3,29.0,18.0,0.0,12.0,15.0,8.0,3.0,0.0,12.0,15.0,5.0,0.0,13.0,8.0,22.5,27.0,10.583333333333334,5.0,15.0,18.0,12.0,12.0,18.0,17.0,21.0,1.0,1.0,18.0,0.6190476190476191,28.0,11.691245791245793,8.0,9.8,7.0,13.0,2.3,4.6,3.0,7.5,3.0,2.0,22.0,4.0,13.0,60.0,74.0,25.0,23.5,1.0,0.0,11.0,7.0,1486.0,1542.0,17.0,17.0,6.1,5.9,10.0,14.5,16.75,18.0,1.0,0.0,361.0,323.0,10.0,38.0,15.0,19.0,562.0,475.0,8.0,6.0,0.5684210526315789,0.5333333333333333,22.0,15.0,1.84,12.0,18.0,3.2,4.8,27.0,24.0,23.0,24.0,20.0,0.5806451612903226,0.7419354838709677,3.0,17.0,0.6633064516129032,0.6118824009799918,24.0,12.0,3619.0,2997.0,4.0,11.0,95.0,834.0,660.0,13.0,29.0,88.0,16.5,20.0,0.04697986577181208,0.07335907335907338,14.0,30.0,5.7,5.1,2.5,13.0,1045.0,945.0,7.0,5.0,77.0,0.0,0.0,16.5,11.5,39.0,22.5,3426.0,3532.0,26.0,13.0,81.0,26.0,14.0,1.0,0.0,11.5,7.5,440.0,392.0,25.0,5.0,1.66,1.57,7.0,22.0,47.0,2.0,83.8,75.3,6.0,15.0,3788.0,11.0,0.5434782608695652,21.0,0.43157894736842106,0.4666666666666667,11.0,18.0,0.4193548387096774,0.25806451612903225,30.0,16.0,0.33669354838709675,0.3881175990200082,9.0,21.0,451.0,441.0,18.0,11.0,13.0,8.0,4.5,20.0,1837.0,1901.0,19.0,15.0,13.580246913580249,9.0,33.3,30.7,10.0,18.0,0.0,0.0,32.0,5.4,5.8,18.0,14.5,169.0,190.0,20.0,12.0,29.0,20.5,16.5,38.0,30.0,16.5,4.5,32.0,28.0,22.0,4.0,26.0,12.7,14.6,9.0,17.0,30.0,6.5,4.0,12.0,18.0,13.58249158249158,8.0,30807.0,28224.0,4.0,5456.0,4898.0,9.0,14.0,97.2,100.0,19.0,30.0,36.0,33.0,11.0,21.0,35.0,33.0,11.5,21.0,6.7,6.7,11.5,20.0,4.1,4.3,21.5,19.0,10.7,11.5,17.0,26.0,24.8,20.8,5.0,6.0,9.4,10.1,20.5,16.0,5.2,5.2,14.0,18.0,44.5,43.6,17.0,11.0,28.8,25.4,6.5,16.0,558.0,10.0,1.6341463414634148,1.5581395348837208,26.0,17.0
2009.0,194.0,190.0,21.5,6.5,246.0,324.0,29.0,28.0,148.0,171.0,9.0,26.0,80.0,129.0,31.0,25.0,18.0,24.0,18.5,24.0,4.0,0.0,2.0,0.0,3.6,5.9,19.0,28.5,6898.0,26.0,4.2,6.6,16.5,29.5,28.0,142.0,160.0,22.5,27.5,-0.7000000000000028,19.0,30.4,31.1,24.5,12.0,279.0,53.2,62.4,21.0,30.0,301.0,8.0,26.0,18.0,14.0,24.58333333333333,27.0,-152.67,-88.21,-45.87,20.0,28.0,-51.85,-8.87,29.0,29.0,-47.54,24.0,30.0,61.5,81.3,14.0,32.0,0.0,3.0,8.0,11.0,4.0,0.0,3.0,5.0,5.0,3.0,5.0,10.0,21.0,1.5,18.416666666666668,21.0,23.25,30.0,23.25,27.0,23.25,26.0,25.0,0.0,0.0,21.0,0.2,1.0,23.36936026936027,27.0,24.2,27.0,29.0,5.5,3.9,7.0,31.5,2.0,2.0,19.0,9.5,31.0,62.0,46.0,4.0,16.5,1.0,0.0,10.0,9.0,1630.0,878.0,1.0,7.0,5.3,6.5,22.0,26.0,28.0,31.0,1.0,0.0,244.0,400.0,27.0,-156.0,29.0,30.0,524.0,482.0,2.0,22.0,0.5796045785639958,0.4908565928777671,31.0,12.0,1.85,18.0,18.0,3.4,5.8,30.0,22.5,28.0,26.5,21.5,0.7826086956521741,0.6363636363636364,16.0,2.0,0.6463043478260869,0.5672764575141049,31.0,20.0,2973.0,3318.0,10.0,24.0,93.0,696.0,731.0,12.0,10.0,80.0,4.5,14.5,0.07317073170731707,0.07407407407407407,17.0,19.0,5.1,5.6,22.5,28.0,961.0,1039.0,26.0,29.0,87.0,0.0,0.0,16.5,13.5,38.0,16.5,3626.0,3082.0,10.0,10.0,72.0,10.5,8.0,1.0,0.0,11.5,5.5,462.0,311.0,18.0,3.0,1.08,2.03,27.0,30.0,40.0,8.5,59.8,87.2,21.0,30.0,3134.0,24.5,0.5405405405405406,15.0,0.42039542143600417,0.5091434071222329,2.0,21.0,0.21739130434782605,0.3636363636363637,17.0,31.0,0.3536956521739131,0.4327235424858951,2.0,13.0,404.0,529.0,29.0,25.0,5.0,16.0,22.0,31.0,1627.0,2531.0,32.0,23.0,12.530864197530866,3.0,20.1,36.8,28.0,31.0,0.0,1.0,33.0,5.9,5.5,23.5,15.0,161.0,166.0,28.0,7.0,28.0,27.0,13.5,26.0,32.0,22.5,25.5,16.0,26.0,22.0,31.5,34.0,17.5,14.2,13.0,31.0,29.0,10.5,-5.0,22.0,29.5,22.53872053872054,29.0,27548.0,30400.0,24.0,4600.0,5849.0,27.0,28.0,100.0,95.7,5.0,8.5,24.0,46.0,27.0,28.5,24.0,44.0,26.5,28.5,6.0,7.2,22.0,27.0,4.0,4.8,32.0,26.5,11.2,11.6,19.5,19.0,26.3,19.1,2.0,1.0,11.6,8.2,14.0,4.0,4.8,5.6,23.5,27.0,41.7,42.8,7.0,28.0,23.6,30.7,24.0,29.0,-1249.0,27.0,1.5,1.5,25.0,21.0
2010.0,172.0,177.0,6.0,31.0,288.0,307.0,17.0,24.0,172.0,171.0,9.0,19.0,97.0,118.0,28.0,13.5,19.0,18.0,11.0,27.0,3.0,0.0,1.0,2.0,6.9,5.2,6.5,5.0,7148.0,20.0,7.7,5.7,5.0,5.0,39.0,172.0,160.0,24.0,5.0,-0.4000000000000021,17.5,28.9,29.3,13.0,22.0,306.0,61.9,58.9,12.0,15.0,307.0,9.0,19.0,18.0,15.0,16.166666666666668,16.0,48.96,72.77,-19.41,8.0,10.0,-16.44,4.29,27.0,9.0,-5.86,17.0,11.0,82.1,81.0,13.0,17.5,0.0,6.0,10.0,10.0,2.0,0.0,6.0,10.0,6.0,1.0,13.0,9.0,21.5,24.0,18.25,22.5,13.5125,15.0,11.4,11.0,15.625,13.0,24.0,0.0,1.0,20.5,0.5416666666666666,22.0,14.863299663299664,13.0,14.4,13.0,6.0,1.2,3.6,7.5,2.0,3.0,1.0,19.0,9.0,2.0,57.0,75.0,27.0,24.5,1.0,1.0,21.5,11.0,1386.0,1554.0,26.0,17.0,6.4,5.9,11.0,11.5,14.5,15.0,0.0,0.0,341.0,318.0,9.0,23.0,15.0,20.0,494.0,521.0,11.0,23.0,0.5486910994764398,0.5519677093844602,25.0,23.0,1.7731958762886595,20.0,26.0,5.3,4.4,18.0,7.0,23.0,15.5,12.5,0.7428571428571429,0.6571428571428571,20.0,5.0,0.6268183513614323,0.6041705804997182,30.0,26.0,3361.0,3216.0,7.0,17.0,100.0,837.0,676.0,3.0,18.0,79.0,2.5,20.0,0.06597222222222222,0.05863192182410424,24.0,23.0,5.7,5.7,24.5,13.0,955.0,991.0,13.5,26.0,76.0,0.0,0.0,16.5,12.5,32.0,12.5,3055.0,2916.0,5.0,24.0,72.0,11.0,17.0,0.0,0.0,10.5,21.0,193.0,232.0,6.0,32.0,1.83,1.67,15.0,13.0,30.0,24.5,96.2,77.6,7.0,4.0,3564.0,19.0,0.563953488372093,13.0,0.4513089005235602,0.44803229061553984,8.0,10.0,0.2571428571428571,0.3428571428571429,13.0,28.0,0.3731816486385677,0.3958294195002818,3.0,7.0,431.0,444.0,20.5,13.0,9.0,12.0,16.5,26.0,2001.0,2107.0,28.0,8.0,15.308641975308642,10.0,33.7,29.4,11.0,13.0,0.0,0.0,30.0,5.7,4.8,29.5,13.0,203.0,143.0,32.0,11.0,26.0,30.5,10.0,28.0,21.0,3.5,21.0,23.0,17.0,3.0,22.5,19.0,9.3,14.7,10.0,4.0,28.0,13.5,9.0,6.5,6.0,15.326599326599329,14.0,29584.0,28320.0,17.0,5362.0,5323.0,17.0,19.0,100.0,100.0,21.0,12.5,36.0,35.0,11.0,19.5,36.0,35.0,11.5,19.0,7.2,6.4,3.0,13.0,4.6,4.7,29.5,6.5,11.6,10.9,7.5,16.5,24.3,20.7,7.5,8.0,6.4,7.3,7.0,30.0,5.6,5.4,19.5,9.0,40.2,40.5,2.0,30.0,31.2,30.0,22.5,9.0,39.0,16.0,1.565217391304348,1.3617021276595744,32.0,23.0
2011.0,181.0,184.0,10.0,25.0,277.0,356.0,29.0,26.5,180.0,188.0,18.0,15.5,74.0,135.0,31.0,29.0,23.0,33.0,27.0,25.5,7.0,0.0,2.0,0.0,4.7,7.5,32.0,26.0,6539.0,28.0,5.3,8.2,30.0,30.5,30.0,154.0,162.0,25.0,14.0,-4.0,29.0,27.0,31.0,30.5,23.5,365.0,62.1,62.6,26.5,8.0,301.0,9.5,7.5,26.0,7.5,28.41666666666667,32.0,-94.67,-58.95,-140.77,32.0,28.0,-31.99,-22.28,31.0,19.0,-160.0,32.0,29.0,92.9,79.3,8.0,2.0,0.0,5.0,6.0,14.0,3.0,0.0,5.0,6.0,13.0,2.0,16.0,10.0,16.0,30.5,23.5,30.0,22.925,30.0,18.85,24.0,27.0,31.0,30.0,1.0,2.0,31.5,0.5333333333333333,23.0,26.274747474747482,31.0,29.6,31.0,24.0,4.1,2.9,17.0,26.5,3.0,2.0,14.0,20.5,29.5,46.0,25.0,3.5,11.5,0.0,1.0,28.0,21.0,1024.0,570.0,2.0,16.0,5.9,7.6,31.5,20.0,23.83333333333333,27.0,0.0,0.0,287.0,494.0,32.0,-207.0,31.0,27.0,588.0,481.0,4.0,7.0,0.6418219461697723,0.5029940119760479,29.0,2.0,2.4324324324324325,8.0,17.0,2.9,6.2,31.0,26.5,30.0,29.5,26.0,0.6538461538461539,0.5357142857142857,29.0,13.0,0.7145653876272514,0.6043416257328474,29.0,7.0,3650.0,3814.0,21.0,16.0,123.0,1007.0,786.0,7.0,27.0,95.0,7.0,29.0,0.08303249097472924,0.09269662921348316,11.0,22.0,5.5,5.6,19.0,16.0,966.0,1002.0,13.5,31.0,67.0,0.0,0.0,16.5,12.0,36.0,16.5,3023.0,0.0,16.5,23.0,58.0,2.5,24.5,0.0,0.0,9.5,24.0,231.0,266.0,10.0,27.0,1.44,2.51,32.0,25.0,29.0,27.5,73.6,97.2,29.0,25.0,3838.0,17.0,0.4111111111111111,25.0,0.3581780538302277,0.4970059880239521,4.0,31.0,0.3461538461538461,0.4642857142857143,4.0,20.0,0.2854346123727486,0.39565837426715256,4.0,26.0,346.0,498.0,28.0,32.0,9.0,26.0,32.0,24.0,1458.0,2497.0,32.0,30.0,14.481481481481481,8.0,28.7,42.9,32.0,23.0,1.0,0.0,32.0,5.2,4.6,30.0,11.0,188.0,148.0,32.0,8.0,23.0,32.0,10.0,28.0,29.0,13.0,23.0,26.0,23.0,11.0,15.0,40.0,20.4,13.0,16.0,32.0,24.0,18.0,-16.0,32.0,32.0,22.949494949494948,30.0,27874.0,29808.0,25.0,5108.0,6311.0,30.0,21.0,100.0,98.3,7.0,13.0,23.0,60.0,32.0,29.0,23.0,59.0,32.0,29.0,6.5,8.2,31.0,25.5,4.2,5.0,30.0,16.5,10.5,13.2,30.5,30.5,22.3,22.8,9.0,26.0,8.0,7.4,8.0,25.0,5.3,6.3,31.5,16.0,45.1,0.0,16.5,16.0,28.0,34.3,29.0,18.0,-1203.0,31.0,1.5476190476190474,1.64,22.0,24.0
2012.0,193.0,192.0,24.0,8.5,301.0,329.0,24.0,19.5,188.0,226.0,30.0,14.0,89.0,75.0,3.5,19.0,24.0,28.0,12.0,23.5,4.0,0.0,1.0,2.0,6.3,7.0,28.0,12.5,6928.0,23.0,6.9,7.6,27.0,14.0,44.0,151.0,150.0,9.0,23.0,2.3000000000000007,10.0,29.0,26.7,11.0,10.0,311.0,54.9,65.4,28.0,31.0,410.0,32.0,22.0,24.0,14.0,20.08333333333333,20.0,37.78,47.58,-112.61,26.0,17.0,-4.23,53.31,4.0,9.0,-58.96,22.0,16.0,84.8,67.9,1.0,16.0,0.0,7.0,4.0,13.0,9.0,0.0,7.0,3.0,12.0,6.0,6.0,8.0,23.0,6.0,22.16666666666667,27.0,13.5,11.0,13.5,16.0,13.5,12.0,16.0,0.0,1.0,8.0,0.375,7.0,16.679966329966327,16.0,15.7,14.0,17.0,3.0,2.9,11.5,25.0,3.0,3.0,18.0,9.0,23.5,31.0,27.0,1.5,29.0,0.0,0.0,11.5,22.5,630.0,680.0,1.0,32.0,6.7,7.3,31.0,11.0,12.666666666666664,13.0,1.0,1.0,389.0,394.0,23.0,-5.0,17.0,13.0,566.0,627.0,31.0,13.5,0.5873015873015873,0.6343355965082444,2.0,14.0,2.1123595505617976,13.0,27.0,4.8,4.8,22.5,11.5,30.0,28.0,9.0,0.675,0.6976744186046512,12.0,13.0,0.6843642611683849,0.7828232971372162,1.0,13.0,3983.0,4758.0,32.0,10.0,101.0,819.0,851.0,18.0,11.0,103.0,23.0,14.5,0.07973421926910297,0.0851063829787234,22.0,23.0,5.4,5.5,8.5,25.5,1008.0,1031.0,18.5,18.0,77.0,1.0,0.0,16.5,22.5,40.0,23.5,3440.0,0.0,16.5,17.0,79.0,20.0,15.5,0.0,0.0,9.5,24.0,324.0,440.0,26.0,18.0,1.89,1.9,20.0,12.0,36.0,14.5,81.8,93.5,27.0,20.0,4144.0,10.0,0.4734042553191489,20.0,0.4126984126984127,0.3656644034917556,31.0,19.0,0.325,0.3023255813953488,21.0,20.0,0.3156357388316151,0.2171767028627838,32.0,20.0,416.0,377.0,3.0,18.0,13.0,13.0,19.0,12.0,1837.0,1320.0,1.0,15.0,21.086419753086414,31.0,35.2,32.8,15.0,16.0,0.0,0.0,26.0,4.4,4.1,31.0,7.5,161.0,193.0,26.0,3.5,27.0,29.5,3.5,33.0,28.0,9.5,13.0,28.0,19.0,1.5,14.0,23.0,10.9,12.5,15.0,10.0,26.0,12.5,3.0,12.5,12.5,17.659932659932657,17.0,29143.0,28800.0,18.0,5820.0,6078.0,29.0,9.0,100.0,100.0,19.0,14.0,39.0,45.0,24.0,16.0,39.0,45.0,24.0,16.0,7.3,7.9,29.0,12.5,4.4,3.5,1.0,11.0,13.3,12.1,23.0,2.0,20.3,25.2,25.0,30.0,9.0,11.0,24.0,19.5,5.8,5.9,27.5,7.0,44.7,0.0,16.5,21.5,30.1,31.6,24.0,15.0,-258.0,21.0,1.6590909090909092,2.257142857142857,1.0,18.0
2013.0,188.0,187.0,10.0,21.0,269.0,324.0,15.0,32.0,157.0,190.0,12.5,29.0,75.0,95.0,14.0,28.0,37.0,39.0,28.0,8.0,0.0,0.0,0.0,0.0,4.8,5.9,16.5,26.5,5868.0,32.0,6.0,6.8,17.0,21.5,31.0,151.0,158.0,22.5,16.5,-3.899999999999999,26.0,26.8,30.7,28.0,24.5,291.0,56.6,64.4,24.0,30.0,352.0,19.0,29.0,20.0,13.5,15.333333333333336,14.0,-76.79,-18.49,-75.41,17.0,24.0,-52.12,38.2,13.0,28.0,-32.43,19.0,27.0,79.3,96.9,31.0,26.0,0.0,3.0,14.0,6.0,6.0,0.0,3.0,12.0,4.0,4.0,9.0,10.0,17.5,12.0,16.5,13.0,23.03125,29.0,22.0,27.0,24.0625,26.0,18.0,0.0,2.0,12.0,0.5,19.5,21.37643097643097,25.0,22.8,25.5,12.0,2.3,3.8,3.0,13.0,3.0,0.0,21.0,3.5,11.0,34.0,24.0,3.0,23.5,0.0,0.0,12.5,19.0,811.0,452.0,2.0,22.0,5.0,6.5,20.5,32.0,27.08333333333333,29.0,0.0,0.0,288.0,389.0,21.0,-101.0,28.0,30.0,514.0,547.0,11.0,26.0,0.5718654434250765,0.5705882352941176,20.0,20.0,2.0933333333333333,16.0,22.0,4.3,5.5,26.0,15.5,30.0,27.5,21.0,0.7857142857142857,0.75,6.0,3.0,0.6362815884476535,0.6835488505747126,16.0,22.0,2820.0,3806.0,17.0,32.0,121.0,1136.0,1012.0,31.0,30.0,105.0,23.0,30.0,0.13754646840148702,0.12037037037037035,6.0,1.0,5.4,5.6,16.0,23.0,981.0,1020.0,11.5,28.0,87.0,0.0,0.0,16.5,9.0,35.0,15.0,3846.0,0.0,16.5,10.0,68.0,5.0,8.0,0.0,0.0,12.0,22.5,268.0,393.0,23.0,18.0,1.41,1.99,24.0,27.0,24.0,29.0,79.6,88.9,22.0,22.0,3181.0,32.0,0.4777070063694268,17.0,0.4281345565749235,0.4294117647058824,13.0,13.0,0.2142857142857143,0.25,27.0,30.0,0.3637184115523465,0.3164511494252874,17.0,11.0,420.0,438.0,15.0,21.0,6.0,10.0,9.0,31.0,1612.0,1762.0,15.0,22.0,16.60493827160494,14.0,27.1,38.0,25.0,28.0,1.0,1.0,47.0,8.4,6.0,23.0,27.5,361.0,255.0,17.0,30.0,35.0,23.5,26.5,29.0,32.0,21.5,19.0,23.0,31.0,25.5,24.5,21.0,9.6,15.0,7.0,8.0,31.0,4.0,10.0,7.0,11.0,19.95286195286195,27.0,28388.0,29546.0,23.0,4432.0,5568.0,17.0,32.0,100.0,100.0,19.0,14.0,31.0,40.0,18.0,27.5,31.0,40.0,18.0,27.5,6.2,7.4,21.5,32.0,3.8,4.0,14.5,25.5,10.9,11.5,11.5,28.0,23.9,18.8,1.5,13.0,11.2,11.2,26.0,8.0,4.5,5.5,20.0,31.5,44.2,0.0,16.5,22.5,23.4,29.8,20.0,32.0,-1136.0,30.0,1.6315789473684212,1.85,8.0,20.0
2014.0,180.0,185.0,21.0,19.5,263.0,353.0,30.0,30.0,162.0,223.0,30.0,28.0,72.0,103.0,22.5,28.5,29.0,27.0,8.5,20.5,0.0,0.0,0.0,0.0,4.8,6.7,23.5,29.5,6051.0,30.0,5.9,7.5,22.5,29.0,31.0,146.0,172.0,31.0,26.0,-4.599999999999998,29.0,26.6,31.2,30.0,23.0,301.0,56.7,68.7,32.0,30.0,387.0,31.0,26.0,18.0,15.5,21.33333333333333,24.0,-68.29,-17.44,-137.68,31.0,29.0,-42.31,55.01,5.0,23.0,-72.07,25.0,29.0,83.3,74.4,1.0,18.5,0.0,3.0,8.0,7.0,6.0,0.0,2.0,7.0,6.0,5.0,13.0,11.0,12.5,26.5,20.5,26.0,25.63125,32.0,23.45,29.0,27.8125,31.0,29.0,0.0,1.0,30.0,0.4482758620689655,16.0,25.71936026936027,29.0,28.9,30.0,20.0,3.8,2.5,17.5,32.0,3.0,1.0,14.0,15.5,31.0,36.0,37.0,16.5,19.5,0.0,0.0,13.5,19.0,819.0,868.0,15.0,18.0,5.7,6.8,24.5,28.0,28.58333333333333,31.0,0.0,0.0,277.0,410.0,25.0,-133.0,28.0,29.0,531.0,563.0,21.0,21.0,0.6228632478632479,0.5613870665417057,25.0,7.0,2.25,15.0,21.0,4.0,5.0,23.0,20.0,28.0,23.0,20.5,0.75,0.6511627906976745,20.0,9.0,0.7056934931506851,0.6918516008809079,15.0,13.0,3297.0,4084.0,28.0,25.0,118.0,939.0,935.0,22.0,20.5,106.0,21.5,25.5,0.11026615969581748,0.0764872521246459,26.0,7.0,5.3,6.0,27.5,28.5,936.0,1067.0,26.5,31.0,79.0,1.0,0.0,16.5,21.0,32.0,17.0,3154.0,2826.0,6.0,20.0,64.0,6.0,10.5,0.0,1.0,26.0,21.5,249.0,185.0,3.0,20.0,1.42,2.1,26.0,29.0,23.0,28.5,75.2,97.4,27.0,28.0,3623.0,23.0,0.4444444444444444,18.0,0.3771367521367521,0.4386129334582943,8.0,26.0,0.25,0.34883720930232553,13.0,24.0,0.29430650684931503,0.308148399119092,18.0,20.0,353.0,468.0,27.0,31.0,7.0,15.0,25.0,27.5,1375.0,1819.0,19.0,29.0,16.086419753086414,13.0,26.7,38.9,26.0,29.0,0.0,2.0,52.0,8.9,6.0,21.5,26.5,326.0,210.0,23.0,27.5,36.0,22.0,29.5,24.0,39.0,31.0,28.0,20.0,29.0,20.5,27.5,33.0,17.2,13.0,14.0,31.5,25.0,16.5,-8.0,26.5,31.0,22.53872053872054,29.0,26280.0,31820.0,30.0,4672.0,5903.0,25.0,30.0,100.0,100.0,20.0,13.5,31.0,41.0,20.0,25.0,31.0,41.0,21.5,24.0,6.8,7.6,23.0,26.5,3.9,3.9,7.0,23.5,12.0,11.1,9.5,10.5,22.8,23.5,16.5,20.0,10.8,5.8,2.0,8.0,5.0,5.5,21.5,29.0,39.9,44.2,16.5,32.0,25.8,31.8,28.0,28.5,-1231.0,31.0,1.7435897435897436,1.9487179487179491,7.0,19.0
2015.0,176.0,180.0,8.5,28.0,336.0,351.0,26.5,9.0,201.0,208.0,26.0,14.5,99.0,104.0,27.0,10.0,36.0,39.0,28.0,8.0,3.0,0.0,1.0,0.0,6.4,6.8,19.5,13.5,6998.0,17.0,7.1,7.8,22.0,15.5,37.0,158.0,168.0,31.0,15.5,-4.0,29.0,26.2,30.2,31.0,25.0,312.0,58.3,69.9,32.0,29.0,378.0,24.0,27.0,18.0,15.5,16.833333333333332,14.5,58.23,86.17,-134.46,29.0,13.0,-18.91,40.6,8.0,7.0,-80.13,22.0,12.0,72.5,91.2,28.0,30.0,0.0,11.0,11.0,9.0,9.0,0.0,10.0,10.0,4.0,5.0,13.0,12.0,9.5,29.0,17.75,17.5,14.30625,12.0,17.55,21.0,11.0625,7.0,26.0,2.0,1.0,28.0,0.5,20.0,18.6516835016835,21.0,22.3,24.0,15.0,2.8,2.0,23.5,24.0,1.0,2.0,11.0,23.0,22.0,21.0,35.0,17.5,31.0,0.0,0.0,13.5,19.0,506.0,882.0,18.0,29.0,6.9,6.6,19.5,7.5,11.083333333333336,7.0,0.0,0.0,342.0,417.0,26.0,-75.0,25.5,20.0,535.0,541.0,7.0,22.0,0.5526057030481809,0.554066985645933,27.0,24.0,2.0303030303030303,20.0,22.0,4.1,5.7,27.0,21.5,31.0,26.5,22.0,0.6470588235294118,0.7209302325581395,16.0,22.0,0.6405054871965414,0.7051046639735585,11.0,26.0,3852.0,3840.0,16.0,17.0,143.0,1195.0,862.0,9.0,31.0,104.0,9.0,31.5,0.10714285714285714,0.1111111111111111,6.0,9.0,6.0,6.0,30.5,6.0,1017.0,1045.0,22.0,19.0,56.0,0.0,1.0,27.0,11.5,27.0,6.0,2348.0,2787.0,3.0,32.0,62.0,1.5,32.0,0.0,0.0,11.5,22.5,288.0,140.0,1.0,17.0,1.85,2.23,30.0,16.5,29.0,28.0,84.2,102.3,31.0,25.0,4042.0,21.0,0.4925373134328358,13.0,0.4473942969518191,0.44593301435406696,6.0,9.0,0.3529411764705882,0.2790697674418605,17.0,11.0,0.35949451280345857,0.2948953360264415,22.0,7.0,455.0,466.0,29.0,8.0,12.0,12.0,21.0,15.0,2162.0,1606.0,11.0,5.0,17.790123456790127,23.0,35.8,41.7,30.0,13.0,0.0,0.0,27.0,4.8,6.6,10.0,8.0,190.0,232.0,21.0,8.0,38.0,15.0,5.5,40.0,34.0,22.5,2.5,29.0,31.0,29.5,11.5,28.0,14.8,12.8,11.0,26.0,23.0,17.0,-5.0,24.0,23.5,15.003367003367007,10.0,27808.0,30240.0,26.0,6014.0,5446.0,10.0,5.0,91.2,93.3,16.0,26.0,34.0,45.0,25.0,23.0,31.0,42.0,24.5,24.0,7.6,7.5,20.0,10.0,4.8,3.4,2.0,1.5,13.0,10.8,5.5,2.0,24.1,25.2,21.5,14.5,9.9,5.2,4.5,9.0,5.9,5.2,8.0,4.0,41.9,45.0,15.5,31.0,34.1,30.5,17.0,5.0,568.0,7.0,1.5833333333333333,2.2058823529411766,1.0,28.0
2016.0,183.0,184.0,13.0,20.0,340.0,326.0,17.0,10.5,220.0,203.0,19.5,6.5,80.0,102.0,26.5,25.0,40.0,21.0,2.0,2.0,7.0,0.0,4.0,2.0,6.0,6.4,21.5,18.5,6354.0,27.0,6.8,7.2,21.5,19.0,41.0,162.0,156.0,12.0,15.0,-0.09999999999999787,16.0,28.3,28.4,18.0,17.0,355.0,61.4,63.3,18.0,20.0,347.0,13.0,19.0,26.0,4.5,17.5,17.5,31.47,107.8,-41.26,9.0,11.0,-68.53,-7.71,29.0,31.0,-41.58,14.0,18.0,71.0,75.0,6.0,32.0,0.0,5.0,15.0,10.0,1.0,0.0,5.0,13.0,4.0,0.0,9.0,12.0,6.5,17.5,13.0,9.0,18.90625,23.0,14.5,16.0,23.3125,24.0,19.0,0.0,1.0,12.0,0.4736842105263158,20.5,18.678451178451176,24.0,19.0,22.0,18.0,3.1,3.1,2.0,26.5,4.0,1.0,17.0,6.0,27.0,21.0,25.0,8.5,31.5,0.0,0.0,13.0,19.5,307.0,583.0,11.0,32.0,6.4,6.8,25.0,17.5,19.58333333333333,21.0,0.0,0.0,354.0,369.0,15.0,-15.0,23.0,18.5,578.0,548.0,10.5,16.0,0.575046904315197,0.5784797630799605,22.0,24.0,2.75,4.0,29.0,5.0,4.4,18.5,11.0,24.0,16.0,9.0,0.7837837837837838,0.6153846153846154,18.0,3.0,0.7084085167809455,0.6815016137251572,21.0,13.0,3926.0,4012.0,22.0,16.0,109.0,926.0,1061.0,29.0,19.0,121.0,28.0,18.5,0.1176470588235294,0.06441717791411042,30.0,2.0,5.9,5.6,11.0,11.5,1066.0,1013.0,14.0,6.0,70.0,0.0,0.0,13.0,13.5,24.0,6.0,3216.0,3108.0,14.0,17.0,70.0,12.5,21.0,0.0,0.0,12.0,20.0,266.0,128.0,1.0,13.0,1.78,1.92,16.0,20.0,29.0,19.0,87.0,88.8,18.0,18.0,4165.0,14.0,0.3636363636363637,29.0,0.424953095684803,0.4215202369200395,11.0,9.0,0.21621621621621626,0.3846153846153846,15.0,30.0,0.2915914832190545,0.31849838627484284,12.0,20.0,453.0,427.0,22.0,7.5,8.0,15.0,19.5,30.0,1616.0,1875.0,22.0,24.0,17.864197530864196,19.0,32.2,35.9,17.0,22.0,1.0,2.0,35.0,5.7,6.5,8.0,16.0,239.0,234.0,11.0,20.0,38.0,10.0,17.0,31.0,36.0,27.0,19.5,22.0,27.0,18.0,23.5,27.0,14.8,14.7,2.0,29.0,29.0,3.0,2.0,14.0,24.5,18.356902356902356,25.0,29646.0,28704.0,15.0,5542.0,5887.0,23.0,18.0,94.1,97.1,26.0,15.0,34.0,35.0,11.5,20.0,32.0,34.0,13.0,17.5,7.2,7.7,28.0,16.0,3.6,4.4,22.0,28.5,11.7,12.2,27.5,12.0,14.6,23.3,26.0,32.0,9.2,5.3,4.0,12.0,5.2,5.8,24.5,22.5,45.9,44.4,10.0,12.0,30.2,31.9,20.5,17.0,-345.0,27.0,2.0,1.75,13.0,4.5
