Year,#Dr,#Dr_Defense,#Dr_Defense_Low_Rank,#Dr_High_Rank,1stD,1stD_Defense,1stD_Defense_Low_Rank,1stD_High_Rank,1stDpass,1stDpass_Defense,1stDpass_Defense_Low_Rank,1stDpass_High_Rank,1stDrun,1stDrun_Defense,1stDrun_Defense_Low_Rank,1stDrun_High_Rank,1stPy,1stPy_Defense,1stPy_Defense_Low_Rank,1stPy_High_Rank,2PA,2PA_Defense,2PM,2PM_Defense,ANY/A,ANY/A_Defense,ANY/A_Defense_Low_Rank,ANY/A_High_Rank,APYd,APYd_High_Rank,AY/A,AY/A_Defense,AY/A_Defense_Low_Rank,AY/A_High_Rank,AllTD,AvgDriveTime,AvgDriveTime_Defense,AvgDriveTime_High_Rank,AvgFieldPositionDifferential,AvgFieldPositionDifferential_High_Rank,AvgStartingPosition,AvgStartingPosition_Defense,AvgStartingPosition_Defense_Low_Rank,AvgStartingPosition_High_Rank,Cmp,Cmp%,Cmp%_Defense,Cmp%_Defense_Low_Rank,Cmp%_High_Rank,Cmp_Defense,Cmp_Defense_Low_Rank,Cmp_High_Rank,DefensivePtsScored,DefensivePtsScored_High_Rank,Dscore,Dscore_Rank,ExpectedPoints,ExpectedPointsPassing,ExpectedPointsPassing_Defense,ExpectedPointsPassing_Defense_High_Rank,ExpectedPointsPassing_High_Rank,ExpectedPointsRunning,ExpectedPointsRunning_Defense,ExpectedPointsRunning_Defense_High_Rank,ExpectedPointsRunning_High_Rank,ExpectedPoints_Defense,ExpectedPoints_Defense_High_Rank,ExpectedPoints_High_Rank,FG%,FG%_Defense,FG%_Defense_Low_Rank,FG%_High_Rank,FGA019,FGA2029,FGA3039,FGA4049,FGA50Plus,FGM019,FGM2029,FGM3039,FGM4049,FGM50Plus,FL,FL_Defense,FL_Defense_High_Rank,FL_Low_Rank,FantasyDstScore,FantasyDstScore_Rank,FantasyOffenseScore,FantasyOffenseScore_Rank,FantasyPassScore,FantasyPassScore_Rank,FantasyRushScore,FantasyRushScore_Rank,Fmb,FmbTD,FmbTD_Defense,FumbleLostPercent,FumbleLostPercent_Low_Rank,GameControlPlusBalance,GameControlPlusBalance_Rank,GameControlScore,GameControlScore_Rank,Int,Int%,Int%_Defense,Int%_Defense_High_Rank,Int%_Low_Rank,IntTD,IntTD_Defense,Int_Defense,Int_Defense_High_Rank,Int_Low_Rank,Job,KickRet,KickRet_Defense,KickRet_Defense_Low_Rank,KickRet_High_Rank,KrTD,KrTD_Defense,KrTD_Defense_Low_Rank,KrTD_High_Rank,KrYds,KrYds_Defense,KrYds_Defense_Low_Rank,KrYds_High_Rank,NY/A,NY/A_Defense,NY/A_Defense_Low_Rank,NY/A_High_Rank,Oscore,Oscore_Rank,OthTD,OthTD_Defense,PF,PF_Defense,PF_Defense_Low_Rank,PF_Differential,PF_Differential_High_Rank,PF_High_Rank,PassAtt,PassAtt_Defense,PassAtt_Defense_Low_Rank,PassAtt_High_Rank,PassPercent,PassPercent_Defense,PassPercent_Defense_High_Rank,PassPercent_High_Rank,PassRun1dRatio,PassRun1dRatio_High_Rank,PassTD,PassTD%,PassTD%_Defense,PassTD%_Defense_Low_Rank,PassTD%_High_Rank,PassTD_Defense,PassTD_Defense_Low_Rank,PassTD_High_Rank,PassTdPercent,PassTdPercent_Defense,PassTdPercent_Defense_High_Rank,PassTdPercent_High_Rank,PassYdPercent,PassYdPercent_Defense,PassYdPercent_Defense_High_Rank,PassYdPercent_High_Rank,PassYds,PassYds_Defense,PassYds_Defense_Low_Rank,PassYds_High_Rank,Pen,PenYds,PenYds_Defense,PenYds_Defense_Low_Rank,PenYds_Low_Rank,Pen_Defense,Pen_Defense_Low_Rank,Pen_Low_Rank,Penalty1dPercent,Penalty1dPercent_Defense,Penalty1dPercent_Defense_High_Rank,Penalty1dPercent_High_Rank,Plays/Drive,Plays/Drive_Defense,Plays/Drive_Defense_Low_Rank,Plays/Drive_High_Rank,Ply,Ply_Defense,Ply_Defense_Low_Rank,Ply_High_Rank,Pnt,PntBlck,PntBlck_Defense,PntBlck_Defense_Low_Rank,PntBlck_Low_Rank,PntRet_Defense,PntRet_Defense_Low_Rank,PntYds,PntYds_Defense,PntYds_Defense_Low_Rank,PntYds_High_Rank,Pnt_Defense,Pnt_Defense_Low_Rank,Pnt_High_Rank,PrTD,PrTD_Defense,PrTD_Defense_Low_Rank,PrTD_High_Rank,PrYds,PrYds_Defense,PrYds_Defense_Low_Rank,PrYds_High_Rank,Pts/Drive,Pts/Drive_Defense,Pts/Drive_Defense_Low_Rank,Pts/Drive_High_Rank,PuntRet,PuntRet_High_Rank,QbRating,QbRating_Defense,QbRating_Defense_Low_Rank,QbRating_High_Rank,RawPassYds,RawPassYds_High_Rank,RunPass1dRatio,RunPass1dRatio_High_Rank,RunPercent,RunPercent_Defense,RunPercent_Defense_High_Rank,RunPercent_High_Rank,RunTdPercent,RunTdPercent_Defense,RunTdPercent_Defense_High_Rank,RunTdPercent_High_Rank,RunYdPercent,RunYdPercent_Defense,RunYdPercent_Defense_High_Rank,RunYdPercent_High_Rank,RushAtt,RushAtt_Defense,RushAtt_Defense_Low_Rank,RushAtt_High_Rank,RushTD,RushTD_Defense,RushTD_Defense_Low_Rank,RushTD_High_Rank,RushYds,RushYds_Defense,RushYds_Defense_Low_Rank,RushYds_High_Rank,STscore,STscore_Rank,Sc%,Sc%_Defense,Sc%_Defense_Low_Rank,Sc%_High_Rank,Sfty,Sfty_Defense,Sk,Sk%,Sk%_Defense,Sk%_Defense_High_Rank,Sk%_Low_Rank,SkYds,SkYds_Defense,SkYds_Defense_High_Rank,SkYds_Low_Rank,Sk_Defense,Sk_Defense_High_Rank,Sk_Low_Rank,TFGA,TFGA_Defense,TFGA_Defense_Low_Rank,TFGA_High_Rank,TFGM,TFGM_Defense,TFGM_Defense_Low_Rank,TFGM_High_Rank,TO,TO%,TO%_Defense,TO%_Defense_High_Rank,TO%_Low_Rank,TO_Defense,TO_Defense_High_Rank,TO_Differential,TO_Differential_High_Rank,TO_Low_Rank,ThreePhaseScore,ThreePhaseScore_Rank,TimeOfPossession,TimeOfPossession_Defense,TimeOfPossession_High_Rank,Tm,TotalYds,TotalYds_Defense,TotalYds_Defense_Low_Rank,TotalYds_High_Rank,XP%,XP%_Defense,XP%_Defense_Low_Rank,XP%_High_Rank,XPA,XPA_Defense,XPA_Defense_Low_Rank,XPA_High_Rank,XPM,XPM_Defense,XPM_Defense_Low_Rank,XPM_High_Rank,Y/Apass,Y/Apass_Defense,Y/Apass_Defense_Low_Rank,Y/Apass_High_Rank,Y/Arun,Y/Arun_Defense,Y/Arun_Defense_Low_Rank,Y/Arun_High_Rank,Y/C,Y/C_Defense,Y/C_Defense_Low_Rank,Y/C_High_Rank,Y/KR,Y/KR_Defense,Y/KR_Defense_Low_Rank,Y/KR_High_Rank,Y/PR,Y/PR_Defense,Y/PR_Defense_Low_Rank,Y/PR_High_Rank,Y/Play,Y/Play_Defense,Y/Play_Defense_Low_Rank,Y/Play_High_Rank,Y/Pnt,Y/Pnt_Defense,Y/Pnt_Defense_Low_Rank,Y/Pnt_High_Rank,Yds/Drive,Yds/Drive_Defense,Yds/Drive_Defense_Low_Rank,Yds/Drive_High_Rank,Yds_Differential,Yds_Differential_High_Rank,YppYprRatio,YppYprRatio_Defense,YppYprRatio_Defense_High_Rank,YppYprRatio_High_Rank
2002.0,211.0,212.0,32.0,1.0,238.0,271.0,3.0,30.0,133.0,155.0,6.0,30.0,82.0,95.0,10.5,27.0,23.0,21.0,8.0,23.0,1.0,0.0,1.0,0.0,3.9,4.5,4.0,29.0,6269.0,31.0,4.9,5.6,6.5,29.5,30.0,133.0,139.0,31.0,1.4000000000000021,12.0,32.1,30.7,12.0,11.5,255.0,55.0,56.1,5.0,25.0,293.0,9.0,30.0,14.0,16.5,3.6666666666666665,2.0,-178.84,-71.78,60.45,4.0,29.0,-101.45,63.8,2.0,32.0,137.99,3.0,30.0,60.0,82.8,24.0,32.0,1.0,6.0,4.0,11.0,3.0,1.0,4.0,2.0,6.0,2.0,18.0,16.0,7.0,29.0,8.166666666666666,3.0,25.10625,31.0,26.15,32.0,24.0625,27.0,28.0,1.0,2.0,0.6428571428571429,32.0,18.624242424242425,23.0,20.4,23.5,22.0,4.7,3.3,12.5,32.0,1.0,1.0,17.0,16.5,27.0,HC,60.0,50.0,2.0,28.0,0.0,0.0,10.0,23.0,1208.0,926.0,1.0,29.0,5.3,5.2,3.5,27.0,29.66666666666667,32.0,0.0,0.0,258.0,302.0,5.0,-44.0,23.0,30.0,464.0,522.0,11.0,29.0,0.5291666666666667,0.5616438356164384,18.0,27.0,1.6219512195121952,19.0,15.0,3.2,3.4,9.0,28.0,18.0,7.5,30.0,0.5769230769230769,0.6,15.5,21.0,0.6294392523364486,0.6442100731812311,15.0,19.0,2694.0,2993.0,4.0,30.0,94.0,785.0,782.0,7.0,8.0,98.0,5.5,8.0,0.09663865546218488,0.07749077490774907,20.0,10.0,4.7,5.0,1.5,32.0,960.0,1022.0,19.0,26.0,105.0,1.0,0.0,16.5,21.5,63.0,32.0,4781.0,4254.0,31.0,2.0,103.0,32.0,3.0,2.0,0.0,10.5,3.5,487.0,554.0,30.0,4.0,1.08,1.33,3.0,30.0,57.0,1.0,65.7,73.4,5.5,29.0,2981.0,31.0,0.6165413533834586,14.0,0.4708333333333333,0.4383561643835616,15.0,6.0,0.4230769230769231,0.4,17.5,12.0,0.3705607476635514,0.3557899268187689,18.0,14.0,452.0,448.0,19.0,13.0,11.0,12.0,7.5,21.5,1586.0,1653.0,8.0,25.0,17.333333333333332,18.0,19.4,25.5,3.0,30.0,1.0,0.0,44.0,8.7,9.1,1.0,30.0,287.0,336.0,2.0,26.0,52.0,2.0,25.5,25.0,29.0,13.5,27.0,15.0,24.0,20.5,30.0,40.0,17.5,14.2,17.0,28.0,33.0,7.0,-7.0,24.0,29.5,16.848484848484848,18.0,28063.0,29468.0,21.0,CAR,4280.0,4646.0,2.0,31.0,100.0,97.0,4.5,11.0,29.0,33.0,9.5,29.0,29.0,32.0,9.0,29.0,6.4,6.4,8.5,22.5,3.5,3.7,1.5,30.5,11.7,11.4,20.0,9.0,20.1,18.5,1.0,28.0,8.5,8.8,14.0,21.5,4.5,4.5,2.0,30.0,45.5,41.3,18.5,1.0,20.1,21.8,2.0,31.0,-366.0,22.0,1.8285714285714287,1.7297297297297298,11.0,5.0
2003.0,195.0,190.0,18.5,7.0,284.0,274.0,8.0,19.0,146.0,161.0,11.0,25.5,114.0,83.0,6.0,11.0,24.0,30.0,27.5,18.5,3.0,0.0,0.0,0.0,5.6,4.7,11.0,12.0,7106.0,15.0,6.3,5.5,11.5,13.0,33.0,153.0,153.0,18.0,1.0,13.5,31.7,30.7,10.0,16.0,270.0,58.7,57.3,8.0,14.5,299.0,16.0,28.0,20.0,12.0,10.75,7.0,-44.9,41.23,33.02,9.0,12.0,-64.55,59.64,6.0,29.0,102.63,7.0,17.0,84.2,65.6,3.0,11.0,0.0,13.0,8.0,13.0,4.0,0.0,13.0,6.0,11.0,2.0,15.0,10.0,24.0,26.0,11.916666666666664,7.0,15.75625,15.0,16.45,19.0,15.0625,14.0,33.0,0.0,3.0,0.4545454545454545,12.5,14.212947658402204,15.0,15.2,15.0,16.0,3.5,3.1,13.0,18.5,3.0,2.0,16.0,12.5,13.0,HC,60.0,70.0,18.5,26.5,1.0,0.0,11.5,7.0,1345.0,1425.0,14.0,23.0,6.3,5.3,6.5,8.0,16.25,18.0,0.0,0.0,325.0,304.0,10.0,21.0,16.0,15.0,460.0,522.0,20.5,28.5,0.4821428571428572,0.5642570281124498,12.0,30.0,1.2807017543859651,29.0,19.0,4.1,3.6,12.5,12.0,19.0,14.0,17.0,0.6785714285714286,0.6551724137931034,11.0,13.0,0.5932697918692861,0.6355555555555555,16.0,27.0,3050.0,3003.0,9.0,18.0,116.0,966.0,1011.0,28.0,23.0,111.0,23.0,24.0,0.08450704225352113,0.10948905109489053,3.0,16.0,5.4,5.4,13.0,20.0,1008.0,996.0,14.0,17.0,81.0,3.0,0.0,16.5,32.0,35.0,13.0,3599.0,3780.0,30.0,8.0,90.0,27.5,17.0,1.0,1.0,23.5,9.5,453.0,402.0,21.0,8.0,1.5,1.4,6.0,17.0,45.0,6.5,79.6,74.8,11.0,15.0,3238.0,21.0,0.7808219178082192,4.0,0.5178571428571428,0.4357429718875502,21.0,3.0,0.3214285714285714,0.3448275862068966,22.0,20.0,0.4067302081307139,0.3644444444444445,17.0,6.0,522.0,434.0,9.0,3.0,9.0,10.0,7.5,24.5,2091.0,1722.0,11.0,7.0,12.494949494949491,2.0,30.8,26.3,6.5,15.0,1.0,0.0,26.0,5.3,7.1,6.5,11.0,188.0,212.0,17.0,12.0,40.0,7.5,8.0,38.0,32.0,23.0,3.0,32.0,21.0,11.0,4.5,31.0,14.9,12.6,20.0,21.0,26.0,18.5,-5.0,25.5,22.0,13.22589531680441,9.0,29835.0,29070.0,10.0,CAR,5141.0,4725.0,8.0,16.0,96.7,96.9,6.0,26.0,30.0,32.0,11.0,21.5,29.0,31.0,11.0,22.0,7.0,6.2,9.5,9.5,4.0,4.0,13.5,17.5,12.0,10.8,8.0,5.0,22.4,20.4,5.0,10.0,10.1,11.5,26.5,13.0,5.1,4.7,6.5,16.5,44.4,42.0,22.0,3.0,26.3,24.7,9.0,17.0,416.0,11.0,1.75,1.55,21.0,9.0
2004.0,182.0,187.0,16.5,21.5,308.0,307.0,18.0,12.5,192.0,177.0,17.5,8.0,85.0,98.0,14.0,25.5,31.0,32.0,24.5,9.5,2.0,0.0,2.0,0.0,6.2,4.9,8.0,11.0,6991.0,22.0,7.1,5.6,6.0,10.5,42.0,158.0,155.0,12.5,1.9000000000000021,5.0,31.8,29.9,10.0,9.0,311.0,58.0,59.1,12.0,18.0,303.0,14.0,12.0,18.0,13.0,14.916666666666664,14.0,13.82,76.46,-19.66,15.0,9.0,-48.15,31.28,14.0,24.0,18.01,15.0,13.0,80.0,71.4,5.5,18.5,0.0,11.0,7.0,2.0,5.0,0.0,11.0,5.0,1.0,3.0,11.0,12.0,15.5,16.5,17.0,16.0,16.38125,19.0,8.7,6.0,24.0625,26.0,23.0,1.0,0.0,0.4782608695652174,16.5,13.38939393939394,10.0,11.4,7.0,15.0,2.8,5.1,1.0,10.0,2.0,3.0,26.0,1.0,13.0,HC,61.0,69.0,18.5,24.0,0.0,0.0,9.0,22.0,1307.0,1477.0,17.0,24.0,6.4,6.4,21.5,12.0,15.25,14.0,0.0,0.0,355.0,339.0,15.5,16.0,12.0,13.0,536.0,513.0,16.0,11.5,0.5741675075681129,0.5357492654260528,22.0,11.0,2.2588235294117647,8.0,29.0,5.4,3.5,7.5,8.0,18.0,8.5,6.0,0.7435897435897436,0.4864864864864865,31.0,7.0,0.6972248803827751,0.6462281679672984,19.0,8.0,3643.0,3478.0,18.0,9.0,123.0,1020.0,1078.0,31.0,29.0,117.0,20.5,26.0,0.10064935064935067,0.10423452768729642,10.0,13.0,5.6,5.6,21.5,13.0,991.0,1021.0,23.0,19.0,79.0,1.0,0.0,16.5,27.0,38.0,21.0,3446.0,2630.0,3.0,12.0,64.0,4.0,15.0,0.0,0.0,12.0,20.5,165.0,303.0,16.0,30.0,1.83,1.71,16.5,10.0,28.0,29.0,87.0,72.0,4.0,11.0,3889.0,10.0,0.4427083333333333,25.0,0.42583249243188703,0.4642507345739472,11.0,22.0,0.2564102564102564,0.5135135135135135,2.0,26.0,0.3027751196172249,0.3537718320327016,14.0,25.0,422.0,474.0,21.5,22.0,10.0,19.0,28.0,22.0,1582.0,1904.0,17.0,28.0,16.166666666666668,16.0,32.4,30.5,17.0,12.0,0.0,0.0,33.0,5.8,6.2,25.5,9.0,246.0,225.0,17.5,19.0,34.0,24.5,11.0,25.0,28.0,19.0,22.0,20.0,20.0,11.0,19.5,26.0,12.6,19.8,2.0,11.0,38.0,2.0,12.0,4.0,12.5,15.378787878787875,10.0,28756.0,28985.0,17.0,CAR,5225.0,5382.0,20.0,13.0,97.5,100.0,21.5,27.0,40.0,39.0,19.5,12.5,39.0,39.0,20.0,14.5,7.3,7.2,21.5,14.0,3.7,4.0,12.5,28.5,12.5,12.2,25.5,6.5,21.4,21.4,12.0,18.0,5.9,8.0,15.5,28.0,5.3,5.3,19.0,13.5,43.6,41.1,11.0,4.5,28.6,28.8,20.0,14.0,-157.0,19.0,1.9729729729729728,1.8,10.0,3.0
2005.0,190.0,187.0,16.5,14.5,278.0,262.0,5.0,23.0,157.0,160.0,10.0,23.0,82.0,72.0,1.0,22.5,39.0,30.0,18.0,3.0,1.0,0.0,0.0,3.0,6.4,4.1,2.0,8.5,6769.0,25.0,7.3,5.0,2.0,7.5,45.0,156.0,150.0,17.0,2.3999999999999986,10.0,33.0,30.6,14.5,7.0,269.0,59.9,57.8,10.5,17.0,305.0,17.0,26.5,18.0,13.0,3.9166666666666665,2.0,1.55,76.88,59.82,2.0,7.0,-68.73,74.32,1.0,30.0,148.53,2.0,12.0,76.5,85.2,24.0,23.5,1.0,8.0,8.0,9.0,8.0,1.0,8.0,8.0,6.0,3.0,10.0,19.0,2.0,10.5,7.916666666666668,2.0,15.2625,15.0,14.4,18.0,16.125,16.0,23.0,1.0,0.0,0.43478260869565216,11.0,10.166528925619836,6.0,8.3,7.0,16.0,3.6,4.4,4.5,25.5,2.0,3.0,23.0,4.0,19.0,HC,53.0,80.0,26.0,29.0,0.0,0.0,11.5,21.5,1083.0,1702.0,25.0,30.0,6.9,5.3,3.5,5.5,17.083333333333332,16.0,0.0,0.0,391.0,259.0,5.0,132.0,4.0,8.0,449.0,528.0,21.0,28.5,0.4948132780082988,0.5840978593272171,7.0,26.0,1.9146341463414642,14.0,25.0,5.6,2.8,3.5,3.0,15.0,3.5,6.0,0.5952380952380952,0.625,12.5,20.0,0.6608080808080808,0.6760283060592658,9.0,14.0,3271.0,3057.0,9.0,17.0,91.0,732.0,1045.0,28.0,2.0,128.0,25.0,1.0,0.14028776978417265,0.11450381679389313,6.0,2.0,5.3,5.4,11.5,26.5,964.0,981.0,11.5,23.0,73.0,0.0,0.0,16.5,12.0,36.0,13.0,3154.0,3563.0,20.0,22.0,79.0,16.5,22.5,0.0,0.0,12.5,20.5,444.0,235.0,6.0,5.0,1.96,1.27,2.0,9.0,41.0,14.5,88.1,68.0,2.0,10.0,3485.0,16.0,0.5222929936305732,19.0,0.5051867219917012,0.4159021406727829,26.0,7.0,0.4047619047619048,0.375,20.5,13.0,0.3391919191919192,0.3239716939407342,24.0,19.0,487.0,408.0,6.0,10.0,17.0,9.0,5.0,9.0,1679.0,1465.0,4.0,19.0,16.12121212121212,15.0,35.8,25.1,4.0,9.0,0.0,0.0,28.0,5.9,7.9,6.5,12.5,214.0,294.0,5.0,15.0,45.0,7.0,8.0,34.0,27.0,8.5,6.0,26.0,23.0,14.0,10.0,26.0,12.6,19.8,2.0,11.0,42.0,2.0,16.0,3.0,14.0,12.03305785123967,6.0,29640.0,28050.0,13.0,CAR,4950.0,4522.0,3.0,22.0,97.7,100.0,22.5,22.5,44.0,22.0,3.0,7.5,43.0,22.0,3.0,8.0,7.8,6.3,5.0,4.0,3.4,3.6,5.0,30.0,13.0,11.0,8.0,2.0,20.4,21.3,11.0,26.0,10.8,6.5,5.0,2.0,5.1,4.6,3.0,13.5,43.2,45.1,30.0,14.5,26.1,24.2,4.5,20.0,428.0,11.5,2.2941176470588243,1.75,11.0,1.0
2006.0,197.0,195.0,28.5,4.0,278.0,267.0,7.0,25.0,158.0,149.0,4.0,21.0,100.0,96.0,11.5,16.5,20.0,22.0,13.5,24.5,0.0,0.0,0.0,2.0,5.0,5.2,15.0,19.5,6603.0,29.0,5.8,6.2,17.0,18.5,28.0,148.0,148.0,24.0,-2.299999999999997,27.0,27.1,29.4,10.0,31.0,325.0,60.3,58.2,10.0,16.0,291.0,10.0,12.0,14.0,16.5,11.166666666666664,8.0,-61.67,-12.76,10.81,13.0,17.0,-39.88,35.83,11.0,22.0,46.96,12.0,21.0,88.9,80.0,15.0,7.0,2.0,6.0,4.0,8.0,7.0,2.0,6.0,4.0,8.0,4.0,10.0,8.0,28.5,12.0,16.0,15.0,18.85625,23.0,15.4,16.0,22.3125,25.0,21.0,0.0,0.0,0.4761904761904762,16.0,18.464600550964192,21.0,20.1,22.0,17.0,3.2,2.8,22.0,16.0,2.0,0.0,14.0,22.5,17.5,HC,62.0,59.0,10.5,18.0,0.0,0.0,13.0,20.0,1200.0,1302.0,10.0,28.0,5.7,5.5,7.5,20.5,22.16666666666667,25.0,0.0,0.0,270.0,305.0,8.5,-35.0,20.0,27.0,539.0,500.0,9.0,10.0,0.5744466800804829,0.5464646464646464,18.0,10.0,1.58,20.0,19.0,3.5,4.4,22.0,22.0,22.0,21.5,18.0,0.7307692307692307,0.6875,8.0,2.0,0.6630103595368677,0.6333122229259025,21.0,12.0,3264.0,3000.0,4.0,15.0,103.0,744.0,735.0,13.0,13.0,89.0,10.5,23.0,0.07194244604316546,0.08239700374531835,16.0,21.0,5.2,5.2,5.5,27.5,994.0,990.0,14.0,19.5,100.0,1.0,0.0,16.5,26.5,61.0,32.0,4554.0,4292.0,31.0,1.0,98.0,31.0,1.0,0.0,1.0,25.0,22.0,225.0,390.0,25.0,30.0,1.29,1.52,8.0,27.0,49.0,5.5,77.9,80.8,16.0,19.0,3486.0,14.0,0.6329113924050633,13.0,0.42555331991951706,0.4535353535353536,15.0,23.0,0.2692307692307693,0.3125,25.0,31.0,0.3369896404631323,0.3666877770740975,12.0,21.0,423.0,449.0,16.0,24.0,7.0,10.0,7.5,29.0,1659.0,1737.0,11.0,24.0,17.262626262626267,20.0,25.4,28.7,9.0,28.0,1.0,0.0,32.0,5.6,7.6,7.0,10.0,222.0,265.0,10.5,17.0,41.0,6.5,14.0,27.0,30.0,19.0,22.5,24.0,24.0,18.5,16.0,27.0,12.7,10.8,29.0,13.0,22.0,28.5,-5.0,24.5,16.5,16.829201101928376,16.0,29156.0,28860.0,15.0,CAR,4923.0,4737.0,7.0,24.0,100.0,100.0,20.5,11.5,28.0,31.0,7.5,26.5,28.0,31.0,7.5,26.0,6.5,6.5,7.0,21.5,3.9,3.9,8.5,20.0,10.7,11.2,12.0,26.5,19.4,22.1,15.0,32.0,4.6,6.4,4.0,32.0,5.0,4.8,6.0,21.0,45.5,43.8,21.0,3.0,25.0,24.3,5.0,28.0,186.0,14.0,1.6666666666666667,1.6666666666666667,16.0,16.0
2007.0,189.0,192.0,23.0,15.5,255.0,302.0,18.0,28.5,142.0,174.0,12.0,28.0,85.0,100.0,20.0,22.0,28.0,28.0,30.5,3.0,1.0,0.0,0.0,0.0,4.4,5.8,20.5,26.5,6183.0,32.0,5.1,6.4,14.0,29.5,28.0,146.0,156.0,27.0,-4.099999999999998,29.0,28.7,32.8,29.0,26.0,285.0,56.4,62.8,24.0,29.0,337.0,19.0,26.0,12.0,24.0,13.916666666666664,15.0,-87.11,-36.54,-40.45,18.0,23.0,-38.04,46.96,7.0,21.0,13.43,18.0,25.0,85.7,84.4,16.0,14.0,2.0,6.0,9.0,9.0,2.0,2.0,6.0,8.0,6.0,2.0,12.0,16.0,6.5,16.0,20.5,25.0,20.11875,26.0,21.55,27.0,18.6875,20.0,25.0,1.0,1.0,0.48,17.5,21.16942148760331,24.0,23.0,26.0,17.0,3.4,2.6,25.0,18.5,1.0,1.0,14.0,25.0,18.0,HC,60.0,56.0,8.0,22.0,0.0,0.0,7.0,24.5,1146.0,1333.0,12.0,28.0,5.1,6.1,15.5,29.5,24.41666666666667,28.0,0.0,0.0,267.0,347.0,15.0,-80.0,21.0,26.5,505.0,537.0,16.0,24.0,0.5439838220424671,0.5426356589147286,22.0,23.0,1.6705882352941177,21.0,19.0,3.8,4.1,16.5,17.5,22.0,16.0,18.0,0.7307692307692307,0.6285714285714286,17.0,7.0,0.5999122614608466,0.6592264768135463,19.0,24.0,2735.0,3426.0,17.0,29.0,95.0,801.0,904.0,31.0,24.0,100.0,27.0,20.0,0.10980392156862744,0.09271523178807947,4.0,1.0,5.4,5.5,13.0,20.5,989.0,1032.0,24.0,20.5,92.0,0.0,0.0,16.5,11.5,55.0,32.0,4038.0,3245.0,18.0,3.0,76.0,19.5,4.0,0.0,1.0,24.0,22.5,269.0,579.0,32.0,21.0,1.34,1.7,18.0,26.0,32.0,19.0,71.9,85.1,21.0,28.0,2941.0,28.0,0.5985915492957746,12.0,0.4560161779575329,0.4573643410852714,11.0,10.0,0.2692307692307693,0.3714285714285713,16.0,26.0,0.40008773853915336,0.3407735231864537,14.0,9.0,451.0,472.0,25.0,9.5,7.0,13.0,21.5,28.5,1824.0,1771.0,18.0,14.0,19.7979797979798,26.0,26.5,32.3,17.0,27.0,0.0,0.0,33.0,6.1,4.1,31.0,16.5,206.0,177.0,27.0,16.0,23.0,31.0,17.0,28.0,32.0,18.0,21.0,24.0,27.0,18.5,18.0,29.0,13.8,14.6,15.5,13.0,30.0,12.5,1.0,14.0,16.0,19.338842975206614,21.0,27594.0,29952.0,28.0,CAR,4559.0,5197.0,16.0,29.0,100.0,100.0,21.5,12.0,27.0,38.0,20.5,24.0,27.0,38.0,21.0,24.0,5.8,6.7,11.0,31.0,4.0,3.8,6.5,17.0,10.3,10.7,7.5,29.0,19.1,23.8,25.0,31.0,8.4,10.5,25.0,20.0,4.6,5.0,10.0,28.0,43.9,42.7,10.5,11.5,23.9,27.0,12.5,29.0,-638.0,23.0,1.45,1.7631578947368425,9.0,29.0
2008.0,192.0,185.0,21.0,4.0,287.0,296.0,16.0,22.0,152.0,178.0,23.0,23.0,118.0,100.0,17.5,6.0,17.0,18.0,11.0,25.5,1.0,0.0,1.0,4.0,6.7,5.4,12.5,7.0,7622.0,9.0,7.4,6.2,12.5,6.5,47.0,147.0,160.0,27.5,4.199999999999998,2.0,31.8,27.6,2.5,8.5,246.0,59.4,59.8,13.0,22.0,333.0,25.5,30.0,12.0,23.0,15.083333333333336,15.0,48.11,39.47,0.6,7.0,15.0,26.42,9.47,20.0,3.0,8.47,12.0,12.0,90.3,85.7,15.0,5.0,0.0,7.0,9.0,12.0,3.0,0.0,7.0,9.0,11.0,1.0,7.0,13.0,8.5,5.0,15.166666666666664,12.0,10.425,5.0,17.35,21.0,3.5,1.0,12.0,2.0,1.0,0.5833333333333334,24.0,11.4564738292011,7.0,10.8,8.0,12.0,2.9,2.2,25.5,19.0,0.0,0.0,12.0,23.5,10.0,HC,60.0,59.0,9.0,23.5,0.0,0.0,11.0,22.5,1372.0,1292.0,8.0,24.0,7.3,5.7,6.0,4.5,8.75,5.0,0.0,2.0,414.0,329.0,12.0,85.0,8.0,7.0,414.0,557.0,27.0,32.0,0.4626865671641791,0.5789473684210527,12.0,30.0,1.2881355932203389,28.0,15.0,3.6,3.4,10.0,22.0,19.0,11.5,24.5,0.3333333333333333,0.5757575757575758,17.0,32.0,0.5644325290437889,0.6391772032458954,18.0,27.0,3158.0,3387.0,16.0,19.0,94.0,637.0,736.0,19.0,10.0,88.0,16.5,18.0,0.05923344947735192,0.060810810810810814,21.0,26.0,5.0,5.7,20.0,31.0,938.0,1026.0,26.0,27.0,76.0,3.0,0.0,16.5,32.0,41.0,25.5,3349.0,3672.0,27.0,16.0,80.0,24.5,15.5,0.0,1.0,25.5,21.5,453.0,276.0,14.0,3.0,2.08,1.64,10.0,9.0,42.0,7.0,84.7,81.4,15.0,14.0,3288.0,23.0,0.7763157894736842,5.0,0.5373134328358209,0.42105263157894735,21.0,3.0,0.6666666666666667,0.4242424242424242,16.0,1.0,0.43556747095621096,0.36082279675410456,15.0,6.0,504.0,432.0,15.0,6.0,30.0,14.0,17.0,1.0,2437.0,1912.0,20.0,3.0,12.636363636363635,5.0,38.0,30.8,11.0,10.0,0.0,0.0,20.0,4.6,6.2,12.0,8.0,130.0,230.0,11.0,7.0,37.0,9.0,6.0,31.0,28.0,10.0,18.0,28.0,24.0,12.0,13.5,19.0,9.9,12.4,18.0,5.0,25.0,15.5,6.0,7.0,6.0,12.112947658402204,6.0,28224.0,29600.0,21.0,CAR,5595.0,5299.0,18.0,10.0,100.0,96.9,3.0,13.5,46.0,32.0,9.0,3.0,46.0,31.0,9.0,3.0,7.9,6.5,6.5,4.5,4.8,4.4,23.0,3.0,13.4,10.9,8.0,1.0,22.9,21.9,9.0,16.0,10.8,6.7,7.0,5.5,6.0,5.2,14.0,4.0,44.1,45.9,30.0,14.5,29.2,28.4,14.0,14.0,296.0,16.0,1.6458333333333337,1.4772727272727268,29.0,15.0
2009.0,193.0,181.0,8.5,9.5,289.0,290.0,12.5,20.0,152.0,155.0,2.0,25.0,123.0,109.0,24.0,3.0,14.0,26.0,25.5,32.0,3.0,0.0,2.0,1.0,4.5,4.5,4.0,23.5,6869.0,27.0,5.4,5.1,4.0,21.5,35.0,150.0,158.0,20.0,-2.8000000000000007,28.0,28.2,31.0,23.0,26.0,264.0,56.8,61.6,20.0,26.0,305.0,10.0,28.0,10.0,24.0,10.583333333333334,8.0,-37.51,-34.35,41.72,4.0,24.0,2.15,16.13,19.0,6.0,65.07,5.0,20.0,81.5,70.4,3.0,20.0,0.0,7.0,10.0,6.0,4.0,0.0,7.0,9.0,5.0,1.0,11.0,15.0,2.0,19.0,15.583333333333336,16.0,14.75625,17.0,22.95,26.0,6.5625,4.0,23.0,0.0,2.0,0.4782608695652174,16.0,16.480991735537188,17.0,16.4,16.5,20.0,4.3,4.4,4.0,27.5,1.0,3.0,22.0,5.5,27.0,HC,51.0,51.0,9.0,30.0,0.0,1.0,24.5,23.5,1015.0,1267.0,12.0,32.0,5.6,5.8,8.5,21.5,18.0,19.0,0.0,0.0,315.0,308.0,9.0,7.0,17.0,21.0,465.0,495.0,5.0,29.0,0.4868035190615836,0.5389344262295082,25.0,31.0,1.2357723577235773,30.0,16.0,3.4,2.8,5.0,22.5,14.0,3.0,25.0,0.4705882352941176,0.4827586206896552,27.0,28.0,0.5284123088540683,0.6047892341183455,27.0,30.0,2799.0,3056.0,4.0,27.0,88.0,698.0,632.0,4.0,11.0,82.0,6.0,11.5,0.04844290657439446,0.0896551724137931,10.0,30.0,5.4,5.5,15.0,22.5,1023.0,976.0,9.0,12.0,77.0,1.0,0.0,16.5,29.5,41.0,25.0,3396.0,3315.0,15.0,12.0,74.0,12.5,13.5,0.0,1.0,27.5,20.5,282.0,452.0,28.0,18.0,1.58,1.44,5.0,20.5,34.0,20.5,70.5,71.7,5.0,26.0,3070.0,27.0,0.8092105263157895,3.0,0.5131964809384164,0.4610655737704918,8.0,2.0,0.5294117647058824,0.5172413793103448,6.0,5.0,0.4715876911459317,0.3952107658816545,6.0,3.0,525.0,450.0,21.0,2.0,18.0,15.0,19.5,10.0,2498.0,1997.0,22.0,3.0,22.61616161616161,32.0,29.0,26.5,6.0,23.0,2.0,0.0,33.0,6.6,5.9,17.5,20.5,271.0,193.0,21.0,24.0,31.0,23.5,13.5,27.0,27.0,12.0,24.0,22.0,19.0,6.5,20.0,31.0,15.0,19.3,2.0,20.0,37.0,4.0,6.0,9.0,24.0,16.56198347107438,18.0,28950.0,28598.0,13.0,CAR,5297.0,5053.0,8.0,19.0,96.9,100.0,23.0,26.0,32.0,33.0,11.5,20.0,31.0,33.0,12.5,21.0,6.6,6.6,8.0,18.0,4.8,4.4,21.5,2.5,11.6,10.7,5.5,11.5,19.9,24.8,30.0,31.0,8.3,11.0,29.0,16.5,5.2,5.2,13.5,18.0,44.1,44.8,24.0,12.0,27.4,27.9,10.5,21.0,244.0,15.0,1.375,1.4999999999999998,26.0,28.0
2010.0,197.0,196.0,25.5,7.0,225.0,328.0,26.0,32.0,125.0,176.0,10.0,32.0,78.0,121.0,29.0,28.0,22.0,31.0,26.0,17.0,0.0,0.0,0.0,0.0,2.9,5.4,10.5,32.0,6432.0,31.0,3.9,6.1,8.5,32.0,17.0,134.0,160.0,31.0,-4.699999999999998,31.5,28.7,33.4,31.0,26.0,256.0,52.9,62.0,18.0,31.0,326.0,15.5,32.0,8.0,25.5,17.833333333333332,19.0,-219.41,-143.05,-51.96,19.0,32.0,-66.92,50.21,6.0,31.0,3.87,14.0,32.0,86.2,90.6,27.0,10.0,0.0,9.0,2.0,14.0,4.0,0.0,9.0,2.0,11.0,3.0,16.0,12.0,11.0,29.0,18.25,22.5,24.79375,31.0,27.9,32.0,21.6875,23.5,31.0,0.0,1.0,0.5161290322580645,18.0,25.641873278236915,30.0,30.0,32.0,21.0,4.3,3.2,12.0,28.0,1.0,5.0,17.0,12.0,27.0,HC,74.0,45.0,2.0,4.0,0.0,0.0,7.0,24.5,1619.0,1064.0,3.0,4.0,4.3,6.1,17.0,32.0,28.25,32.0,0.0,0.0,196.0,408.0,26.0,-212.0,32.0,32.0,484.0,526.0,12.0,26.0,0.5550935550935551,0.5254716981132076,27.0,19.0,1.6025641025641026,27.0,9.0,1.9,3.6,5.0,31.0,19.0,6.0,32.0,0.5625,0.4871794871794872,32.0,26.0,0.5535671100362757,0.6313732787495347,24.0,31.0,2289.0,3393.0,11.0,32.0,106.0,918.0,765.0,14.0,25.0,90.0,12.0,25.0,0.09777777777777777,0.09451219512195122,9.0,6.0,5.0,5.6,20.5,30.5,962.0,1060.0,28.0,25.0,95.0,0.0,0.0,16.5,12.5,54.0,31.0,4094.0,3306.0,16.0,3.0,76.0,14.5,1.0,0.0,1.0,26.0,21.0,373.0,488.0,27.0,11.0,0.95,1.87,24.0,32.0,39.0,13.0,57.0,81.0,12.0,32.0,2635.0,32.0,0.624,6.0,0.4449064449064449,0.4745283018867924,6.0,14.0,0.4375,0.5128205128205128,1.0,7.0,0.4464328899637243,0.3686267212504653,9.0,2.0,428.0,503.0,28.0,16.5,7.0,20.0,31.0,31.0,1846.0,1981.0,23.0,13.0,16.5959595959596,19.0,20.8,35.2,22.5,32.0,1.0,0.0,50.0,9.4,5.6,18.5,31.0,346.0,224.0,19.0,30.0,31.0,21.0,30.5,29.0,32.0,20.5,17.5,25.0,29.0,27.0,14.0,37.0,17.8,14.3,11.0,29.0,29.0,11.5,-8.0,25.5,29.5,21.283746556473826,29.0,26398.0,31360.0,30.0,CAR,4135.0,5374.0,18.0,32.0,100.0,100.0,21.0,12.5,17.0,45.0,26.0,32.0,17.0,45.0,26.5,32.0,5.4,6.9,15.5,32.0,4.3,3.9,8.5,12.0,10.3,11.1,12.5,30.0,21.9,23.6,20.0,19.0,9.6,9.0,16.0,19.0,4.3,5.1,9.0,32.0,43.1,43.5,16.5,20.0,20.7,27.4,13.5,32.0,-1239.0,31.0,1.2558139534883723,1.7692307692307694,9.5,32.0
2011.0,204.0,206.0,31.0,1.0,286.0,315.0,19.0,20.5,130.0,182.0,14.0,31.0,129.0,101.0,20.5,4.0,27.0,32.0,25.5,19.0,6.0,0.0,3.0,0.0,4.8,6.6,27.0,24.0,6906.0,22.0,5.9,7.6,28.0,22.0,36.0,140.0,149.0,28.0,-1.6000000000000014,23.0,26.7,28.3,17.0,26.0,217.0,50.6,62.4,24.0,32.0,333.0,18.5,32.0,18.0,14.0,20.58333333333333,20.0,-93.02,-68.25,-71.37,24.0,30.0,-19.17,13.07,19.0,14.0,-47.98,20.0,28.0,76.0,82.1,15.0,27.5,0.0,6.0,8.0,7.0,4.0,0.0,5.0,8.0,3.0,3.0,17.0,9.0,21.0,32.0,18.33333333333333,22.0,16.35625,18.0,22.15,29.0,10.5625,8.0,30.0,0.0,2.0,0.5666666666666667,26.0,22.03099173553719,28.0,24.5,28.0,13.0,3.0,1.7,28.5,19.0,3.0,4.0,9.0,29.0,9.5,HC,39.0,20.0,2.0,22.0,0.0,0.0,12.0,21.0,956.0,491.0,1.0,21.0,5.2,6.4,20.0,29.0,21.58333333333333,24.0,0.0,0.0,309.0,390.0,24.0,-81.0,25.0,25.0,429.0,534.0,14.0,32.0,0.4631268436578171,0.5409219190968956,24.0,32.0,1.007751937984496,32.0,20.0,4.7,4.5,20.5,9.0,24.0,17.5,20.0,0.6451612903225806,0.6857142857142857,12.5,15.5,0.4804579549940782,0.6469868995633188,23.0,32.0,2434.0,3704.0,18.0,31.0,101.0,843.0,845.0,14.0,13.0,99.0,15.5,16.5,0.0944055944055944,0.1015873015873016,8.0,15.0,5.1,5.3,7.5,31.0,1017.0,1063.0,27.0,14.5,101.0,0.0,0.0,16.5,12.0,51.0,32.0,4783.0,0.0,16.5,1.0,92.0,29.0,2.0,2.0,1.0,23.0,2.5,596.0,585.0,30.0,3.0,1.34,1.69,16.0,27.0,47.0,3.5,73.5,93.1,28.0,26.0,2708.0,31.0,0.9923076923076924,1.0,0.5368731563421829,0.4590780809031044,9.0,1.0,0.3548387096774194,0.3142857142857143,20.5,17.5,0.5195420450059218,0.3530131004366812,10.0,1.0,546.0,488.0,27.0,1.5,11.0,11.0,16.0,19.5,2632.0,2021.0,22.0,1.0,15.505050505050509,12.0,24.5,33.0,18.0,27.0,0.0,1.0,42.0,8.9,7.1,10.0,27.5,274.0,283.0,7.5,23.0,41.0,11.5,23.5,25.0,39.0,30.0,29.0,19.0,32.0,29.5,30.5,30.0,14.2,7.8,32.0,22.0,18.0,28.5,-12.0,26.5,26.0,19.561983471074377,29.0,28560.0,30694.0,21.0,DEN,5066.0,5725.0,20.0,23.0,100.0,100.0,20.0,13.0,30.0,40.0,22.5,25.0,30.0,40.0,22.5,25.0,6.3,7.5,21.5,28.0,4.8,4.1,12.0,6.0,12.5,12.0,16.0,11.5,24.5,24.6,20.5,11.5,12.7,11.5,20.5,3.5,5.0,5.4,15.0,24.0,47.4,0.0,16.5,6.0,24.8,27.7,11.5,27.0,-659.0,27.0,1.3125,1.8292682926829267,5.0,31.0
2012.0,188.0,193.0,26.5,14.0,380.0,287.0,4.0,3.0,232.0,183.0,11.5,6.0,112.0,73.0,2.0,9.0,36.0,31.0,20.0,6.5,2.0,0.0,1.0,0.0,7.8,4.9,4.0,1.0,7671.0,7.0,8.4,6.0,6.0,3.5,57.0,160.0,143.0,11.0,3.6000000000000014,6.0,29.1,25.5,4.5,8.0,402.0,68.4,57.4,7.0,2.0,321.0,10.0,5.5,40.0,3.0,4.916666666666667,2.0,135.85,197.32,31.07,2.0,3.0,-59.03,45.6,7.0,30.0,91.32,2.0,6.0,81.3,88.0,25.0,23.0,1.0,7.0,11.0,9.0,4.0,1.0,7.0,10.0,5.0,3.0,14.0,8.0,23.0,26.0,7.458333333333332,2.0,10.3875,5.0,4.4,2.0,16.375,15.0,22.0,1.0,0.0,0.6363636363636364,29.0,8.043112947658402,3.0,7.1,5.0,11.0,1.9,2.9,11.5,5.0,5.0,2.0,16.0,13.0,6.5,HC,28.0,34.0,8.5,31.0,1.0,0.0,11.5,7.0,646.0,751.0,5.0,30.0,7.4,5.2,1.0,1.0,8.5,5.0,0.0,0.0,481.0,289.0,4.0,192.0,2.0,2.0,588.0,559.0,17.0,10.0,0.5587155963302752,0.6019704433497537,8.0,21.0,2.071428571428572,14.0,37.0,6.3,4.5,18.0,4.0,25.0,17.5,3.0,0.7551020408163265,0.8333333333333334,2.0,9.0,0.7122211749921458,0.6865864144453998,8.0,8.0,4534.0,3194.0,3.0,5.0,100.0,805.0,951.0,27.0,8.0,123.0,30.5,13.0,0.09473684210526316,0.10801393728222997,5.0,12.0,6.0,5.4,4.5,6.0,1090.0,1015.0,13.5,4.5,67.0,0.0,0.0,16.5,9.0,33.0,13.5,3099.0,0.0,16.5,25.0,94.0,32.0,27.5,1.0,0.0,9.5,9.0,445.0,197.0,4.0,5.5,2.24,1.43,5.0,4.5,49.0,2.0,105.3,79.4,9.0,2.0,4671.0,6.0,0.4827586206896552,19.0,0.4412844036697248,0.3980295566502463,25.0,12.0,0.2448979591836735,0.16666666666666666,31.0,24.0,0.28777882500785423,0.3134135855546002,25.0,25.0,481.0,404.0,7.0,9.0,12.0,5.0,1.5,15.0,1832.0,1458.0,3.0,16.0,15.06060606060606,13.0,39.9,26.9,3.0,4.0,2.0,1.0,21.0,3.4,8.5,2.0,1.0,137.0,364.0,1.0,1.0,52.0,1.5,2.0,32.0,25.0,5.0,16.0,26.0,22.0,8.0,18.5,25.0,12.2,11.9,17.5,16.0,24.0,16.5,-1.0,18.5,16.0,8.986225895316805,2.0,30080.0,27599.0,8.0,DEN,6366.0,4652.0,2.0,4.0,100.0,100.0,19.0,14.0,55.0,29.0,4.0,3.0,55.0,29.0,4.0,3.0,7.9,6.4,5.0,5.0,3.8,3.6,2.0,25.0,11.6,11.1,11.0,13.5,23.1,22.1,7.0,18.0,9.1,6.0,2.0,18.0,5.8,4.6,1.5,7.0,46.3,0.0,16.5,15.5,33.9,24.1,1.0,3.0,1714.0,1.0,2.0789473684210527,1.7777777777777781,7.0,3.0
2013.0,202.0,206.0,31.0,4.0,435.0,339.0,27.0,1.0,293.0,208.0,27.5,1.0,107.0,90.0,13.0,10.0,35.0,41.0,30.0,10.5,1.0,0.0,0.0,0.0,8.8,5.9,16.5,1.0,8837.0,1.0,9.2,6.8,17.0,1.0,76.0,145.0,141.0,23.5,0.8000000000000007,13.5,28.3,27.5,14.0,11.0,461.0,68.3,58.2,6.0,3.0,357.0,22.0,1.0,18.0,18.5,18.166666666666668,22.0,274.57,291.3,-99.8,26.0,1.0,-18.03,59.04,3.0,15.0,-37.26,21.0,1.0,96.2,88.5,20.0,1.0,2.0,4.0,5.0,8.0,7.0,2.0,4.0,5.0,8.0,6.0,16.0,9.0,21.5,32.0,17.166666666666668,15.5,8.14375,2.0,1.6,1.0,14.6875,14.0,27.0,1.0,0.0,0.5925925925925926,29.0,11.459090909090907,8.0,9.1,6.0,10.0,1.5,2.8,15.5,1.5,1.0,2.0,17.0,13.0,5.5,HC,39.0,32.0,8.5,18.5,1.0,1.0,28.0,4.0,974.0,936.0,16.0,14.0,7.8,6.2,15.5,1.0,6.666666666666668,2.0,1.0,0.0,606.0,399.0,22.0,207.0,1.0,1.0,675.0,613.0,27.0,2.0,0.6012110726643599,0.6089385474860335,7.0,11.0,2.7383177570093458,5.0,55.0,8.1,4.7,20.0,1.0,29.0,23.5,1.0,0.7746478873239436,0.6590909090909091,19.0,5.0,0.7440207735410688,0.7145365168539326,5.0,4.0,5444.0,4070.0,27.0,1.0,117.0,1000.0,807.0,13.0,27.5,97.0,15.0,29.0,0.08045977011494253,0.12094395280235988,5.0,19.0,5.9,5.3,6.0,6.0,1156.0,1074.0,23.0,1.0,66.0,1.0,0.0,16.5,23.5,28.0,7.5,2893.0,0.0,16.5,28.0,89.0,28.0,29.0,1.0,0.0,12.0,7.0,343.0,274.0,14.0,12.0,2.83,1.83,18.5,1.0,44.0,4.0,114.4,84.5,17.0,1.0,5572.0,1.0,0.3651877133105802,28.0,0.3987889273356401,0.3910614525139665,26.0,22.0,0.2253521126760564,0.3409090909090909,14.0,28.0,0.25597922645893123,0.2854634831460674,28.0,29.0,461.0,420.0,8.0,11.0,16.0,15.0,23.5,8.0,1873.0,1626.0,7.5,15.0,17.555555555555557,20.0,47.5,32.5,14.0,1.0,0.0,1.0,20.0,2.9,6.3,17.0,1.0,128.0,290.0,9.0,1.0,41.0,14.0,1.0,26.0,26.0,3.5,27.5,25.0,23.0,7.0,18.5,26.0,10.4,12.6,18.0,11.0,26.0,16.5,0.0,15.0,17.5,13.818181818181818,9.0,29290.0,29046.0,15.0,DEN,7317.0,5696.0,19.0,1.0,100.0,100.0,19.0,14.0,75.0,44.0,23.0,1.0,75.0,44.0,23.0,1.0,8.3,7.1,16.0,3.0,4.1,3.9,9.0,18.5,12.1,12.2,24.5,8.0,25.0,29.3,32.0,6.0,7.8,9.8,23.0,22.5,6.3,5.3,16.0,1.5,43.8,0.0,16.5,24.0,36.2,27.5,12.0,2.0,1621.0,1.0,2.0243902439024395,1.8205128205128205,9.0,7.0
2014.0,198.0,195.0,25.5,3.5,360.0,311.0,14.5,6.0,227.0,219.0,29.0,6.0,98.0,60.0,2.0,13.5,35.0,32.0,17.5,11.5,2.0,0.0,2.0,0.0,7.7,5.0,3.0,4.0,7674.0,5.0,8.1,5.7,3.5,4.0,58.0,149.0,146.0,24.5,0.5999999999999979,16.0,28.9,28.3,22.0,9.5,399.0,65.7,62.2,14.0,8.0,399.0,32.0,5.0,20.0,11.0,9.333333333333334,5.0,130.29,161.99,-45.39,9.0,5.0,-29.0,52.59,7.0,17.0,13.81,5.0,7.0,82.8,82.1,14.0,21.0,2.0,9.0,8.0,7.0,3.0,2.0,9.0,7.0,5.0,1.0,5.0,7.0,24.5,4.0,12.166666666666664,10.0,9.3125,3.0,6.25,4.0,12.375,11.0,16.0,1.0,1.0,0.3125,4.5,10.472314049586778,5.0,9.3,7.0,15.0,2.5,2.8,12.0,17.5,2.0,1.0,18.0,8.5,17.0,HC,32.0,35.0,13.0,24.5,0.0,0.0,13.5,19.0,802.0,905.0,16.0,20.0,7.5,5.3,1.0,2.5,7.083333333333332,3.0,0.0,0.0,482.0,354.0,16.5,128.0,4.0,2.0,607.0,641.0,32.0,9.5,0.584817244611059,0.6614936954413191,1.0,19.0,2.3163265306122454,13.0,40.0,6.6,4.5,15.5,3.0,29.0,26.0,2.0,0.7272727272727273,0.7631578947368421,6.0,11.0,0.7230840831523425,0.7386852344869957,2.0,11.0,4661.0,3607.0,9.0,4.0,120.0,1045.0,816.0,9.0,29.0,103.0,12.0,28.0,0.09722222222222222,0.10289389067524116,16.0,16.0,5.5,5.4,4.0,23.0,1067.0,1031.0,20.0,7.0,69.0,0.0,0.0,16.5,6.5,33.0,19.5,3048.0,4035.0,31.0,25.0,88.0,29.5,21.5,0.0,1.0,26.0,21.5,296.0,371.0,26.0,11.0,2.31,1.72,12.5,4.0,41.0,5.0,101.3,82.4,8.0,4.0,4779.0,4.0,0.4317180616740088,20.0,0.415182755388941,0.3385063045586809,32.0,14.0,0.2727272727272727,0.23684210526315785,27.0,22.0,0.2769159168476575,0.26131476551300425,31.0,22.0,443.0,349.0,1.0,12.0,15.0,9.0,9.0,9.5,1785.0,1276.0,2.0,15.0,20.80808080808081,29.0,39.9,31.3,9.5,6.0,1.0,0.0,17.0,2.7,6.0,21.5,1.0,118.0,252.0,14.0,2.0,41.0,10.5,1.0,29.0,28.0,10.5,22.5,24.0,23.0,11.0,23.5,20.0,9.6,11.8,21.0,7.0,25.0,16.5,5.0,11.5,7.5,11.644628099173556,3.0,29502.0,28470.0,13.0,DEN,6446.0,4883.0,3.0,4.0,100.0,100.0,20.0,13.5,56.0,37.0,13.0,1.5,56.0,37.0,13.5,1.5,7.9,6.0,1.0,5.0,4.0,3.7,4.5,20.5,12.0,9.7,1.0,10.5,25.1,25.9,24.0,8.0,7.2,11.2,29.0,20.5,6.0,4.7,2.0,4.5,44.2,45.9,25.5,22.0,32.6,24.9,1.0,7.0,1563.0,2.0,1.975,1.6216216216216215,24.0,6.0
2015.0,179.0,175.0,3.0,24.5,312.0,307.0,10.5,21.0,177.0,182.0,7.0,25.0,108.0,103.0,24.0,7.0,27.0,22.0,2.5,24.0,5.0,0.0,2.0,0.0,6.4,7.0,25.0,13.5,6831.0,23.0,7.1,8.0,28.0,15.5,34.0,169.0,161.0,7.0,3.0,7.0,29.4,26.4,7.5,6.5,334.0,63.9,62.8,14.0,13.0,322.0,3.5,23.0,0.0,31.5,19.916666666666668,20.0,23.83,49.93,-101.61,22.0,17.0,-20.72,8.7,26.0,11.0,-87.45,25.0,18.0,84.6,85.7,21.5,18.0,1.0,8.0,12.0,9.0,9.0,1.0,8.0,10.0,7.0,7.0,9.0,9.0,18.5,16.0,22.16666666666667,27.0,15.2625,15.0,18.65,25.0,11.875,10.0,20.0,0.0,1.0,0.45,12.0,16.19063360881543,16.0,14.3,13.0,12.0,2.3,1.6,29.0,19.0,0.0,3.0,8.0,30.5,13.5,HC,33.0,39.0,21.0,18.5,0.0,2.0,32.0,19.0,892.0,983.0,23.0,10.0,6.6,6.6,19.5,12.5,18.166666666666668,20.0,0.0,0.0,335.0,397.0,20.0,-62.0,21.0,23.0,523.0,513.0,5.0,25.0,0.5434146341463415,0.5586136595310908,26.0,26.0,1.6388888888888888,26.0,21.0,4.0,6.0,29.0,23.0,31.0,26.5,24.0,0.6176470588235294,0.775,6.0,25.5,0.6639477977161501,0.650081418491044,32.0,23.0,3663.0,3593.0,4.0,23.0,99.0,909.0,895.0,12.0,16.0,98.0,5.0,7.0,0.08653846153846154,0.07166123778501629,30.0,26.0,5.9,5.8,21.5,9.0,1025.0,981.0,3.0,18.0,74.0,1.0,0.0,11.0,27.0,30.0,11.5,3233.0,3273.0,13.0,21.0,74.0,14.5,18.0,0.0,1.0,26.5,22.5,242.0,229.0,12.0,24.0,1.88,2.01,24.0,15.0,31.0,21.5,89.8,99.1,26.0,16.0,3846.0,25.0,0.6101694915254238,7.0,0.4565853658536585,0.4413863404689092,7.0,7.0,0.38235294117647056,0.225,27.0,7.5,0.3360522022838499,0.34991858150895605,1.0,10.0,468.0,433.0,21.0,6.0,13.0,9.0,8.5,13.0,1854.0,1934.0,23.0,11.0,15.520202020202026,14.0,37.4,36.6,20.0,10.0,0.0,0.0,34.0,6.1,6.4,12.0,20.0,183.0,237.0,18.5,7.0,35.0,22.5,15.0,39.0,28.0,11.5,4.5,33.0,24.0,11.5,4.0,21.0,11.2,8.0,29.0,16.0,17.0,28.0,-4.0,20.0,13.5,18.081267217630856,20.0,30251.0,28175.0,7.5,CHI,5517.0,5527.0,14.0,21.0,96.6,93.5,18.0,12.0,29.0,46.0,27.0,28.0,28.0,43.0,26.0,27.5,7.4,7.5,20.0,12.0,4.0,4.5,27.5,18.0,11.5,11.9,24.0,12.5,27.0,25.2,21.5,3.0,7.8,7.6,14.0,20.0,5.4,5.6,22.0,19.0,43.7,44.2,8.0,25.5,30.7,31.4,22.5,16.0,-10.0,16.0,1.85,1.6666666666666667,22.0,10.0
2016.0,171.0,174.0,4.0,31.0,324.0,322.0,14.0,17.0,212.0,188.0,11.5,10.0,93.0,99.0,23.5,16.5,19.0,35.0,25.5,31.5,0.0,0.0,0.0,1.0,6.0,6.5,24.0,18.5,6986.0,11.0,6.6,7.4,24.0,21.0,32.0,158.0,176.0,21.0,-4.099999999999998,30.0,25.1,29.2,24.0,31.0,347.0,62.1,64.5,23.0,19.0,342.0,9.0,21.5,14.0,12.0,20.58333333333333,23.0,7.05,36.06,-114.88,22.0,23.0,-19.89,4.38,26.0,18.0,-101.61,24.0,21.0,78.3,94.3,32.0,27.0,0.0,8.0,8.0,4.0,3.0,0.0,7.0,7.0,3.0,1.0,12.0,3.0,31.0,28.0,18.416666666666668,21.0,18.6,22.0,17.7,22.0,19.5,21.5,26.0,1.0,1.0,0.4615384615384616,19.0,23.14393939393939,29.0,26.5,30.0,19.0,3.4,1.5,28.0,28.5,1.0,1.0,8.0,30.0,28.5,HC,42.0,36.0,20.0,3.0,0.0,0.0,13.0,19.5,897.0,777.0,21.0,6.0,6.8,6.3,16.5,8.5,17.333333333333332,19.0,0.0,0.0,279.0,399.0,24.0,-120.0,28.0,28.5,559.0,530.0,4.0,22.0,0.6070320579110652,0.5602766798418972,28.0,13.0,2.2795698924731185,16.0,19.0,3.4,4.2,17.0,24.5,22.0,12.5,24.5,0.6551724137931034,0.55,25.0,13.5,0.6958274894810659,0.6485219899062725,27.0,18.0,3969.0,3598.0,7.0,14.0,110.0,967.0,959.0,22.0,22.0,103.0,9.5,21.0,0.05864197530864197,0.10869565217391304,8.0,32.0,5.8,6.0,23.5,16.0,967.0,1012.0,13.0,30.0,68.0,0.0,0.0,13.0,13.5,22.0,3.5,2995.0,3049.0,10.5,24.0,67.0,9.0,23.0,1.0,1.0,27.5,5.5,215.0,282.0,18.5,25.0,1.5,2.18,26.0,27.0,27.0,23.5,81.8,93.5,23.0,25.0,4139.0,15.0,0.4386792452830189,17.0,0.3929679420889348,0.4397233201581028,5.0,20.0,0.3448275862068966,0.45,8.0,19.5,0.3041725105189341,0.3514780100937275,6.0,15.0,380.0,445.0,26.0,25.5,10.0,18.0,26.0,23.5,1735.0,1950.0,27.0,17.0,22.0,30.0,27.5,42.0,30.0,28.0,1.0,1.0,28.0,4.8,6.5,8.0,8.0,170.0,230.0,12.5,5.0,37.0,12.0,8.0,23.0,35.0,25.0,28.0,18.0,33.0,28.0,30.5,31.0,17.0,6.3,30.0,30.0,11.0,32.0,-20.0,31.5,30.0,19.787878787878785,29.0,27018.0,30624.0,31.0,CHI,5704.0,5548.0,15.0,15.0,96.9,90.5,8.0,11.0,32.0,42.0,25.5,25.5,31.0,38.0,25.0,20.5,7.4,7.2,17.0,11.5,4.6,4.4,22.0,5.0,11.9,11.2,15.5,9.0,21.4,21.6,16.0,17.0,8.0,12.8,32.0,19.0,5.9,5.5,15.5,5.5,44.0,45.5,16.5,25.5,33.2,31.9,20.5,8.5,156.0,12.0,1.6086956521739133,1.6363636363636362,23.0,20.5
Mean year,192.53333333333333,191.6,20.733333333333334,10.8,302.6,298.53333333333336,13.5,18.7,175.2,176.46666666666667,13.066666666666666,19.633333333333333,100.93333333333334,93.33333333333333,14.566666666666666,14.766666666666667,26.466666666666665,28.733333333333334,20.366666666666667,17.266666666666666,1.8666666666666667,0.0,0.9333333333333333,0.7333333333333333,5.8066666666666675,5.36,12.466666666666667,15.4,7049.933333333333,19.333333333333332,6.5666666666666655,6.213333333333335,12.566666666666666,15.7,39.86666666666667,149.73333333333332,153.0,21.533333333333335,-0.04666666666666615,16.9,29.37333333333333,29.42,15.4,16.866666666666667,309.4,59.76,60.14666666666667,13.9,18.366666666666667,324.4,15.4,20.833333333333332,15.733333333333333,17.166666666666668,13.02222222222222,12.133333333333333,-5.826000000000001,40.26066666666666,-20.508666666666667,13.066666666666666,16.466666666666665,-37.666000000000004,38.068000000000005,11.6,20.2,25.05266666666666,12.333333333333334,17.533333333333335,82.16666666666667,82.45333333333333,17.333333333333332,17.233333333333334,0.8,7.666666666666667,7.533333333333333,8.533333333333333,4.666666666666667,0.8,7.4,6.666666666666667,6.4,2.8,12.2,11.066666666666666,16.3,20.066666666666666,15.080555555555552,14.4,15.967916666666664,16.466666666666665,16.106666666666666,18.666666666666668,15.829166666666667,15.733333333333333,24.0,0.6666666666666666,1.0,0.5042680762781278,18.866666666666667,16.063103764921948,16.133333333333333,16.426666666666666,16.4,15.733333333333333,3.153333333333333,2.9599999999999995,16.266666666666666,19.033333333333335,1.6666666666666667,2.066666666666667,15.8,16.433333333333334,16.8,,50.266666666666666,49.0,11.766666666666667,21.5,0.2,0.26666666666666666,14.3,18.533333333333335,1097.4666666666667,1108.7333333333333,12.266666666666667,21.533333333333335,6.279999999999999,5.826666666666666,10.866666666666667,14.333333333333334,17.27777777777778,17.466666666666665,0.06666666666666667,0.13333333333333333,352.2,341.93333333333334,14.433333333333334,10.266666666666667,15.6,17.4,513.1333333333333,539.3333333333334,15.766666666666667,21.266666666666666,0.5374414601432747,0.5673611154248195,17.133333333333333,21.933333333333334,1.767030301123346,20.133333333333333,23.866666666666667,4.506666666666667,4.000000000000001,14.066666666666666,15.366666666666667,21.733333333333334,14.333333333333334,16.733333333333334,0.6398190528560311,0.6329814956902072,16.1,15.7,0.6339757232136859,0.657019932824236,17.666666666666668,19.2,3440.5333333333333,3370.6,10.666666666666666,18.266666666666666,103.8,858.0,864.0666666666667,18.133333333333333,17.366666666666667,101.73333333333333,15.566666666666666,18.066666666666666,0.0880858790190448,0.09597363711132294,11.4,16.333333333333332,5.413333333333333,5.473333333333333,12.566666666666666,20.966666666666665,1010.0666666666667,1018.6666666666666,17.866666666666667,17.6,81.53333333333333,0.8,0.0,15.9,19.733333333333334,41.4,20.8,3630.8,2827.6,19.666666666666668,13.533333333333333,82.93333333333334,21.6,14.233333333333333,0.5333333333333333,0.6666666666666666,20.733333333333334,15.3,352.53333333333336,374.46666666666664,20.233333333333334,14.033333333333333,1.7139999999999995,1.649333333333333,12.966666666666667,17.266666666666666,40.4,11.7,83.23333333333332,81.34666666666666,13.5,17.2,3648.5333333333333,18.933333333333334,0.6082809786957516,12.866666666666667,0.46255853985672524,0.43263888457518057,15.866666666666667,11.066666666666666,0.3601809471439688,0.3670185043097928,16.9,17.3,0.36602427678631405,0.3429800671757642,15.333333333333334,13.8,466.2,440.6,16.7,11.4,12.866666666666667,12.6,15.266666666666667,17.666666666666668,1927.5333333333333,1760.4666666666667,14.566666666666666,14.066666666666666,17.164983164983163,18.066666666666666,31.653333333333325,30.88,12.7,17.466666666666665,0.6666666666666666,0.26666666666666666,30.733333333333334,5.786666666666667,6.7,13.066666666666666,13.8,208.0,254.13333333333333,12.833333333333334,13.666666666666666,38.733333333333334,13.6,12.266666666666667,29.2,29.733333333333334,15.266666666666667,19.233333333333334,24.066666666666666,24.533333333333335,15.6,18.066666666666666,27.933333333333334,13.426666666666666,13.080000000000002,17.6,16.866666666666667,26.866666666666667,15.966666666666667,-1.0666666666666667,17.3,18.7,15.699540863177225,15.0,28754.466666666667,29236.733333333334,17.566666666666666,,5368.066666666667,5131.066666666667,11.533333333333333,17.6,98.82,98.32,16.5,15.966666666666667,38.0,36.2,15.5,17.333333333333332,37.6,35.53333333333333,15.566666666666666,17.2,7.060000000000001,6.733333333333334,11.533333333333333,14.766666666666667,4.113333333333333,3.993333333333333,11.833333333333334,16.933333333333334,11.806666666666667,11.206666666666667,13.266666666666667,12.366666666666667,22.240000000000002,23.099999999999998,16.6,18.3,8.639999999999997,9.153333333333334,17.5,17.4,5.3,5.033333333333333,10.333333333333334,15.866666666666667,44.45333333333334,35.05333333333333,18.866666666666667,13.5,27.913333333333334,26.8,10.633333333333333,17.966666666666665,237.0,14.766666666666667,1.7392339511059336,1.6905512402174792,15.5,14.366666666666667
Median year,193.0,192.0,23.0,7.0,287.0,302.0,14.0,20.5,157.0,177.0,11.5,23.0,100.0,98.0,14.0,13.5,27.0,30.0,24.5,18.5,1.0,0.0,1.0,0.0,6.0,5.2,11.0,13.5,6906.0,22.0,6.6,6.1,11.5,15.5,35.0,149.0,153.0,23.5,0.8000000000000007,13.5,28.9,29.4,14.0,11.5,285.0,59.4,59.8,13.0,18.0,322.0,15.5,26.0,14.0,16.5,13.916666666666664,14.0,1.55,39.47,-19.66,13.0,17.0,-38.04,45.6,7.0,21.0,13.81,12.0,18.0,82.8,84.4,16.0,18.5,1.0,7.0,8.0,9.0,4.0,1.0,7.0,7.0,6.0,3.0,12.0,10.0,18.5,19.0,16.0,15.5,15.75625,17.0,17.35,21.0,16.125,15.0,23.0,1.0,1.0,0.4782608695652174,17.5,16.19063360881543,16.0,15.2,15.0,16.0,3.2,2.8,13.0,19.0,1.0,2.0,16.0,13.0,17.0,,53.0,50.0,9.0,23.5,0.0,0.0,11.5,21.0,1083.0,1064.0,12.0,24.0,6.4,5.8,8.5,12.0,17.333333333333332,19.0,0.0,0.0,325.0,339.0,15.0,7.0,17.0,21.0,505.0,528.0,16.0,25.0,0.5439838220424671,0.5602766798418972,18.0,23.0,1.6388888888888888,20.0,19.0,4.0,4.1,15.5,17.5,22.0,14.0,18.0,0.6551724137931034,0.6285714285714286,15.5,13.5,0.6608080808080808,0.6469868995633188,19.0,19.0,3264.0,3393.0,9.0,18.0,101.0,843.0,845.0,14.0,16.0,99.0,15.0,20.0,0.0944055944055944,0.1015873015873016,9.0,16.0,5.4,5.4,13.0,22.5,994.0,1021.0,19.0,19.0,77.0,1.0,0.0,16.5,21.5,38.0,21.0,3396.0,3306.0,16.5,12.0,80.0,24.5,15.5,0.0,1.0,24.0,20.5,343.0,371.0,21.0,11.0,1.58,1.69,12.5,17.0,41.0,7.0,81.8,81.0,12.0,16.0,3485.0,21.0,0.6101694915254238,13.0,0.4560161779575329,0.4397233201581028,15.0,10.0,0.3448275862068966,0.3714285714285713,17.5,19.5,0.3391919191919192,0.3530131004366812,14.0,14.0,461.0,445.0,19.0,10.0,11.0,12.0,16.0,19.5,1832.0,1771.0,17.0,15.0,16.5959595959596,18.0,30.8,30.8,11.0,15.0,1.0,0.0,32.0,5.8,6.4,12.0,11.0,206.0,237.0,12.5,15.0,40.0,11.5,11.0,28.0,28.0,13.5,22.0,24.0,24.0,12.0,18.5,27.0,12.7,12.6,18.0,16.0,26.0,16.5,-1.0,18.5,16.5,16.56198347107438,16.0,28950.0,29046.0,15.0,,5225.0,5197.0,14.0,19.0,100.0,100.0,20.0,13.5,32.0,37.0,13.0,21.5,31.0,37.0,13.5,21.0,7.3,6.6,9.5,12.0,4.0,3.9,9.0,18.0,11.9,11.1,12.0,10.5,21.9,22.1,16.0,18.0,8.4,9.0,16.0,19.0,5.2,5.1,10.0,16.5,44.1,43.5,16.5,14.5,27.4,27.4,11.5,17.0,186.0,15.0,1.75,1.7297297297297298,11.0,10.0
