Year,#Dr,#Dr_Defense,#Dr_Defense_Low_Rank,#Dr_High_Rank,1stD,1stD_Defense,1stD_Defense_Low_Rank,1stD_High_Rank,1stDpass,1stDpass_Defense,1stDpass_Defense_Low_Rank,1stDpass_High_Rank,1stDrun,1stDrun_Defense,1stDrun_Defense_Low_Rank,1stDrun_High_Rank,1stPy,1stPy_Defense,1stPy_Defense_Low_Rank,1stPy_High_Rank,2PA,2PA_Defense,2PM,2PM_Defense,ANY/A,ANY/A_Defense,ANY/A_Defense_Low_Rank,ANY/A_High_Rank,APYd,APYd_High_Rank,AY/A,AY/A_Defense,AY/A_Defense_Low_Rank,AY/A_High_Rank,AllTD,AvgDriveTime,AvgDriveTime_Defense,AvgDriveTime_High_Rank,AvgFieldPositionDifferential,AvgFieldPositionDifferential_High_Rank,AvgStartingPosition,AvgStartingPosition_Defense,AvgStartingPosition_Defense_Low_Rank,AvgStartingPosition_High_Rank,Cmp,Cmp%,Cmp%_Defense,Cmp%_Defense_Low_Rank,Cmp%_High_Rank,Cmp_Defense,Cmp_Defense_Low_Rank,Cmp_High_Rank,DefensivePtsScored,DefensivePtsScored_High_Rank,Dscore,Dscore_Rank,ExpectedPoints,ExpectedPointsPassing,ExpectedPointsPassing_Defense,ExpectedPointsPassing_Defense_High_Rank,ExpectedPointsPassing_High_Rank,ExpectedPointsRunning,ExpectedPointsRunning_Defense,ExpectedPointsRunning_Defense_High_Rank,ExpectedPointsRunning_High_Rank,ExpectedPoints_Defense,ExpectedPoints_Defense_High_Rank,ExpectedPoints_High_Rank,FG%,FG%_Defense,FG%_Defense_Low_Rank,FG%_High_Rank,FGA019,FGA2029,FGA3039,FGA4049,FGA50Plus,FGM019,FGM2029,FGM3039,FGM4049,FGM50Plus,FL,FL_Defense,FL_Defense_High_Rank,FL_Low_Rank,FantasyDstScore,FantasyDstScore_Rank,FantasyOffenseScore,FantasyOffenseScore_Rank,FantasyPassScore,FantasyPassScore_Rank,FantasyRushScore,FantasyRushScore_Rank,Fmb,FmbTD,FmbTD_Defense,FumbleLostPercent,FumbleLostPercent_Low_Rank,GameControlPlusBalance,GameControlPlusBalance_Rank,GameControlScore,GameControlScore_Rank,Int,Int%,Int%_Defense,Int%_Defense_High_Rank,Int%_Low_Rank,IntTD,IntTD_Defense,Int_Defense,Int_Defense_High_Rank,Int_Low_Rank,Job,KickRet,KickRet_Defense,KickRet_Defense_Low_Rank,KickRet_High_Rank,KrTD,KrTD_Defense,KrTD_Defense_Low_Rank,KrTD_High_Rank,KrYds,KrYds_Defense,KrYds_Defense_Low_Rank,KrYds_High_Rank,NY/A,NY/A_Defense,NY/A_Defense_Low_Rank,NY/A_High_Rank,Oscore,Oscore_Rank,OthTD,OthTD_Defense,PF,PF_Defense,PF_Defense_Low_Rank,PF_Differential,PF_Differential_High_Rank,PF_High_Rank,PassAtt,PassAtt_Defense,PassAtt_Defense_Low_Rank,PassAtt_High_Rank,PassPercent,PassPercent_Defense,PassPercent_Defense_High_Rank,PassPercent_High_Rank,PassRun1dRatio,PassRun1dRatio_High_Rank,PassTD,PassTD%,PassTD%_Defense,PassTD%_Defense_Low_Rank,PassTD%_High_Rank,PassTD_Defense,PassTD_Defense_Low_Rank,PassTD_High_Rank,PassTdPercent,PassTdPercent_Defense,PassTdPercent_Defense_High_Rank,PassTdPercent_High_Rank,PassYdPercent,PassYdPercent_Defense,PassYdPercent_Defense_High_Rank,PassYdPercent_High_Rank,PassYds,PassYds_Defense,PassYds_Defense_Low_Rank,PassYds_High_Rank,Pen,PenYds,PenYds_Defense,PenYds_Defense_Low_Rank,PenYds_Low_Rank,Pen_Defense,Pen_Defense_Low_Rank,Pen_Low_Rank,Penalty1dPercent,Penalty1dPercent_Defense,Penalty1dPercent_Defense_High_Rank,Penalty1dPercent_High_Rank,Plays/Drive,Plays/Drive_Defense,Plays/Drive_Defense_Low_Rank,Plays/Drive_High_Rank,Ply,Ply_Defense,Ply_Defense_Low_Rank,Ply_High_Rank,Pnt,PntBlck,PntBlck_Defense,PntBlck_Defense_Low_Rank,PntBlck_Low_Rank,PntRet_Defense,PntRet_Defense_Low_Rank,PntYds,PntYds_Defense,PntYds_Defense_Low_Rank,PntYds_High_Rank,Pnt_Defense,Pnt_Defense_Low_Rank,Pnt_High_Rank,PrTD,PrTD_Defense,PrTD_Defense_Low_Rank,PrTD_High_Rank,PrYds,PrYds_Defense,PrYds_Defense_Low_Rank,PrYds_High_Rank,Pts/Drive,Pts/Drive_Defense,Pts/Drive_Defense_Low_Rank,Pts/Drive_High_Rank,PuntRet,PuntRet_High_Rank,QbRating,QbRating_Defense,QbRating_Defense_Low_Rank,QbRating_High_Rank,RawPassYds,RawPassYds_High_Rank,RunPass1dRatio,RunPass1dRatio_High_Rank,RunPercent,RunPercent_Defense,RunPercent_Defense_High_Rank,RunPercent_High_Rank,RunTdPercent,RunTdPercent_Defense,RunTdPercent_Defense_High_Rank,RunTdPercent_High_Rank,RunYdPercent,RunYdPercent_Defense,RunYdPercent_Defense_High_Rank,RunYdPercent_High_Rank,RushAtt,RushAtt_Defense,RushAtt_Defense_Low_Rank,RushAtt_High_Rank,RushTD,RushTD_Defense,RushTD_Defense_Low_Rank,RushTD_High_Rank,RushYds,RushYds_Defense,RushYds_Defense_Low_Rank,RushYds_High_Rank,STscore,STscore_Rank,Sc%,Sc%_Defense,Sc%_Defense_Low_Rank,Sc%_High_Rank,Sfty,Sfty_Defense,Sk,Sk%,Sk%_Defense,Sk%_Defense_High_Rank,Sk%_Low_Rank,SkYds,SkYds_Defense,SkYds_Defense_High_Rank,SkYds_Low_Rank,Sk_Defense,Sk_Defense_High_Rank,Sk_Low_Rank,TFGA,TFGA_Defense,TFGA_Defense_Low_Rank,TFGA_High_Rank,TFGM,TFGM_Defense,TFGM_Defense_Low_Rank,TFGM_High_Rank,TO,TO%,TO%_Defense,TO%_Defense_High_Rank,TO%_Low_Rank,TO_Defense,TO_Defense_High_Rank,TO_Differential,TO_Differential_High_Rank,TO_Low_Rank,ThreePhaseScore,ThreePhaseScore_Rank,TimeOfPossession,TimeOfPossession_Defense,TimeOfPossession_High_Rank,Tm,TotalYds,TotalYds_Defense,TotalYds_Defense_Low_Rank,TotalYds_High_Rank,XP%,XP%_Defense,XP%_Defense_Low_Rank,XP%_High_Rank,XPA,XPA_Defense,XPA_Defense_Low_Rank,XPA_High_Rank,XPM,XPM_Defense,XPM_Defense_Low_Rank,XPM_High_Rank,Y/Apass,Y/Apass_Defense,Y/Apass_Defense_Low_Rank,Y/Apass_High_Rank,Y/Arun,Y/Arun_Defense,Y/Arun_Defense_Low_Rank,Y/Arun_High_Rank,Y/C,Y/C_Defense,Y/C_Defense_Low_Rank,Y/C_High_Rank,Y/KR,Y/KR_Defense,Y/KR_Defense_Low_Rank,Y/KR_High_Rank,Y/PR,Y/PR_Defense,Y/PR_Defense_Low_Rank,Y/PR_High_Rank,Y/Play,Y/Play_Defense,Y/Play_Defense_Low_Rank,Y/Play_High_Rank,Y/Pnt,Y/Pnt_Defense,Y/Pnt_Defense_Low_Rank,Y/Pnt_High_Rank,Yds/Drive,Yds/Drive_Defense,Yds/Drive_Defense_Low_Rank,Yds/Drive_High_Rank,Yds_Differential,Yds_Differential_High_Rank,YppYprRatio,YppYprRatio_Defense,YppYprRatio_Defense_High_Rank,YppYprRatio_High_Rank
1999.0,205.0,220.0,31.0,7.5,218.0,328.0,29.0,31.0,123.0,171.0,15.0,31.0,76.0,125.0,29.0,25.0,19.0,32.0,28.0,25.0,2.0,0.0,2.0,0.0,3.1,4.4,6.5,30.0,6045.0,29.0,4.1,5.1,5.5,30.0,29.0,128.0,145.0,29.0,-2.200000000000003,23.0,32.5,34.7,30.0,11.0,235.0,49.6,56.7,17.0,30.0,322.0,23.0,31.0,34.0,3.0,17.083333333333332,19.0,,,,,,,,,,,,,67.7,80.0,21.0,25.0,0.0,9.0,8.0,9.0,5.0,0.0,8.0,5.0,7.0,1.0,21.0,18.0,4.5,31.0,14.5,13.0,23.325,29.0,24.4,30.0,22.25,25.0,33.0,0.0,0.0,0.6363636363636364,25.0,21.50826446280992,25.0,23.0,26.0,18.0,3.8,4.9,2.5,25.5,5.0,2.0,28.0,3.0,17.5,HC,69.0,57.0,6.0,10.0,1.0,0.0,11.0,7.0,1612.0,1305.0,13.0,5.0,4.0,5.7,10.5,31.0,26.0,28.0,0.0,0.0,272.0,357.0,22.0,-85.0,25.0,25.5,474.0,568.0,21.0,30.0,0.5522703273495249,0.5382562277580071,26.0,21.0,1.618421052631579,21.0,18.0,3.8,3.9,17.0,18.0,22.0,19.5,23.0,0.7826086956521741,0.6470588235294118,18.0,3.0,0.5441253263707572,0.633650677407543,26.0,31.0,2084.0,3461.0,15.0,31.0,102.0,905.0,719.0,3.0,18.0,89.0,5.5,13.0,0.0871559633027523,0.0975609756097561,10.0,13.0,4.8,5.3,16.5,30.5,947.0,1124.0,30.0,29.0,108.0,1.0,0.0,16.0,26.0,59.0,30.0,4566.0,3008.0,7.0,2.0,73.0,7.0,1.0,0.0,0.0,9.5,22.5,250.0,490.0,28.0,27.0,1.09,1.57,19.0,30.5,29.0,28.5,61.4,69.1,8.0,29.0,2405.0,31.0,0.6178861788617886,11.0,0.4477296726504752,0.4617437722419929,6.0,11.0,0.21739130434782605,0.3529411764705882,14.0,29.0,0.4558746736292428,0.366349322592457,6.0,1.0,424.0,519.0,29.0,19.0,5.0,12.0,19.0,29.5,1746.0,2001.0,28.0,17.0,15.949494949494948,17.0,21.5,31.8,25.0,29.0,2.0,0.0,49.0,9.4,6.1,22.5,28.5,321.0,272.0,11.5,25.0,37.0,21.0,24.5,31.0,45.0,31.0,16.5,21.0,36.0,31.0,21.5,39.0,17.1,20.5,1.0,24.0,46.0,1.0,7.0,8.0,28.5,20.016528925619834,27.0,26240.0,31900.0,29.0,PHI,3830.0,5462.0,24.0,30.0,100.0,100.0,21.5,10.5,27.0,33.0,15.0,25.0,27.0,33.0,15.5,24.0,5.1,6.6,11.0,31.0,4.1,3.9,16.0,10.0,10.2,11.6,12.0,31.0,23.4,22.9,24.0,6.5,8.6,8.3,10.0,19.0,4.0,4.9,11.0,30.5,42.3,41.2,12.0,12.0,18.7,24.7,12.0,31.0,-1632.0,30.0,1.2439024390243902,1.6923076923076923,19.0,31.0
2000.0,189.0,195.0,22.5,20.0,295.0,295.0,15.0,17.0,182.0,159.0,11.0,13.0,88.0,105.0,20.0,22.5,25.0,31.0,25.0,18.0,2.0,0.0,1.0,1.0,4.6,3.9,4.5,21.0,6842.0,19.0,5.4,4.8,6.0,19.5,38.0,150.0,154.0,19.5,-1.1999999999999993,22.0,30.5,31.7,18.0,25.0,331.0,57.6,56.9,12.0,18.5,314.0,18.0,11.0,12.0,17.0,9.666666666666666,9.0,-54.16,-43.04,57.03,8.0,22.0,-0.92,57.25,9.0,4.0,125.05,5.0,17.0,87.9,84.8,22.5,7.5,1.0,6.0,15.0,10.0,1.0,1.0,6.0,14.0,7.0,1.0,14.0,12.0,19.0,22.0,11.833333333333336,9.0,15.5375,18.0,13.7,15.0,17.375,20.0,22.0,0.0,1.0,0.6363636363636364,27.0,13.791460055096412,11.0,15.7,17.0,15.0,2.6,3.4,15.5,8.0,2.0,0.0,19.0,11.5,11.5,HC,53.0,72.0,22.0,27.5,1.0,0.0,10.5,7.5,1237.0,1519.0,17.5,24.0,5.0,5.0,3.5,26.0,15.5,17.0,0.0,0.0,351.0,245.0,4.0,106.0,6.0,12.0,575.0,552.0,23.0,7.0,0.6096361848574238,0.5706161137440758,16.0,9.0,2.0681818181818183,12.0,21.0,3.7,2.0,1.0,15.5,11.0,2.5,13.0,0.6176470588235294,0.5238095238095238,29.0,15.5,0.6240511386336396,0.6203319502074689,25.0,20.0,3124.0,2990.0,7.0,20.0,113.0,980.0,936.0,26.0,27.0,111.0,26.0,24.0,0.0847457627118644,0.10508474576271186,5.0,16.0,5.6,5.6,20.5,10.5,1017.0,1055.0,26.0,15.0,86.0,0.0,0.0,16.0,10.0,47.0,27.0,3635.0,3515.0,18.5,11.0,87.0,21.5,10.5,1.0,1.0,24.0,8.0,335.0,375.0,20.0,18.0,1.72,1.18,4.0,10.5,33.0,24.5,75.9,66.6,7.0,17.0,3386.0,20.0,0.4835164835164835,20.0,0.3903638151425762,0.42938388625592416,16.0,23.0,0.38235294117647056,0.4761904761904762,3.0,16.5,0.3759488613663604,0.3796680497925311,7.0,12.0,397.0,453.0,21.5,24.0,13.0,10.0,10.5,18.0,1882.0,1830.0,20.0,15.0,10.015151515151516,2.0,33.3,25.1,6.0,9.0,0.0,0.0,45.0,7.3,8.3,7.5,17.0,262.0,291.0,5.0,21.0,50.0,6.0,22.0,33.0,33.0,23.0,11.5,29.0,28.0,23.5,4.5,29.0,13.8,14.9,14.0,15.0,31.0,12.5,2.0,13.5,16.5,11.882920110192835,4.0,28350.0,30030.0,20.0,PHI,5006.0,4820.0,10.5,17.0,94.4,100.0,19.5,30.0,36.0,21.0,4.0,13.0,34.0,21.0,4.0,13.0,5.9,5.9,2.0,27.5,4.7,4.0,12.5,4.5,10.2,10.4,3.0,29.0,23.3,21.1,7.5,7.0,10.2,8.0,10.0,11.0,4.9,4.6,4.5,17.0,42.3,40.4,6.5,12.0,26.5,24.6,10.5,15.0,186.0,17.0,1.25531914893617,1.475,26.0,30.0
2001.0,201.0,199.0,27.5,2.5,256.0,262.0,4.0,27.0,146.0,150.0,3.0,26.0,90.0,88.0,11.5,19.0,20.0,24.0,20.0,24.0,0.0,0.0,0.0,1.0,5.4,4.4,7.0,10.5,6908.0,19.0,6.4,5.4,9.5,11.0,38.0,138.0,152.0,30.0,2.699999999999996,9.0,32.3,29.6,6.0,11.5,300.0,57.5,55.7,5.0,20.5,288.0,7.0,22.5,24.0,10.5,7.333333333333332,4.0,-48.92,-6.48,86.44,4.0,16.0,-30.53,66.42,9.0,11.0,163.9,3.0,16.0,83.9,71.9,5.5,6.5,1.0,9.0,8.0,10.0,3.0,1.0,9.0,7.0,7.0,2.0,10.0,19.0,2.0,8.5,8.833333333333334,3.0,16.1125,19.0,13.6,13.0,18.625,21.0,20.0,2.0,1.0,0.5,21.0,10.770936639118457,6.0,11.4,9.0,14.0,2.7,2.7,23.0,7.5,2.0,0.0,14.0,23.5,8.5,HC,49.0,67.0,23.0,30.0,1.0,0.0,11.5,5.5,1165.0,1430.0,20.0,25.0,5.6,5.1,3.0,19.5,14.583333333333336,10.0,0.0,0.0,343.0,208.0,2.0,135.0,3.5,9.0,522.0,517.0,16.0,18.0,0.5770020533880903,0.5526057030481809,18.0,12.0,1.6222222222222222,21.0,27.0,5.2,2.5,4.0,4.0,13.0,2.5,5.5,0.8181818181818182,0.6842105263157895,11.0,1.0,0.6388381068454194,0.6092320782812167,25.0,22.0,3145.0,2864.0,2.0,20.0,100.0,768.0,741.0,9.0,16.0,85.0,7.5,21.0,0.078125,0.0916030534351145,9.0,19.0,5.0,5.3,9.5,28.5,974.0,1017.0,22.0,22.0,97.0,0.0,0.0,16.0,12.0,56.0,31.0,4221.0,4222.0,31.0,3.0,104.0,31.0,2.0,0.0,0.0,10.0,21.5,508.0,489.0,26.0,2.0,1.54,1.02,2.0,15.0,44.0,7.0,83.4,71.0,9.0,8.5,3427.0,19.0,0.6164383561643836,11.0,0.4229979466119097,0.4473942969518191,14.0,20.0,0.1818181818181817,0.3157894736842105,21.0,31.0,0.3611618931545806,0.3907679217187833,7.0,10.0,412.0,455.0,19.5,23.0,6.0,6.0,2.5,31.0,1778.0,1837.0,18.0,14.0,7.964646464646464,1.0,29.4,21.1,3.0,17.0,0.0,0.0,40.0,7.1,8.0,6.0,17.0,282.0,283.0,10.0,23.0,45.0,8.0,18.0,31.0,32.0,18.5,15.0,26.0,23.0,13.5,11.5,24.0,10.9,14.1,14.0,6.0,33.0,12.0,9.0,7.5,6.5,10.141873278236917,3.0,27738.0,30248.0,26.0,PHI,4923.0,4701.0,7.0,17.0,97.4,100.0,22.5,21.0,38.0,17.0,1.0,8.0,37.0,17.0,1.0,8.0,6.6,6.1,4.0,20.5,4.3,4.0,16.0,8.5,11.4,10.9,8.0,19.0,23.8,21.3,13.0,2.0,11.5,8.7,12.0,7.0,5.1,4.6,3.0,15.0,43.5,40.6,4.0,7.0,24.2,23.5,3.0,26.0,222.0,11.0,1.5348837209302326,1.525,27.0,26.0
2002.0,200.0,194.0,23.0,4.0,311.0,272.0,4.0,18.0,164.0,160.0,9.5,22.0,124.0,83.0,4.5,6.0,23.0,29.0,22.5,23.0,3.0,0.0,3.0,2.0,5.9,4.5,4.0,7.5,7767.0,9.0,6.7,5.6,6.5,7.0,46.0,150.0,143.0,23.0,6.8000000000000025,1.0,35.2,28.4,2.0,2.0,318.0,58.0,59.1,15.5,21.5,333.0,17.0,18.0,18.0,12.5,6.083333333333332,3.0,-2.03,2.94,90.22,2.0,22.0,0.74,76.18,1.0,8.0,171.25,2.0,18.0,88.2,81.0,21.0,3.0,0.0,9.0,16.0,7.0,2.0,0.0,9.0,14.0,6.0,1.0,13.0,23.0,1.0,17.0,6.25,2.0,10.8,6.0,11.6,14.0,10.0,9.0,28.0,1.0,1.0,0.4642857142857143,11.0,7.2214876033057855,1.0,4.6,2.0,11.0,2.0,2.7,21.0,5.0,2.0,0.0,15.0,20.5,6.0,HC,52.0,76.0,26.0,30.0,0.0,1.0,24.0,23.0,1297.0,1637.0,23.0,26.0,5.8,5.0,2.0,18.0,11.083333333333336,7.0,0.0,0.0,415.0,241.0,2.0,174.0,1.0,4.0,548.0,563.0,23.0,18.5,0.5442684063373718,0.6134786917740337,5.0,24.0,1.3225806451612905,29.0,27.0,4.9,3.2,6.0,5.5,18.0,7.5,5.0,0.6428571428571429,0.7826086956521741,2.0,14.5,0.6038543897216274,0.650820361800589,14.0,24.0,3384.0,3094.0,7.0,19.0,111.0,897.0,969.0,28.5,20.0,112.0,25.5,23.0,0.07395498392282958,0.10661764705882353,6.0,22.0,5.5,5.3,6.0,20.0,1073.0,1009.0,18.0,4.0,79.0,0.0,0.0,16.5,7.5,30.0,11.5,3197.0,3690.0,28.0,13.0,90.0,28.0,12.5,1.0,2.0,28.5,11.5,567.0,420.0,24.0,2.0,1.92,1.09,2.0,10.5,47.0,3.0,85.9,76.4,10.0,9.0,3606.0,18.0,0.7560975609756098,4.0,0.4557315936626282,0.3865213082259663,28.0,9.0,0.3571428571428571,0.21739130434782605,31.0,18.5,0.3961456102783726,0.34917963819941106,19.0,9.0,489.0,390.0,5.0,5.5,15.0,5.0,1.0,14.5,2220.0,1660.0,9.0,7.0,13.202020202020199,5.0,36.0,20.6,2.0,8.0,0.0,0.0,36.0,6.2,9.0,2.0,16.5,222.0,348.0,1.0,17.0,56.0,1.0,16.0,34.0,21.0,1.5,7.5,30.0,17.0,4.0,4.0,24.0,12.0,18.0,5.0,10.0,38.0,4.0,14.0,4.0,8.0,9.842975206611573,1.0,30000.0,27742.0,11.0,PHI,5604.0,4754.0,4.0,10.0,100.0,100.0,24.0,11.0,43.0,24.0,2.5,6.5,43.0,24.0,2.5,4.0,6.6,6.1,2.5,17.0,4.5,4.3,20.5,8.5,11.3,10.3,2.5,16.0,24.9,21.5,13.5,1.0,12.1,14.0,30.0,6.0,5.2,4.7,3.0,17.0,40.5,41.0,16.5,23.0,28.0,24.3,3.0,17.5,850.0,6.0,1.4666666666666666,1.4186046511627908,28.0,24.0
2003.0,187.0,187.0,12.5,20.5,302.0,306.0,21.0,13.5,156.0,171.0,18.5,18.5,105.0,116.0,22.0,12.0,41.0,19.0,4.0,1.0,1.0,0.0,0.0,1.0,5.4,5.0,14.0,14.0,7074.0,16.0,6.4,5.8,14.0,12.0,43.0,145.0,163.0,24.5,2.3000000000000007,4.0,32.5,30.2,5.0,8.0,279.0,57.6,60.3,21.0,19.5,337.0,31.0,25.0,8.0,23.5,16.5,18.0,10.98,-6.29,45.18,7.0,17.0,30.14,-10.59,29.0,3.0,54.0,12.0,11.0,82.8,73.3,6.0,12.0,0.0,9.0,7.0,10.0,3.0,0.0,9.0,7.0,6.0,2.0,11.0,13.0,9.5,15.0,16.083333333333332,16.5,12.4625,10.0,15.05,15.0,9.875,7.0,21.0,0.0,0.0,0.5238095238095238,26.0,13.726997245179064,13.0,13.6,13.0,11.0,2.3,2.3,29.0,5.0,1.0,1.0,13.0,26.5,4.0,HC,65.0,74.0,23.0,18.0,0.0,1.0,26.0,22.0,1387.0,1590.0,23.0,21.0,5.7,5.4,9.0,20.0,12.083333333333336,10.0,0.0,0.0,374.0,287.0,7.0,87.0,8.0,11.0,484.0,559.0,28.0,25.0,0.5582627118644068,0.5642722117202268,11.0,15.0,1.4857142857142858,19.0,17.0,3.5,3.0,4.0,21.0,17.0,7.0,22.5,0.425,0.5666666666666667,22.0,31.0,0.5998013902681232,0.6097606934237799,21.0,24.0,3020.0,3236.0,16.0,20.0,96.0,817.0,1105.0,32.0,12.0,129.0,29.0,9.0,0.1357615894039735,0.062091503267973865,29.0,1.0,5.2,5.8,28.5,28.0,944.0,1058.0,28.0,29.0,79.0,0.0,0.0,16.5,8.5,35.0,13.0,3207.0,3034.0,10.0,18.0,78.0,17.5,19.0,2.0,0.0,9.5,3.5,378.0,272.0,6.0,14.0,1.88,1.48,11.0,10.0,31.0,27.0,80.5,78.7,17.0,14.0,3273.0,18.5,0.6730769230769231,14.0,0.4417372881355932,0.4357277882797732,22.0,18.0,0.575,0.43333333333333335,11.0,2.0,0.4001986097318768,0.3902393065762201,12.0,9.0,417.0,461.0,21.5,25.5,23.0,13.0,18.0,2.0,2015.0,2071.0,22.0,9.0,12.686868686868687,3.0,34.2,27.8,9.0,10.0,1.0,0.0,43.0,8.2,6.4,18.0,30.0,253.0,248.0,8.5,23.0,38.0,10.0,26.5,29.0,30.0,15.5,17.0,24.0,22.0,14.0,12.0,22.0,10.2,13.4,17.0,3.5,26.0,18.5,4.0,8.0,5.5,13.853994490358126,11.0,27115.0,30481.0,28.0,PHI,5035.0,5307.0,20.0,18.0,100.0,96.4,4.0,8.5,42.0,28.0,7.0,8.0,42.0,27.0,6.0,8.0,6.8,6.2,9.5,13.0,4.8,4.5,23.5,4.5,11.7,10.3,3.0,7.5,21.3,21.5,21.0,17.0,12.2,7.8,8.0,5.5,5.3,5.0,15.0,10.5,40.6,38.9,4.0,20.0,26.9,28.1,21.0,16.0,-272.0,20.0,1.4166666666666667,1.3777777777777778,29.0,25.0
2004.0,192.0,183.0,11.5,12.5,301.0,299.0,13.0,14.0,188.0,165.0,11.5,10.0,87.0,101.0,17.0,23.0,26.0,33.0,26.0,17.5,2.0,0.0,0.0,1.0,7.1,4.6,4.5,4.5,7449.0,11.0,8.0,5.5,5.0,4.0,44.0,144.0,167.0,24.5,1.3000000000000007,7.5,31.1,29.8,9.0,15.5,336.0,61.4,60.7,19.0,10.0,334.0,27.0,8.0,12.0,23.0,11.166666666666664,9.0,69.55,106.56,11.07,10.0,7.0,-23.88,19.44,19.0,14.0,46.14,12.0,8.0,84.4,70.8,4.0,11.0,0.0,4.0,7.0,18.0,3.0,0.0,4.0,6.0,15.0,2.0,11.0,11.0,20.0,16.5,12.666666666666664,7.0,13.51875,11.0,5.6,3.0,21.4375,23.0,17.0,0.0,0.0,0.6470588235294118,32.0,11.659504132231405,6.0,11.6,8.0,11.0,2.0,3.1,20.0,3.0,2.0,1.0,17.0,15.5,4.5,HC,56.0,73.0,21.0,28.5,0.0,0.0,9.0,22.0,1214.0,1693.0,26.0,28.0,6.8,5.4,3.5,9.5,9.5,8.5,0.0,0.0,386.0,260.0,2.5,126.0,4.0,8.0,547.0,550.0,29.0,9.0,0.6083333333333333,0.5745909528392685,7.0,4.0,2.160919540229885,9.0,32.0,5.9,2.9,2.5,6.0,16.0,3.0,4.0,0.7619047619047619,0.5517241379310345,27.0,5.0,0.7082591669633321,0.6279569892473118,23.0,5.0,3979.0,3212.0,12.0,7.0,124.0,952.0,1001.0,27.0,22.0,119.0,24.5,28.0,0.08637873754152824,0.11036789297658862,8.0,18.0,5.2,5.8,27.5,26.0,960.0,1039.0,26.0,27.0,73.0,0.0,0.0,16.5,12.0,34.0,13.5,3068.0,3782.0,27.0,21.0,89.0,25.5,22.0,0.0,0.0,12.0,20.5,377.0,221.0,5.5,12.0,1.95,1.39,7.5,7.0,41.0,11.5,96.4,75.8,8.0,4.0,4208.0,6.0,0.4627659574468085,24.0,0.3916666666666667,0.42540904716073147,26.0,29.0,0.2380952380952381,0.4482758620689655,6.0,28.0,0.2917408330366679,0.3720430107526882,10.0,28.0,376.0,442.0,16.0,31.0,10.0,13.0,18.0,22.0,1639.0,1903.0,16.0,24.0,15.414141414141412,13.5,35.9,25.1,4.0,8.0,0.0,0.0,37.0,6.3,7.9,4.5,12.0,229.0,263.0,9.0,16.0,47.0,2.0,16.5,32.0,24.0,7.0,4.5,27.0,17.0,6.0,5.5,22.0,10.9,13.1,21.0,5.5,28.0,18.5,6.0,11.5,7.5,11.71900826446281,5.0,27648.0,30561.0,26.0,PHI,5618.0,5115.0,10.0,9.0,97.6,100.0,21.5,26.0,42.0,27.0,4.5,8.5,41.0,27.0,5.0,9.5,7.7,6.3,3.0,8.5,4.4,4.3,19.5,9.0,12.5,10.4,1.0,6.5,21.7,23.2,26.5,15.0,9.2,6.5,5.5,13.0,5.9,4.9,7.0,5.5,42.0,42.5,23.5,16.5,29.2,28.0,14.5,10.5,503.0,9.0,1.75,1.4651162790697674,31.0,16.5
2005.0,218.0,209.0,32.0,1.0,282.0,290.0,13.0,21.0,182.0,171.0,18.0,12.0,73.0,91.0,16.5,28.0,27.0,28.0,14.5,17.0,2.0,0.0,1.0,0.0,4.8,5.7,22.5,22.5,7451.0,10.0,5.5,6.4,21.5,23.0,35.0,126.0,147.0,32.0,-1.6000000000000014,20.0,30.4,32.0,22.0,21.0,337.0,54.4,59.0,16.0,27.0,297.0,14.0,9.0,18.0,13.0,19.08333333333333,21.0,-129.46,-60.11,-31.82,19.0,29.0,-48.79,66.1,4.0,18.0,47.06,14.0,30.0,75.9,81.5,21.0,25.0,0.0,6.0,9.0,12.0,2.0,0.0,6.0,8.0,7.0,1.0,14.0,10.0,24.5,23.0,19.33333333333333,24.0,18.78125,20.0,13.5,16.0,24.0625,27.0,34.0,1.0,2.0,0.4117647058823529,10.0,20.93732782369146,24.0,23.5,26.0,20.0,3.2,3.4,10.5,19.5,1.0,4.0,17.0,11.5,26.0,HC,71.0,67.0,20.0,11.0,0.0,1.0,27.0,21.5,1578.0,1416.0,16.5,11.0,5.6,6.2,24.0,21.0,20.33333333333333,21.0,1.0,0.0,310.0,388.0,27.0,-78.0,24.0,18.0,620.0,503.0,13.5,3.0,0.6445959104186952,0.5125240847784199,26.0,2.0,2.4931506849315066,5.0,21.0,3.4,4.8,26.5,21.0,24.0,26.5,14.0,0.65625,0.6153846153846154,15.0,8.5,0.7197103151301625,0.6383019592777565,19.0,6.0,3677.0,3323.0,21.0,8.0,134.0,1130.0,910.0,15.0,29.5,112.0,14.0,27.0,0.09574468085106384,0.09655172413793103,18.0,14.0,4.8,5.1,3.0,31.0,1027.0,1038.0,27.0,10.0,100.0,1.0,0.0,16.5,28.0,57.0,31.0,4113.0,4358.0,32.0,2.0,104.0,32.0,2.0,0.0,0.0,12.5,20.5,448.0,310.0,18.0,4.0,1.33,1.62,15.5,25.0,53.0,1.5,71.5,82.2,20.0,25.0,3903.0,8.0,0.4010989010989011,28.0,0.3554040895813048,0.4874759152215801,7.0,31.0,0.34375,0.3846153846153846,18.0,24.5,0.2802896848698375,0.3616980407222435,14.0,27.0,365.0,506.0,28.5,30.0,11.0,15.0,21.0,19.0,1432.0,1883.0,21.0,28.0,14.818181818181818,8.0,24.8,29.2,13.0,29.0,0.0,0.0,42.0,6.3,5.5,27.0,16.5,226.0,184.0,28.0,16.0,29.0,26.5,21.5,29.0,27.0,8.5,19.0,22.0,22.0,12.5,22.5,34.0,14.7,11.5,24.0,22.0,27.0,19.0,-7.0,23.5,25.5,18.374655647382927,20.0,27468.0,30723.0,27.0,PHI,5109.0,5206.0,23.0,19.0,97.0,100.0,22.5,27.0,33.0,46.0,29.0,16.5,32.0,46.0,29.0,17.5,6.3,7.0,23.0,24.5,3.9,3.7,8.5,17.5,11.6,11.8,25.5,16.0,22.2,21.1,9.0,14.5,8.5,5.4,4.0,12.0,5.0,5.0,14.0,17.5,41.1,41.9,15.0,25.0,23.3,24.8,8.0,28.0,-97.0,23.0,1.6153846153846154,1.8918918918918919,4.0,23.0
2006.0,183.0,186.0,14.0,23.5,312.0,314.0,25.5,9.5,189.0,154.0,7.0,8.0,106.0,126.0,31.0,11.0,17.0,34.0,32.0,29.5,1.0,0.0,1.0,0.0,7.6,4.5,6.0,2.0,7915.0,2.0,8.3,5.4,6.0,1.5,49.0,152.0,164.0,18.0,0.8000000000000007,14.5,30.0,29.2,7.0,19.0,323.0,59.4,58.9,12.5,19.0,309.0,17.0,13.0,30.0,4.5,16.333333333333332,15.0,83.65,83.24,33.22,5.0,8.0,17.96,-8.61,27.0,4.0,41.88,13.0,4.0,78.3,92.9,30.0,19.0,0.0,10.0,5.0,8.0,0.0,0.0,9.0,3.0,6.0,0.0,15.0,10.0,22.5,26.5,13.25,9.0,9.63125,4.0,3.95,3.0,15.3125,17.0,26.0,1.0,4.0,0.5769230769230769,26.0,13.037052341597796,8.0,12.3,9.0,9.0,1.7,3.6,10.0,3.0,4.0,2.0,19.0,8.5,3.0,HC,58.0,71.0,25.5,25.0,0.0,0.0,13.0,20.0,1204.0,1647.0,28.0,27.0,7.2,5.4,4.0,3.0,5.833333333333332,3.0,0.0,0.0,398.0,328.0,15.5,70.0,8.0,6.0,544.0,525.0,23.0,8.0,0.5789473684210527,0.5360531309297912,24.0,9.0,1.7830188679245282,15.0,31.0,5.7,3.2,7.0,1.0,17.0,7.5,1.5,0.7045454545454546,0.5862068965517241,17.0,3.0,0.6749139767327543,0.5843017717660507,27.0,10.0,4119.0,3067.0,9.0,3.0,112.0,983.0,795.0,18.0,32.0,96.0,18.5,27.5,0.05448717948717949,0.10828025477707008,4.0,31.0,5.5,5.8,27.0,17.0,988.0,1054.0,30.0,22.0,78.0,0.0,0.0,16.5,11.5,41.0,22.0,3326.0,3567.0,20.0,18.0,82.0,21.0,15.0,0.0,1.0,25.0,22.0,339.0,380.0,24.0,17.0,1.98,1.55,11.5,5.5,36.0,18.5,96.7,73.6,6.0,2.0,4309.0,4.0,0.5608465608465608,18.0,0.42105263157894735,0.4639468690702088,9.0,24.0,0.2954545454545454,0.4137931034482759,16.0,30.0,0.3250860232672457,0.4156982282339493,6.0,23.0,416.0,489.0,25.0,27.0,13.0,12.0,12.5,15.5,1984.0,2182.0,26.0,11.0,20.949494949494948,30.0,33.9,30.1,13.0,10.0,0.0,0.0,28.0,4.9,7.1,11.0,8.0,190.0,300.0,4.0,11.5,40.0,9.0,8.5,23.0,28.0,14.0,31.0,18.0,26.0,22.5,30.5,24.0,11.5,15.1,11.5,7.5,29.0,13.5,5.0,9.0,9.5,13.77410468319559,8.0,27816.0,30504.0,25.0,PHI,6103.0,5249.0,15.0,2.0,100.0,100.0,20.5,11.5,48.0,34.0,13.5,3.5,48.0,34.0,14.0,3.0,7.9,6.4,4.0,3.5,4.8,4.5,24.5,5.0,13.3,10.9,5.5,1.0,20.8,23.2,23.0,28.0,9.4,9.3,21.0,10.0,6.2,5.0,10.5,1.0,42.6,43.5,16.5,23.0,33.2,28.2,16.0,2.0,854.0,5.0,1.6458333333333337,1.4222222222222225,28.0,18.0
2007.0,182.0,187.0,18.0,20.5,323.0,279.0,8.0,5.5,186.0,177.0,15.0,15.0,118.0,80.0,7.0,6.5,19.0,22.0,19.0,20.5,2.0,0.0,0.0,0.0,5.7,5.7,16.0,16.0,7858.0,4.0,6.6,6.5,17.5,10.5,38.0,163.0,149.0,7.5,-2.8000000000000007,26.0,29.2,32.0,24.0,25.0,350.0,60.7,57.9,3.0,17.0,312.0,11.0,9.0,12.0,24.0,13.083333333333336,13.0,49.64,36.73,-29.98,17.0,13.0,20.15,40.76,12.0,3.0,26.05,16.0,8.0,75.0,81.6,12.0,27.5,0.0,12.0,10.0,6.0,4.0,0.0,12.0,10.0,1.0,1.0,12.0,8.0,28.5,16.0,16.25,16.0,11.11875,6.0,10.55,9.5,11.6875,11.0,24.0,2.0,2.0,0.5,20.0,14.755371900826447,13.0,15.8,13.5,15.0,2.6,2.0,31.5,8.5,0.0,1.0,11.0,31.0,12.5,HC,71.0,69.0,21.0,12.5,0.0,0.0,7.0,24.5,1539.0,1536.0,19.0,14.0,6.0,6.0,13.0,17.5,10.166666666666666,7.0,0.0,0.0,336.0,300.0,9.0,36.0,11.0,17.0,577.0,539.0,17.0,7.0,0.5978987583572111,0.5883554647599591,11.0,10.0,1.5762711864406782,24.0,24.0,4.2,3.0,2.0,14.5,16.0,2.5,12.5,0.6666666666666666,0.6153846153846154,22.5,17.0,0.6554372490836097,0.6922922521075873,7.0,17.0,3755.0,3449.0,18.0,10.0,83.0,649.0,616.0,6.0,10.0,81.0,5.5,12.0,0.05882352941176471,0.07885304659498207,7.0,22.5,5.9,5.4,8.0,7.0,1047.0,979.0,9.0,5.0,73.0,0.0,0.0,16.5,11.5,36.0,17.5,3066.0,3162.0,16.0,18.0,76.0,19.5,17.0,0.0,1.0,24.0,22.5,340.0,409.0,28.0,10.0,1.86,1.47,7.0,12.0,42.0,8.0,84.6,80.3,13.0,13.0,4005.0,10.0,0.6344086021505376,9.0,0.4021012416427889,0.4116445352400409,22.0,23.0,0.33333333333333337,0.3846153846153846,10.5,16.0,0.3445627509163903,0.30770774789241273,26.0,16.0,421.0,403.0,8.0,20.0,12.0,10.0,10.0,16.5,1974.0,1533.0,7.0,8.0,19.272727272727273,25.0,34.1,30.5,14.0,10.0,0.0,0.0,49.0,7.8,6.4,11.5,24.5,250.0,244.0,10.5,21.0,37.0,10.5,28.0,32.0,38.0,29.0,12.5,24.0,31.0,27.5,18.0,27.0,13.2,10.2,32.0,12.0,19.0,32.0,-8.0,25.0,13.0,13.710743801652892,10.0,29666.0,27863.0,10.0,PHI,5729.0,4982.0,10.0,6.0,100.0,93.1,1.0,12.0,36.0,29.0,3.5,16.5,36.0,27.0,2.0,16.0,6.9,6.9,14.5,15.5,4.7,3.8,6.5,2.0,11.4,11.8,23.5,12.5,21.7,22.3,13.0,24.0,8.1,11.4,28.0,24.0,5.5,5.1,14.5,10.5,42.0,41.6,6.0,19.5,31.5,26.6,11.0,6.0,747.0,7.0,1.4680851063829787,1.8157894736842104,6.0,28.0
2008.0,200.0,198.0,31.0,2.0,318.0,248.0,3.0,8.0,204.0,144.0,2.0,6.0,94.0,79.0,6.0,22.0,20.0,25.0,25.0,16.5,0.0,0.0,0.0,2.0,5.8,4.6,4.0,14.5,7776.0,6.0,6.3,5.6,7.0,19.5,45.0,151.0,143.0,24.0,0.09999999999999787,19.0,31.2,31.1,21.5,11.0,362.0,59.7,54.1,2.0,21.0,284.0,5.0,6.0,32.0,4.0,4.416666666666667,3.0,24.99,59.11,98.48,3.0,12.0,-29.13,61.42,4.0,23.0,169.75,3.0,14.0,82.5,85.7,15.0,22.0,2.0,11.0,12.0,10.0,5.0,2.0,11.0,10.0,8.0,2.0,10.0,14.0,6.0,15.0,5.916666666666668,1.0,14.35,14.0,9.7,9.0,19.0,21.0,16.0,3.0,0.0,0.625,29.0,9.80550964187328,4.0,9.6,5.0,16.0,2.6,2.9,13.5,13.5,2.0,2.0,15.0,12.5,21.5,HC,60.0,75.0,26.5,23.5,1.0,1.0,26.0,7.0,1411.0,1698.0,25.0,19.0,6.2,5.1,2.5,12.0,12.666666666666664,11.5,0.0,2.0,416.0,289.0,4.0,127.0,4.0,6.0,606.0,525.0,19.0,4.0,0.5956439393939394,0.5764587525150905,13.0,7.0,2.1702127659574466,4.0,23.0,3.8,3.6,12.5,17.0,19.0,11.5,9.0,0.6052631578947368,0.7307692307692307,5.0,14.0,0.6973965763195435,0.6637047163362952,14.0,6.0,3911.0,2913.0,3.0,6.0,74.0,635.0,598.0,4.0,9.0,81.0,9.0,4.0,0.06289308176100629,0.10080645161290322,4.0,21.0,5.5,5.2,4.0,20.5,1056.0,994.0,17.0,3.0,78.0,1.0,0.0,16.5,26.5,41.0,25.5,3377.0,4292.0,32.0,14.0,101.0,32.0,12.0,1.0,0.0,11.5,7.5,446.0,296.0,17.0,4.0,1.83,1.28,4.0,14.5,52.0,1.0,81.4,72.9,5.0,20.0,4060.0,6.0,0.4607843137254902,29.0,0.40435606060606055,0.4235412474849095,20.0,26.0,0.3947368421052632,0.2692307692307693,28.0,19.0,0.30260342368045645,0.3362952836637048,19.0,27.0,427.0,421.0,13.0,17.0,15.0,7.0,2.5,15.5,1697.0,1476.0,4.0,22.0,13.929292929292927,12.0,35.5,25.3,4.0,13.0,1.0,1.0,23.0,3.7,8.4,3.0,5.0,149.0,312.0,3.0,8.0,48.0,3.0,7.0,40.0,28.0,10.0,1.5,33.0,24.0,12.0,3.0,26.0,11.5,13.6,13.0,12.5,29.0,10.0,3.0,14.0,18.0,10.011019283746558,2.0,30200.0,28314.0,10.0,PHI,5608.0,4389.0,3.0,9.0,100.0,100.0,19.0,13.5,45.0,29.0,6.0,5.0,45.0,29.0,6.0,5.0,6.7,6.1,4.0,20.0,4.0,3.5,4.0,23.0,11.2,11.4,15.0,19.0,23.5,22.6,15.0,11.0,8.6,7.2,8.0,19.0,5.3,4.4,2.0,14.5,43.3,42.5,6.0,21.5,28.0,22.1,3.0,18.0,1219.0,1.0,1.675,1.7428571428571429,9.0,14.0
2009.0,192.0,197.0,30.0,11.0,290.0,295.0,14.0,19.0,182.0,179.0,16.0,18.0,87.0,81.0,8.5,20.0,21.0,35.0,31.0,20.0,2.0,0.0,2.0,1.0,6.8,4.6,5.0,11.0,7740.0,9.0,7.8,5.5,7.5,7.5,47.0,141.0,155.0,29.0,-1.099999999999998,23.0,30.6,31.7,28.0,8.5,335.0,60.6,61.0,17.5,18.0,354.0,28.0,16.0,28.0,2.0,10.75,9.0,44.15,56.49,-10.07,11.0,13.0,-2.51,42.07,9.0,8.0,46.71,8.0,13.0,86.5,87.5,29.0,10.0,1.0,11.0,9.0,13.0,3.0,1.0,11.0,8.0,11.0,1.0,10.0,13.0,9.0,13.5,9.166666666666666,2.0,14.475,15.0,10.2,11.0,18.75,19.0,23.0,2.0,0.0,0.43478260869565216,12.0,13.615289256198347,11.0,14.9,13.0,13.0,2.4,4.3,5.0,9.0,2.0,1.0,25.0,4.0,9.0,HC,58.0,81.0,30.0,20.0,0.0,0.0,10.0,23.5,1191.0,1907.0,30.0,28.0,6.9,5.5,4.5,10.5,11.0,9.5,0.0,0.0,429.0,337.0,19.0,92.0,10.0,5.0,553.0,580.0,28.5,11.0,0.6061538461538462,0.6017357762777242,7.0,5.0,2.0919540229885056,10.0,27.0,4.9,4.7,20.0,8.5,27.0,24.5,11.0,0.6585365853658537,0.7105263157894737,7.0,14.0,0.7141110723017814,0.6739342028421258,12.0,5.0,4089.0,3462.0,17.0,10.0,115.0,951.0,789.0,19.0,30.0,104.0,23.5,29.0,0.07241379310344828,0.11864406779661014,3.0,20.0,5.3,5.4,7.5,24.5,975.0,1037.0,23.0,24.0,76.0,0.0,0.0,16.5,13.5,39.0,19.5,3222.0,3600.0,24.0,17.0,80.0,24.0,15.5,2.0,0.0,11.5,1.5,471.0,229.0,6.0,2.0,1.99,1.67,17.0,9.5,35.0,19.0,92.0,77.6,11.0,11.0,4380.0,10.0,0.4780219780219781,23.0,0.39384615384615385,0.39826422372227577,26.0,28.0,0.3414634146341463,0.2894736842105263,26.0,19.0,0.2858889276982186,0.3260657971578742,21.0,28.0,384.0,413.0,10.0,28.0,14.0,11.0,12.0,16.0,1637.0,1675.0,9.0,22.0,16.21212121212121,16.0,38.0,29.9,13.0,6.0,2.0,0.0,38.0,6.4,7.1,7.5,19.0,291.0,316.0,2.0,27.0,44.0,4.0,21.0,37.0,24.0,7.0,1.0,32.0,21.0,11.0,1.5,23.0,10.4,17.3,4.0,6.0,38.0,3.0,15.0,2.0,8.0,12.330578512396693,8.0,27072.0,30535.0,28.5,PHI,5726.0,5137.0,12.0,11.0,95.6,100.0,23.0,30.0,45.0,38.0,19.5,9.5,43.0,38.0,20.5,10.5,7.9,6.5,7.0,8.0,4.3,4.1,12.0,12.5,13.1,10.7,5.5,2.0,20.5,23.5,21.0,29.5,13.5,5.9,3.0,1.0,5.9,5.0,7.0,5.5,42.4,45.0,27.5,24.0,29.8,26.0,7.0,15.0,589.0,11.0,1.8372093023255816,1.5853658536585369,22.0,10.0
2010.0,196.0,194.0,23.0,9.0,322.0,309.0,18.5,10.0,189.0,185.0,18.0,14.5,116.0,91.0,15.5,6.0,17.0,33.0,27.5,29.5,2.0,0.0,1.0,1.0,6.4,5.3,8.0,9.0,8265.0,2.0,7.5,6.2,10.5,7.0,49.0,153.0,142.0,19.0,3.9000000000000017,3.5,31.6,27.7,4.0,4.0,348.0,62.0,57.6,8.0,12.5,309.0,11.5,12.0,12.0,21.5,14.166666666666664,12.0,93.21,45.25,-66.83,25.0,16.0,59.56,36.38,11.0,1.0,-27.95,22.0,7.0,84.2,85.7,23.0,12.0,0.0,12.0,12.0,11.0,3.0,0.0,12.0,10.0,9.0,1.0,12.0,11.0,14.5,22.0,14.333333333333336,9.0,8.35625,3.0,8.65,7.0,8.0625,7.0,33.0,1.0,2.0,0.3636363636363637,3.5,9.664187327823688,4.0,7.4,5.0,13.0,2.3,4.3,2.0,9.0,1.0,1.0,23.0,3.0,10.0,HC,62.0,69.0,22.0,17.5,0.0,0.0,7.0,24.5,1272.0,1502.0,21.0,22.0,6.4,6.0,13.5,11.5,6.75,3.0,0.0,0.0,439.0,377.0,21.5,62.0,9.0,3.0,561.0,536.0,18.0,11.5,0.5876685934489403,0.5761523046092184,15.0,11.0,1.6293103448275863,26.0,28.0,5.0,5.8,28.0,11.0,31.0,29.5,8.5,0.6086956521739131,0.7209302325581395,10.0,23.0,0.6269662921348315,0.6626552053486151,19.0,25.0,3906.0,3469.0,14.5,9.0,129.0,1101.0,724.0,9.0,31.0,87.0,10.0,30.0,0.052795031055900624,0.10679611650485436,5.0,31.0,5.5,5.3,6.5,18.0,1038.0,998.0,15.0,12.0,73.0,0.0,0.0,16.5,12.5,34.0,16.5,3197.0,3600.0,23.0,20.0,82.0,21.5,22.5,1.0,0.0,10.5,6.0,404.0,309.0,17.0,8.0,2.13,1.83,22.0,5.0,38.0,14.0,92.1,80.8,11.0,7.0,4215.0,8.0,0.6137566137566137,7.0,0.4123314065510597,0.4238476953907816,18.0,22.0,0.3913043478260869,0.2790697674418605,23.0,10.0,0.3730337078651685,0.3373447946513849,14.0,8.0,428.0,423.0,17.0,16.5,18.0,12.0,16.5,4.5,2324.0,1766.0,15.0,5.0,15.848484848484848,15.0,39.8,31.4,15.0,4.0,0.0,0.0,49.0,8.0,6.8,10.0,26.0,309.0,292.0,4.5,28.0,39.0,11.0,29.0,38.0,21.0,3.5,5.0,32.0,18.0,5.0,3.0,25.0,11.7,17.0,5.0,12.5,34.0,5.0,9.0,6.5,13.0,11.928374655647385,5.0,29988.0,27548.0,13.0,PHI,6230.0,5235.0,12.0,2.0,100.0,100.0,21.0,12.5,47.0,45.0,26.0,4.5,47.0,45.0,26.5,4.5,7.5,7.0,18.0,6.0,5.4,4.2,14.5,1.0,12.1,12.2,25.0,10.0,20.5,21.8,12.5,25.0,10.6,9.1,17.0,12.0,6.0,5.2,14.5,2.5,43.8,43.9,22.0,13.5,31.8,26.9,7.5,6.5,995.0,5.0,1.3888888888888888,1.6666666666666663,16.0,30.0
2011.0,190.0,195.0,23.0,15.0,356.0,289.0,8.0,4.0,197.0,173.0,9.0,11.0,134.0,84.0,9.0,2.0,25.0,32.0,25.5,22.0,0.0,0.0,0.0,1.0,5.8,5.7,11.5,15.0,7721.0,7.0,6.5,6.9,19.5,16.5,46.0,158.0,141.0,10.5,0.09999999999999787,16.0,28.7,28.6,18.0,14.5,330.0,59.6,58.1,10.0,19.0,301.0,9.5,14.0,26.0,7.5,12.333333333333336,10.0,63.46,43.86,-16.49,10.0,15.0,31.28,35.12,10.0,4.0,20.35,10.0,11.0,88.9,66.7,1.0,5.0,0.0,10.0,11.0,4.0,2.0,0.0,10.0,9.0,4.0,1.0,13.0,9.0,21.0,27.0,12.166666666666664,8.0,10.65,5.0,14.05,13.0,7.25,4.0,23.0,3.0,0.0,0.5652173913043478,25.0,13.24173553719008,12.0,13.5,13.0,25.0,4.5,2.9,17.0,32.0,1.0,2.0,15.0,18.0,31.5,HC,39.0,51.0,23.0,22.0,0.0,0.0,12.0,21.0,815.0,1178.0,22.0,28.0,7.0,6.0,10.0,8.0,9.666666666666666,8.0,0.0,0.0,396.0,328.0,10.0,68.0,9.0,8.0,554.0,518.0,12.0,13.0,0.5656370656370656,0.5784114052953157,16.0,19.0,1.4701492537313432,27.0,22.0,4.0,5.2,26.5,15.0,27.0,24.0,11.5,0.5238095238095238,0.7105263157894737,8.0,30.0,0.6435953648606326,0.6535205848403232,17.0,20.0,4110.0,3397.0,10.0,9.0,107.0,853.0,813.0,10.0,18.0,97.0,10.5,22.0,0.0702247191011236,0.11072664359861592,7.0,28.0,5.6,5.2,3.5,13.0,1036.0,982.0,9.0,7.5,67.0,1.0,0.0,16.5,28.0,31.0,8.5,2830.0,0.0,16.5,26.0,85.0,22.5,24.5,0.0,0.0,9.5,24.0,212.0,176.0,3.0,28.0,1.93,1.61,12.5,9.5,30.0,25.5,78.3,85.7,19.0,19.0,4276.0,10.0,0.6802030456852792,6.0,0.4343629343629344,0.4215885947046844,17.0,14.0,0.4761904761904762,0.2894736842105263,25.0,3.0,0.3564046351393674,0.34647941515967684,16.0,13.0,450.0,414.0,12.0,12.0,20.0,11.0,16.0,2.0,2276.0,1801.0,16.0,5.0,18.272727272727273,24.0,34.7,27.7,4.0,12.5,1.0,0.0,32.0,5.5,8.8,1.0,12.0,166.0,316.0,3.0,4.0,50.0,1.5,10.0,27.0,24.0,2.0,26.5,24.0,16.0,1.0,19.0,38.0,17.9,12.3,20.5,30.0,24.0,18.0,-14.0,30.5,31.0,12.983471074380164,5.0,30020.0,27495.0,8.0,PHI,6386.0,5198.0,8.0,4.0,100.0,100.0,20.0,13.0,46.0,38.0,19.5,5.0,46.0,38.0,20.0,5.0,7.7,7.2,17.0,11.0,5.1,4.4,20.0,3.0,13.0,12.3,22.5,6.0,20.9,23.1,13.5,31.0,7.1,5.7,3.0,27.5,6.2,5.3,12.0,4.5,42.2,0.0,16.5,29.0,33.7,26.6,8.0,7.0,1188.0,4.0,1.5098039215686276,1.6363636363636362,23.0,25.0
2012.0,184.0,182.0,10.0,21.0,332.0,317.0,17.0,11.0,190.0,178.0,7.5,12.0,111.0,108.0,28.0,10.0,31.0,31.0,20.0,11.0,3.0,0.0,0.0,0.0,5.2,7.3,30.5,24.0,7463.0,11.0,6.1,8.2,31.0,25.0,29.0,155.0,161.0,19.0,-6.1999999999999975,32.0,25.6,31.8,32.0,26.0,367.0,59.4,60.2,14.0,21.0,292.0,4.0,9.0,0.0,31.5,21.75,24.5,-50.97,-0.36,-122.32,30.0,26.0,-50.24,25.8,15.0,27.0,-87.34,25.0,26.0,87.1,93.1,28.0,13.0,0.0,9.0,9.0,12.0,1.0,0.0,8.0,8.0,11.0,0.0,22.0,5.0,29.0,32.0,24.58333333333333,30.0,16.3375,19.0,15.05,18.0,17.625,17.0,37.0,0.0,4.0,0.5945945945945946,28.0,22.966253443526174,29.0,25.5,29.0,15.0,2.4,1.6,29.5,11.0,0.0,3.0,8.0,30.0,16.0,HC,60.0,41.0,15.0,3.5,0.0,0.0,11.5,22.5,1259.0,1012.0,16.0,7.0,5.7,6.7,22.0,25.0,20.0,20.0,0.0,0.0,280.0,444.0,29.5,-164.0,30.0,29.0,618.0,485.0,2.0,7.0,0.6172381835032438,0.5181086519114688,28.0,8.0,1.7117117117117118,21.0,18.0,2.9,6.8,32.0,27.0,33.0,32.0,25.5,0.6428571428571429,0.75,4.0,16.0,0.6691968225948809,0.6319431797486796,27.0,19.0,3791.0,3470.0,9.0,13.0,98.0,813.0,996.0,28.0,10.0,118.0,27.0,10.5,0.0933734939759036,0.09779179810725552,14.0,13.0,6.0,5.6,12.0,6.0,1079.0,994.0,6.0,6.0,72.0,1.0,0.0,16.5,22.5,40.0,23.5,3336.0,0.0,16.5,20.0,78.0,17.5,22.5,1.0,1.0,23.5,9.0,310.0,542.0,32.0,21.0,1.51,2.14,28.0,24.0,30.0,25.0,78.6,99.6,31.0,24.0,4075.0,11.0,0.5842105263157895,12.0,0.3827618164967562,0.4818913480885312,5.0,25.0,0.3571428571428571,0.25,29.0,17.0,0.3308031774051191,0.3680568202513204,6.0,14.0,413.0,479.0,26.0,19.0,10.0,11.0,13.5,22.5,1874.0,2021.0,23.0,13.0,19.252525252525253,27.0,29.9,39.0,27.0,24.0,0.0,0.0,48.0,7.2,5.8,22.5,22.0,284.0,198.0,22.0,26.0,30.0,26.0,28.0,31.0,29.0,11.0,19.5,27.0,27.0,17.5,16.5,37.0,17.9,6.6,31.0,31.0,13.0,31.5,-24.0,31.5,31.0,20.43250688705234,28.0,28520.0,29302.0,22.0,PHI,5665.0,5491.0,15.0,15.0,96.2,98.1,5.0,30.0,26.0,52.0,30.5,27.5,25.0,51.0,30.0,29.0,6.6,7.6,26.5,25.5,4.5,4.2,15.5,9.0,11.1,12.6,28.0,27.5,21.0,24.7,21.5,27.0,10.3,13.6,31.0,12.5,5.3,5.5,19.5,19.0,46.3,0.0,16.5,15.5,30.4,30.0,16.5,14.0,174.0,12.0,1.4666666666666666,1.8095238095238089,4.0,28.5
2013.0,197.0,204.0,29.0,11.0,323.0,303.0,10.5,14.0,179.0,189.0,11.0,20.0,110.0,88.0,11.5,8.5,34.0,26.0,10.5,12.0,0.0,0.0,0.0,0.0,5.9,5.5,11.0,15.0,7637.0,7.0,6.7,6.5,11.5,16.0,52.0,151.0,139.0,16.5,10.2,1.0,33.4,23.2,1.0,1.0,333.0,61.0,56.4,2.0,14.5,334.0,10.0,20.0,42.0,1.5,13.75,10.0,34.02,53.99,-0.96,9.0,18.0,-9.9,18.77,19.0,10.0,35.7,8.0,14.0,78.6,78.6,5.0,28.0,0.0,6.0,10.0,8.0,4.0,0.0,6.0,9.0,6.0,1.0,10.0,15.0,1.5,20.0,6.916666666666668,3.0,12.5625,9.0,15.25,17.0,9.875,9.0,21.0,0.0,0.0,0.4761904761904762,15.5,10.610468319559226,5.0,8.4,5.0,8.0,1.5,3.5,6.0,1.5,5.0,0.0,21.0,3.5,1.5,HC,44.0,43.0,19.5,9.5,2.0,0.0,12.5,1.5,1316.0,1048.0,19.5,3.0,5.7,6.2,15.5,23.5,12.0,10.0,2.0,0.0,430.0,305.0,5.5,125.0,5.0,6.5,546.0,592.0,24.0,20.5,0.5704567541302236,0.598875351452671,11.0,21.0,1.6272727272727272,26.0,24.0,4.4,4.2,14.5,13.5,25.0,16.0,16.5,0.5853658536585366,0.7352941176470589,9.0,25.0,0.6189770200148258,0.6732370433305013,17.0,26.0,3340.0,3962.0,25.5,24.5,101.0,774.0,852.0,17.0,10.0,112.0,30.0,17.5,0.10526315789473684,0.0858085808580858,19.0,10.0,5.4,5.4,9.0,23.0,1029.0,1067.0,22.0,16.0,89.0,1.0,0.0,16.5,23.5,38.0,22.0,4034.0,0.0,16.5,8.0,87.0,24.0,5.5,2.0,0.0,12.0,1.0,695.0,246.0,9.0,1.0,1.79,1.49,5.0,19.0,59.0,1.0,88.6,78.5,7.0,14.0,3561.0,25.0,0.6145251396648045,7.0,0.4295432458697765,0.401124648547329,22.0,12.0,0.41463414634146345,0.2647058823529411,24.0,8.0,0.3810229799851742,0.3267629566694987,16.0,7.0,442.0,428.0,11.0,15.0,17.0,9.0,6.5,5.5,2056.0,1923.0,22.0,10.0,12.676767676767678,5.0,32.0,27.5,4.0,20.0,0.0,1.0,41.0,7.0,7.4,8.0,19.0,221.0,309.0,7.0,8.0,47.0,6.5,14.5,28.0,28.0,8.0,22.0,22.0,22.0,4.5,27.0,18.0,9.1,15.7,3.0,5.0,36.0,2.0,18.0,2.0,2.5,12.820936639118454,6.0,29747.0,28356.0,9.0,KC,5396.0,5885.0,24.0,21.0,100.0,100.0,19.0,14.0,52.0,33.0,8.0,3.0,52.0,33.0,8.0,2.5,6.5,7.2,18.0,27.5,4.7,4.5,25.0,4.5,10.7,12.8,32.0,30.5,29.9,24.4,22.5,1.0,11.8,6.5,4.0,6.0,5.2,5.5,20.0,20.5,45.3,0.0,16.5,15.0,27.3,28.8,18.0,24.0,-489.0,25.0,1.3829787234042552,1.6,23.0,30.0
2014.0,173.0,178.0,8.0,31.0,309.0,310.0,12.5,21.0,184.0,184.0,5.5,21.0,92.0,108.0,26.5,16.0,33.0,18.0,2.0,15.0,2.0,0.0,0.0,0.0,6.0,5.8,10.5,17.0,7366.0,10.0,7.1,6.7,10.5,14.0,40.0,166.0,162.0,10.0,1.6000000000000014,11.5,29.3,27.7,19.0,8.0,320.0,64.9,58.3,2.0,11.0,318.0,2.0,24.5,12.0,24.5,14.25,9.0,37.4,58.31,-17.03,4.0,16.0,-2.73,8.98,24.0,5.0,-5.79,9.0,15.0,83.3,86.5,24.0,18.5,1.0,10.0,7.0,10.0,2.0,1.0,10.0,6.0,7.0,1.0,11.0,8.0,21.5,21.0,11.666666666666664,5.0,14.3875,13.0,18.4,21.0,10.375,6.0,22.0,1.0,0.0,0.5,23.0,15.517217630853994,16.0,16.5,16.5,6.0,1.2,1.1,31.0,2.0,1.0,0.0,6.0,31.0,1.5,HC,51.0,54.0,29.5,4.0,1.0,0.0,13.5,3.5,1430.0,1293.0,30.0,1.0,5.9,5.5,3.5,23.0,15.583333333333336,13.0,0.0,0.0,353.0,281.0,2.0,72.0,9.0,16.0,493.0,545.0,13.5,28.0,0.5634095634095634,0.5771484375,17.0,23.0,2.0,21.5,18.0,3.7,4.0,11.0,24.5,22.0,8.0,27.5,0.5,0.8461538461538461,1.0,30.5,0.6239215686274511,0.6149773071104387,31.0,26.0,3182.0,3252.0,2.0,29.0,88.0,681.0,851.0,13.0,4.0,107.0,23.0,5.0,0.10679611650485436,0.05806451612903226,31.0,11.0,5.7,6.0,27.5,19.0,962.0,1024.0,16.0,29.0,71.0,0.0,0.0,16.5,6.5,29.0,12.0,3164.0,3700.0,25.0,19.0,78.0,20.5,20.0,1.0,0.0,10.0,7.0,605.0,190.0,4.0,1.0,1.93,1.56,6.0,13.5,50.0,1.0,92.2,86.4,12.0,12.5,3428.0,30.0,0.5,11.5,0.4365904365904366,0.4228515625,16.0,10.0,0.5,0.15384615384615385,32.0,2.5,0.3760784313725489,0.3850226928895613,2.0,7.0,420.0,433.0,18.0,16.0,18.0,4.0,1.0,3.0,1918.0,2036.0,28.0,10.0,13.515151515151516,9.0,35.8,32.6,14.5,13.0,0.0,1.0,49.0,9.0,7.8,3.0,28.5,246.0,253.0,13.0,21.0,46.0,5.0,26.0,30.0,37.0,26.0,20.5,25.0,32.0,29.5,19.0,17.0,9.2,6.7,30.0,4.0,14.0,30.5,-3.0,21.0,4.5,14.534435261707987,13.0,28718.0,28836.0,19.0,KC,5100.0,5288.0,7.0,25.0,100.0,100.0,20.0,13.5,38.0,25.0,1.5,17.0,38.0,25.0,1.5,17.0,7.0,6.4,4.0,22.0,4.6,4.7,30.0,4.0,10.7,11.0,7.5,27.0,28.0,23.9,18.0,2.5,12.1,6.6,6.0,4.0,5.3,5.2,7.0,18.0,44.6,47.4,30.0,19.5,29.4,29.7,12.0,18.5,-188.0,22.0,1.5217391304347827,1.3617021276595744,32.0,26.5
2015.0,182.0,183.0,14.0,20.5,303.0,313.0,13.0,25.0,155.0,193.0,16.0,28.5,116.0,86.0,11.0,4.0,32.0,34.0,23.0,17.0,4.0,0.0,2.0,2.0,6.4,4.9,3.5,13.5,6683.0,26.0,7.6,5.8,4.0,9.0,45.0,163.0,153.0,13.0,6.6999999999999975,1.0,31.3,24.6,3.0,1.0,310.0,65.5,57.5,2.0,9.0,349.0,13.0,28.0,38.0,2.0,8.166666666666666,7.0,73.11,47.83,27.86,3.0,19.0,30.2,34.08,15.0,1.0,69.97,3.0,8.0,81.1,81.8,12.0,26.0,0.0,8.0,10.0,11.0,8.0,0.0,7.0,10.0,9.0,4.0,8.0,7.0,27.5,10.5,5.583333333333332,1.0,12.20625,8.0,18.6,24.0,5.8125,4.0,15.0,2.0,1.0,0.5333333333333333,24.0,10.231955922865012,6.0,7.8,5.0,7.0,1.5,3.6,2.0,3.0,4.0,1.0,22.0,2.0,1.5,HC,35.0,46.0,27.5,13.5,0.0,0.0,13.5,19.0,791.0,1137.0,29.0,15.0,6.3,5.7,4.0,16.0,13.75,12.0,0.0,0.0,405.0,287.0,3.0,118.0,6.0,9.0,473.0,607.0,26.0,29.5,0.5434554973821989,0.6306653809064611,5.0,25.0,1.3362068965517242,31.0,20.0,4.2,4.1,12.0,19.5,25.0,16.0,26.5,0.5128205128205128,0.78125,5.0,30.0,0.6142668428005285,0.7018409565382425,13.0,28.0,3255.0,3698.0,9.0,30.0,104.0,878.0,941.0,16.0,11.0,110.0,14.0,12.0,0.1056105610561056,0.10862619808306707,8.0,11.0,5.5,5.8,21.5,25.0,955.0,1037.0,20.0,31.0,75.0,0.0,1.0,27.0,11.5,26.0,4.5,3333.0,3484.0,18.0,18.0,78.0,21.0,16.0,0.0,0.0,11.5,22.5,355.0,170.0,5.0,10.0,1.99,1.52,7.5,9.0,45.0,4.0,95.4,76.0,2.0,9.0,3493.0,30.0,0.7483870967741936,2.0,0.456544502617801,0.36933461909353904,28.0,8.0,0.4871794871794872,0.21875,28.0,3.0,0.3857331571994715,0.2981590434617575,20.0,5.0,436.0,383.0,7.0,12.5,19.0,7.0,4.0,2.0,2044.0,1571.0,8.0,6.0,17.21212121212121,21.0,37.9,27.3,3.5,9.0,1.0,0.0,46.0,8.9,7.2,6.0,29.5,238.0,290.0,6.0,16.0,47.0,4.0,26.5,37.0,22.0,1.0,6.0,30.0,18.0,1.0,8.0,15.0,7.1,15.3,3.0,2.0,29.0,5.0,14.0,2.0,2.0,12.663911845730025,7.0,29666.0,27999.0,15.0,KC,5299.0,5269.0,7.0,27.0,95.1,89.3,5.0,16.0,41.0,28.0,4.0,10.5,39.0,25.0,2.0,11.0,7.4,6.6,4.5,12.0,4.7,4.1,17.0,3.5,11.3,11.4,13.0,18.0,22.6,24.7,19.5,21.0,7.9,6.5,9.0,19.0,5.5,5.1,6.0,14.0,44.4,44.7,11.5,22.0,29.1,28.8,8.5,21.0,30.0,15.0,1.574468085106383,1.6097560975609757,26.5,29.0
2016.0,186.0,191.0,17.0,17.0,305.0,342.0,25.0,23.5,197.0,209.0,23.0,19.0,86.0,102.0,26.5,22.0,22.0,31.0,16.5,29.0,2.0,0.0,2.0,1.0,6.5,5.8,9.0,14.5,7197.0,5.0,7.2,6.3,4.5,16.0,42.0,166.0,165.0,7.0,3.2,4.0,29.9,26.7,5.5,6.0,365.0,66.8,58.5,2.0,7.0,350.0,15.0,17.0,32.0,1.5,15.916666666666664,15.0,33.53,70.4,-29.04,6.0,18.0,-24.46,8.3,21.0,19.0,-5.71,9.0,17.0,88.6,83.3,10.0,6.0,0.0,9.0,17.0,7.0,2.0,0.0,8.0,15.0,6.0,2.0,9.0,15.0,1.0,17.5,10.666666666666666,6.0,15.7125,16.0,15.55,18.0,15.875,16.0,18.0,1.0,0.0,0.5,23.0,11.982782369146006,7.0,9.5,7.0,8.0,1.5,3.0,5.0,8.5,4.0,1.0,18.0,2.0,8.0,HC,40.0,35.0,19.0,4.0,1.0,0.0,13.0,4.0,943.0,843.0,24.0,4.0,6.5,6.3,16.5,15.0,16.166666666666668,14.0,0.0,0.0,389.0,311.0,7.0,78.0,4.0,13.0,546.0,598.0,27.0,25.0,0.5838383838383838,0.5888993414863594,19.0,20.0,2.2906976744186047,15.0,19.0,3.5,3.8,12.0,22.5,23.0,15.0,24.5,0.5588235294117647,0.696969696969697,13.0,27.0,0.6814868804664723,0.671302578018996,23.0,21.0,3740.0,3958.0,18.0,19.0,109.0,848.0,797.0,4.0,9.5,109.0,18.5,18.5,0.07213114754098361,0.09064327485380116,20.0,28.0,5.8,6.1,27.5,16.0,990.0,1063.0,28.0,27.0,76.0,0.0,0.0,13.0,13.5,30.0,14.0,3427.0,3076.0,12.0,12.0,69.0,10.0,14.0,2.0,0.0,12.0,2.0,592.0,157.0,6.0,1.0,1.87,1.7,7.5,16.5,40.0,5.5,93.2,79.8,3.0,15.0,3914.0,21.5,0.4365482233502538,18.0,0.4161616161616162,0.41110065851364064,14.0,13.0,0.4411764705882353,0.303030303030303,20.0,6.0,0.3185131195335277,0.32869742198100405,10.0,12.0,412.0,437.0,24.0,14.0,15.0,10.0,7.0,13.5,1748.0,1938.0,26.0,15.0,10.26262626262626,4.0,36.6,33.5,10.0,15.0,1.0,0.0,32.0,5.5,4.5,30.5,14.5,174.0,162.0,30.0,6.0,28.0,28.0,11.5,35.0,30.0,12.5,10.0,31.0,25.0,11.5,7.5,17.0,9.7,15.7,1.0,10.0,33.0,1.0,16.0,1.5,9.0,14.465564738292013,9.0,30876.0,31515.0,10.0,KC,5488.0,5896.0,24.0,20.0,92.3,100.0,30.0,20.0,39.0,30.0,7.0,13.0,36.0,30.0,9.0,14.5,7.2,6.9,12.5,16.0,4.2,4.4,22.0,16.5,10.7,11.8,23.5,25.5,23.6,24.1,29.0,9.0,14.8,5.2,3.0,1.0,5.5,5.5,15.5,16.5,45.1,44.6,11.0,19.0,30.6,32.8,24.0,16.0,-408.0,28.0,1.7142857142857142,1.5681818181818181,28.0,17.0
