Year,#Dr,#Dr_Defense,#Dr_Defense_Low_Rank,#Dr_High_Rank,1stD,1stD_Defense,1stD_Defense_Low_Rank,1stD_High_Rank,1stDpass,1stDpass_Defense,1stDpass_Defense_Low_Rank,1stDpass_High_Rank,1stDrun,1stDrun_Defense,1stDrun_Defense_Low_Rank,1stDrun_High_Rank,1stPy,1stPy_Defense,1stPy_Defense_Low_Rank,1stPy_High_Rank,2PA,2PA_Defense,2PM,2PM_Defense,ANY/A,ANY/A_Defense,ANY/A_Defense_Low_Rank,ANY/A_High_Rank,APYd,APYd_High_Rank,AY/A,AY/A_Defense,AY/A_Defense_Low_Rank,AY/A_High_Rank,AllTD,AvgDriveTime,AvgDriveTime_Defense,AvgDriveTime_High_Rank,AvgFieldPositionDifferential,AvgFieldPositionDifferential_High_Rank,AvgStartingPosition,AvgStartingPosition_Defense,AvgStartingPosition_Defense_Low_Rank,AvgStartingPosition_High_Rank,Cmp,Cmp%,Cmp%_Defense,Cmp%_Defense_Low_Rank,Cmp%_High_Rank,Cmp_Defense,Cmp_Defense_Low_Rank,Cmp_High_Rank,DefensivePtsScored,DefensivePtsScored_High_Rank,Dscore,Dscore_Rank,ExpectedPoints,ExpectedPointsPassing,ExpectedPointsPassing_Defense,ExpectedPointsPassing_Defense_High_Rank,ExpectedPointsPassing_High_Rank,ExpectedPointsRunning,ExpectedPointsRunning_Defense,ExpectedPointsRunning_Defense_High_Rank,ExpectedPointsRunning_High_Rank,ExpectedPoints_Defense,ExpectedPoints_Defense_High_Rank,ExpectedPoints_High_Rank,FG%,FG%_Defense,FG%_Defense_Low_Rank,FG%_High_Rank,FGA019,FGA2029,FGA3039,FGA4049,FGA50Plus,FGM019,FGM2029,FGM3039,FGM4049,FGM50Plus,FL,FL_Defense,FL_Defense_High_Rank,FL_Low_Rank,FantasyDstScore,FantasyDstScore_Rank,FantasyOffenseScore,FantasyOffenseScore_Rank,FantasyPassScore,FantasyPassScore_Rank,FantasyRushScore,FantasyRushScore_Rank,Fmb,FmbTD,FmbTD_Defense,FumbleLostPercent,FumbleLostPercent_Low_Rank,GameControlPlusBalance,GameControlPlusBalance_Rank,GameControlScore,GameControlScore_Rank,Int,Int%,Int%_Defense,Int%_Defense_High_Rank,Int%_Low_Rank,IntTD,IntTD_Defense,Int_Defense,Int_Defense_High_Rank,Int_Low_Rank,Job,KickRet,KickRet_Defense,KickRet_Defense_Low_Rank,KickRet_High_Rank,KrTD,KrTD_Defense,KrTD_Defense_Low_Rank,KrTD_High_Rank,KrYds,KrYds_Defense,KrYds_Defense_Low_Rank,KrYds_High_Rank,NY/A,NY/A_Defense,NY/A_Defense_Low_Rank,NY/A_High_Rank,Oscore,Oscore_Rank,OthTD,OthTD_Defense,PF,PF_Defense,PF_Defense_Low_Rank,PF_Differential,PF_Differential_High_Rank,PF_High_Rank,PassAtt,PassAtt_Defense,PassAtt_Defense_Low_Rank,PassAtt_High_Rank,PassPercent,PassPercent_Defense,PassPercent_Defense_High_Rank,PassPercent_High_Rank,PassRun1dRatio,PassRun1dRatio_High_Rank,PassTD,PassTD%,PassTD%_Defense,PassTD%_Defense_Low_Rank,PassTD%_High_Rank,PassTD_Defense,PassTD_Defense_Low_Rank,PassTD_High_Rank,PassTdPercent,PassTdPercent_Defense,PassTdPercent_Defense_High_Rank,PassTdPercent_High_Rank,PassYdPercent,PassYdPercent_Defense,PassYdPercent_Defense_High_Rank,PassYdPercent_High_Rank,PassYds,PassYds_Defense,PassYds_Defense_Low_Rank,PassYds_High_Rank,Pen,PenYds,PenYds_Defense,PenYds_Defense_Low_Rank,PenYds_Low_Rank,Pen_Defense,Pen_Defense_Low_Rank,Pen_Low_Rank,Penalty1dPercent,Penalty1dPercent_Defense,Penalty1dPercent_Defense_High_Rank,Penalty1dPercent_High_Rank,Plays/Drive,Plays/Drive_Defense,Plays/Drive_Defense_Low_Rank,Plays/Drive_High_Rank,Ply,Ply_Defense,Ply_Defense_Low_Rank,Ply_High_Rank,Pnt,PntBlck,PntBlck_Defense,PntBlck_Defense_Low_Rank,PntBlck_Low_Rank,PntRet_Defense,PntRet_Defense_Low_Rank,PntYds,PntYds_Defense,PntYds_Defense_Low_Rank,PntYds_High_Rank,Pnt_Defense,Pnt_Defense_Low_Rank,Pnt_High_Rank,PrTD,PrTD_Defense,PrTD_Defense_Low_Rank,PrTD_High_Rank,PrYds,PrYds_Defense,PrYds_Defense_Low_Rank,PrYds_High_Rank,Pts/Drive,Pts/Drive_Defense,Pts/Drive_Defense_Low_Rank,Pts/Drive_High_Rank,PuntRet,PuntRet_High_Rank,QbRating,QbRating_Defense,QbRating_Defense_Low_Rank,QbRating_High_Rank,RawPassYds,RawPassYds_High_Rank,RunPass1dRatio,RunPass1dRatio_High_Rank,RunPercent,RunPercent_Defense,RunPercent_Defense_High_Rank,RunPercent_High_Rank,RunTdPercent,RunTdPercent_Defense,RunTdPercent_Defense_High_Rank,RunTdPercent_High_Rank,RunYdPercent,RunYdPercent_Defense,RunYdPercent_Defense_High_Rank,RunYdPercent_High_Rank,RushAtt,RushAtt_Defense,RushAtt_Defense_Low_Rank,RushAtt_High_Rank,RushTD,RushTD_Defense,RushTD_Defense_Low_Rank,RushTD_High_Rank,RushYds,RushYds_Defense,RushYds_Defense_Low_Rank,RushYds_High_Rank,STscore,STscore_Rank,Sc%,Sc%_Defense,Sc%_Defense_Low_Rank,Sc%_High_Rank,Sfty,Sfty_Defense,Sk,Sk%,Sk%_Defense,Sk%_Defense_High_Rank,Sk%_Low_Rank,SkYds,SkYds_Defense,SkYds_Defense_High_Rank,SkYds_Low_Rank,Sk_Defense,Sk_Defense_High_Rank,Sk_Low_Rank,TFGA,TFGA_Defense,TFGA_Defense_Low_Rank,TFGA_High_Rank,TFGM,TFGM_Defense,TFGM_Defense_Low_Rank,TFGM_High_Rank,TO,TO%,TO%_Defense,TO%_Defense_High_Rank,TO%_Low_Rank,TO_Defense,TO_Defense_High_Rank,TO_Differential,TO_Differential_High_Rank,TO_Low_Rank,ThreePhaseScore,ThreePhaseScore_Rank,TimeOfPossession,TimeOfPossession_Defense,TimeOfPossession_High_Rank,Tm,TotalYds,TotalYds_Defense,TotalYds_Defense_Low_Rank,TotalYds_High_Rank,XP%,XP%_Defense,XP%_Defense_Low_Rank,XP%_High_Rank,XPA,XPA_Defense,XPA_Defense_Low_Rank,XPA_High_Rank,XPM,XPM_Defense,XPM_Defense_Low_Rank,XPM_High_Rank,Y/Apass,Y/Apass_Defense,Y/Apass_Defense_Low_Rank,Y/Apass_High_Rank,Y/Arun,Y/Arun_Defense,Y/Arun_Defense_Low_Rank,Y/Arun_High_Rank,Y/C,Y/C_Defense,Y/C_Defense_Low_Rank,Y/C_High_Rank,Y/KR,Y/KR_Defense,Y/KR_Defense_Low_Rank,Y/KR_High_Rank,Y/PR,Y/PR_Defense,Y/PR_Defense_Low_Rank,Y/PR_High_Rank,Y/Play,Y/Play_Defense,Y/Play_Defense_Low_Rank,Y/Play_High_Rank,Y/Pnt,Y/Pnt_Defense,Y/Pnt_Defense_Low_Rank,Y/Pnt_High_Rank,Yds/Drive,Yds/Drive_Defense,Yds/Drive_Defense_Low_Rank,Yds/Drive_High_Rank,Yds_Differential,Yds_Differential_High_Rank,YppYprRatio,YppYprRatio_Defense,YppYprRatio_Defense_High_Rank,YppYprRatio_High_Rank
2002.0,200.0,194.0,23.0,4.0,311.0,272.0,4.0,18.0,164.0,160.0,9.5,22.0,124.0,83.0,4.5,6.0,23.0,29.0,22.5,23.0,3.0,0.0,3.0,2.0,5.9,4.5,4.0,7.5,7767.0,9.0,6.7,5.6,6.5,7.0,46.0,150.0,143.0,23.0,6.8000000000000025,1.0,35.2,28.4,2.0,2.0,318.0,58.0,59.1,15.5,21.5,333.0,17.0,18.0,18.0,12.5,6.083333333333332,3.0,-2.03,2.94,90.22,2.0,22.0,0.74,76.18,1.0,8.0,171.25,2.0,18.0,88.2,81.0,21.0,3.0,0.0,9.0,16.0,7.0,2.0,0.0,9.0,14.0,6.0,1.0,13.0,23.0,1.0,17.0,6.25,2.0,10.8,6.0,11.6,14.0,10.0,9.0,28.0,1.0,1.0,0.4642857142857143,11.0,7.2214876033057855,1.0,4.6,2.0,11.0,2.0,2.7,21.0,5.0,2.0,0.0,15.0,20.5,6.0,OC,52.0,76.0,26.0,30.0,0.0,1.0,24.0,23.0,1297.0,1637.0,23.0,26.0,5.8,5.0,2.0,18.0,11.083333333333336,7.0,0.0,0.0,415.0,241.0,2.0,174.0,1.0,4.0,548.0,563.0,23.0,18.5,0.5442684063373718,0.6134786917740337,5.0,24.0,1.3225806451612905,29.0,27.0,4.9,3.2,6.0,5.5,18.0,7.5,5.0,0.6428571428571429,0.7826086956521741,2.0,14.5,0.6038543897216274,0.650820361800589,14.0,24.0,3384.0,3094.0,7.0,19.0,111.0,897.0,969.0,28.5,20.0,112.0,25.5,23.0,0.07395498392282958,0.10661764705882353,6.0,22.0,5.5,5.3,6.0,20.0,1073.0,1009.0,18.0,4.0,79.0,0.0,0.0,16.5,7.5,30.0,11.5,3197.0,3690.0,28.0,13.0,90.0,28.0,12.5,1.0,2.0,28.5,11.5,567.0,420.0,24.0,2.0,1.92,1.09,2.0,10.5,47.0,3.0,85.9,76.4,10.0,9.0,3606.0,18.0,0.7560975609756098,4.0,0.4557315936626282,0.3865213082259663,28.0,9.0,0.3571428571428571,0.21739130434782605,31.0,18.5,0.3961456102783726,0.34917963819941106,19.0,9.0,489.0,390.0,5.0,5.5,15.0,5.0,1.0,14.5,2220.0,1660.0,9.0,7.0,13.202020202020199,5.0,36.0,20.6,2.0,8.0,0.0,0.0,36.0,6.2,9.0,2.0,16.5,222.0,348.0,1.0,17.0,56.0,1.0,16.0,34.0,21.0,1.5,7.5,30.0,17.0,4.0,4.0,24.0,12.0,18.0,5.0,10.0,38.0,4.0,14.0,4.0,8.0,9.842975206611573,1.0,30000.0,27742.0,11.0,PHI,5604.0,4754.0,4.0,10.0,100.0,100.0,24.0,11.0,43.0,24.0,2.5,6.5,43.0,24.0,2.5,4.0,6.6,6.1,2.5,17.0,4.5,4.3,20.5,8.5,11.3,10.3,2.5,16.0,24.9,21.5,13.5,1.0,12.1,14.0,30.0,6.0,5.2,4.7,3.0,17.0,40.5,41.0,16.5,23.0,28.0,24.3,3.0,17.5,850.0,6.0,1.4666666666666666,1.4186046511627908,28.0,24.0
2003.0,187.0,187.0,12.5,20.5,302.0,306.0,21.0,13.5,156.0,171.0,18.5,18.5,105.0,116.0,22.0,12.0,41.0,19.0,4.0,1.0,1.0,0.0,0.0,1.0,5.4,5.0,14.0,14.0,7074.0,16.0,6.4,5.8,14.0,12.0,43.0,145.0,163.0,24.5,2.3000000000000007,4.0,32.5,30.2,5.0,8.0,279.0,57.6,60.3,21.0,19.5,337.0,31.0,25.0,8.0,23.5,16.5,18.0,10.98,-6.29,45.18,7.0,17.0,30.14,-10.59,29.0,3.0,54.0,12.0,11.0,82.8,73.3,6.0,12.0,0.0,9.0,7.0,10.0,3.0,0.0,9.0,7.0,6.0,2.0,11.0,13.0,9.5,15.0,16.083333333333332,16.5,12.4625,10.0,15.05,15.0,9.875,7.0,21.0,0.0,0.0,0.5238095238095238,26.0,13.726997245179064,13.0,13.6,13.0,11.0,2.3,2.3,29.0,5.0,1.0,1.0,13.0,26.5,4.0,OC,65.0,74.0,23.0,18.0,0.0,1.0,26.0,22.0,1387.0,1590.0,23.0,21.0,5.7,5.4,9.0,20.0,12.083333333333336,10.0,0.0,0.0,374.0,287.0,7.0,87.0,8.0,11.0,484.0,559.0,28.0,25.0,0.5582627118644068,0.5642722117202268,11.0,15.0,1.4857142857142858,19.0,17.0,3.5,3.0,4.0,21.0,17.0,7.0,22.5,0.425,0.5666666666666667,22.0,31.0,0.5998013902681232,0.6097606934237799,21.0,24.0,3020.0,3236.0,16.0,20.0,96.0,817.0,1105.0,32.0,12.0,129.0,29.0,9.0,0.1357615894039735,0.062091503267973865,29.0,1.0,5.2,5.8,28.5,28.0,944.0,1058.0,28.0,29.0,79.0,0.0,0.0,16.5,8.5,35.0,13.0,3207.0,3034.0,10.0,18.0,78.0,17.5,19.0,2.0,0.0,9.5,3.5,378.0,272.0,6.0,14.0,1.88,1.48,11.0,10.0,31.0,27.0,80.5,78.7,17.0,14.0,3273.0,18.5,0.6730769230769231,14.0,0.4417372881355932,0.4357277882797732,22.0,18.0,0.575,0.43333333333333335,11.0,2.0,0.4001986097318768,0.3902393065762201,12.0,9.0,417.0,461.0,21.5,25.5,23.0,13.0,18.0,2.0,2015.0,2071.0,22.0,9.0,12.686868686868687,3.0,34.2,27.8,9.0,10.0,1.0,0.0,43.0,8.2,6.4,18.0,30.0,253.0,248.0,8.5,23.0,38.0,10.0,26.5,29.0,30.0,15.5,17.0,24.0,22.0,14.0,12.0,22.0,10.2,13.4,17.0,3.5,26.0,18.5,4.0,8.0,5.5,13.853994490358126,11.0,27115.0,30481.0,28.0,PHI,5035.0,5307.0,20.0,18.0,100.0,96.4,4.0,8.5,42.0,28.0,7.0,8.0,42.0,27.0,6.0,8.0,6.8,6.2,9.5,13.0,4.8,4.5,23.5,4.5,11.7,10.3,3.0,7.5,21.3,21.5,21.0,17.0,12.2,7.8,8.0,5.5,5.3,5.0,15.0,10.5,40.6,38.9,4.0,20.0,26.9,28.1,21.0,16.0,-272.0,20.0,1.4166666666666667,1.3777777777777778,29.0,25.0
2004.0,192.0,183.0,11.5,12.5,301.0,299.0,13.0,14.0,188.0,165.0,11.5,10.0,87.0,101.0,17.0,23.0,26.0,33.0,26.0,17.5,2.0,0.0,0.0,1.0,7.1,4.6,4.5,4.5,7449.0,11.0,8.0,5.5,5.0,4.0,44.0,144.0,167.0,24.5,1.3000000000000007,7.5,31.1,29.8,9.0,15.5,336.0,61.4,60.7,19.0,10.0,334.0,27.0,8.0,12.0,23.0,11.166666666666664,9.0,69.55,106.56,11.07,10.0,7.0,-23.88,19.44,19.0,14.0,46.14,12.0,8.0,84.4,70.8,4.0,11.0,0.0,4.0,7.0,18.0,3.0,0.0,4.0,6.0,15.0,2.0,11.0,11.0,20.0,16.5,12.666666666666664,7.0,13.51875,11.0,5.6,3.0,21.4375,23.0,17.0,0.0,0.0,0.6470588235294118,32.0,11.659504132231405,6.0,11.6,8.0,11.0,2.0,3.1,20.0,3.0,2.0,1.0,17.0,15.5,4.5,OC,56.0,73.0,21.0,28.5,0.0,0.0,9.0,22.0,1214.0,1693.0,26.0,28.0,6.8,5.4,3.5,9.5,9.5,8.5,0.0,0.0,386.0,260.0,2.5,126.0,4.0,8.0,547.0,550.0,29.0,9.0,0.6083333333333333,0.5745909528392685,7.0,4.0,2.160919540229885,9.0,32.0,5.9,2.9,2.5,6.0,16.0,3.0,4.0,0.7619047619047619,0.5517241379310345,27.0,5.0,0.7082591669633321,0.6279569892473118,23.0,5.0,3979.0,3212.0,12.0,7.0,124.0,952.0,1001.0,27.0,22.0,119.0,24.5,28.0,0.08637873754152824,0.11036789297658862,8.0,18.0,5.2,5.8,27.5,26.0,960.0,1039.0,26.0,27.0,73.0,0.0,0.0,16.5,12.0,34.0,13.5,3068.0,3782.0,27.0,21.0,89.0,25.5,22.0,0.0,0.0,12.0,20.5,377.0,221.0,5.5,12.0,1.95,1.39,7.5,7.0,41.0,11.5,96.4,75.8,8.0,4.0,4208.0,6.0,0.4627659574468085,24.0,0.3916666666666667,0.42540904716073147,26.0,29.0,0.2380952380952381,0.4482758620689655,6.0,28.0,0.2917408330366679,0.3720430107526882,10.0,28.0,376.0,442.0,16.0,31.0,10.0,13.0,18.0,22.0,1639.0,1903.0,16.0,24.0,15.414141414141412,13.5,35.9,25.1,4.0,8.0,0.0,0.0,37.0,6.3,7.9,4.5,12.0,229.0,263.0,9.0,16.0,47.0,2.0,16.5,32.0,24.0,7.0,4.5,27.0,17.0,6.0,5.5,22.0,10.9,13.1,21.0,5.5,28.0,18.5,6.0,11.5,7.5,11.71900826446281,5.0,27648.0,30561.0,26.0,PHI,5618.0,5115.0,10.0,9.0,97.6,100.0,21.5,26.0,42.0,27.0,4.5,8.5,41.0,27.0,5.0,9.5,7.7,6.3,3.0,8.5,4.4,4.3,19.5,9.0,12.5,10.4,1.0,6.5,21.7,23.2,26.5,15.0,9.2,6.5,5.5,13.0,5.9,4.9,7.0,5.5,42.0,42.5,23.5,16.5,29.2,28.0,14.5,10.5,503.0,9.0,1.75,1.4651162790697674,31.0,16.5
2005.0,218.0,209.0,32.0,1.0,282.0,290.0,13.0,21.0,182.0,171.0,18.0,12.0,73.0,91.0,16.5,28.0,27.0,28.0,14.5,17.0,2.0,0.0,1.0,0.0,4.8,5.7,22.5,22.5,7451.0,10.0,5.5,6.4,21.5,23.0,35.0,126.0,147.0,32.0,-1.6000000000000014,20.0,30.4,32.0,22.0,21.0,337.0,54.4,59.0,16.0,27.0,297.0,14.0,9.0,18.0,13.0,19.08333333333333,21.0,-129.46,-60.11,-31.82,19.0,29.0,-48.79,66.1,4.0,18.0,47.06,14.0,30.0,75.9,81.5,21.0,25.0,0.0,6.0,9.0,12.0,2.0,0.0,6.0,8.0,7.0,1.0,14.0,10.0,24.5,23.0,19.33333333333333,24.0,18.78125,20.0,13.5,16.0,24.0625,27.0,34.0,1.0,2.0,0.4117647058823529,10.0,20.93732782369146,24.0,23.5,26.0,20.0,3.2,3.4,10.5,19.5,1.0,4.0,17.0,11.5,26.0,OC,71.0,67.0,20.0,11.0,0.0,1.0,27.0,21.5,1578.0,1416.0,16.5,11.0,5.6,6.2,24.0,21.0,20.33333333333333,21.0,1.0,0.0,310.0,388.0,27.0,-78.0,24.0,18.0,620.0,503.0,13.5,3.0,0.6445959104186952,0.5125240847784199,26.0,2.0,2.4931506849315066,5.0,21.0,3.4,4.8,26.5,21.0,24.0,26.5,14.0,0.65625,0.6153846153846154,15.0,8.5,0.7197103151301625,0.6383019592777565,19.0,6.0,3677.0,3323.0,21.0,8.0,134.0,1130.0,910.0,15.0,29.5,112.0,14.0,27.0,0.09574468085106384,0.09655172413793103,18.0,14.0,4.8,5.1,3.0,31.0,1027.0,1038.0,27.0,10.0,100.0,1.0,0.0,16.5,28.0,57.0,31.0,4113.0,4358.0,32.0,2.0,104.0,32.0,2.0,0.0,0.0,12.5,20.5,448.0,310.0,18.0,4.0,1.33,1.62,15.5,25.0,53.0,1.5,71.5,82.2,20.0,25.0,3903.0,8.0,0.4010989010989011,28.0,0.3554040895813048,0.4874759152215801,7.0,31.0,0.34375,0.3846153846153846,18.0,24.5,0.2802896848698375,0.3616980407222435,14.0,27.0,365.0,506.0,28.5,30.0,11.0,15.0,21.0,19.0,1432.0,1883.0,21.0,28.0,14.818181818181818,8.0,24.8,29.2,13.0,29.0,0.0,0.0,42.0,6.3,5.5,27.0,16.5,226.0,184.0,28.0,16.0,29.0,26.5,21.5,29.0,27.0,8.5,19.0,22.0,22.0,12.5,22.5,34.0,14.7,11.5,24.0,22.0,27.0,19.0,-7.0,23.5,25.5,18.374655647382927,20.0,27468.0,30723.0,27.0,PHI,5109.0,5206.0,23.0,19.0,97.0,100.0,22.5,27.0,33.0,46.0,29.0,16.5,32.0,46.0,29.0,17.5,6.3,7.0,23.0,24.5,3.9,3.7,8.5,17.5,11.6,11.8,25.5,16.0,22.2,21.1,9.0,14.5,8.5,5.4,4.0,12.0,5.0,5.0,14.0,17.5,41.1,41.9,15.0,25.0,23.3,24.8,8.0,28.0,-97.0,23.0,1.6153846153846154,1.8918918918918919,4.0,23.0
2006.0,197.0,192.0,26.0,4.0,272.0,272.0,10.0,26.0,160.0,192.0,31.0,20.0,87.0,53.0,1.0,24.0,25.0,27.0,22.5,13.0,3.0,0.0,0.0,0.0,4.3,5.0,9.5,28.0,7120.0,20.0,5.1,5.6,7.0,27.5,32.0,155.0,143.0,16.0,-1.400000000000002,21.0,29.9,31.3,23.5,21.0,332.0,61.5,59.3,15.5,13.0,355.0,32.0,7.0,36.0,2.0,9.083333333333334,6.0,-127.19,-80.73,14.75,12.0,29.0,-35.81,78.46,2.0,21.0,104.77,3.0,29.0,84.0,85.0,22.0,13.0,2.0,7.0,8.0,6.0,2.0,2.0,7.0,8.0,4.0,0.0,12.0,15.0,6.0,17.5,10.75,7.0,18.9,24.0,19.8,25.0,18.0,21.0,31.0,3.0,2.0,0.3870967741935484,6.0,15.802341597796145,15.0,14.5,15.0,20.0,3.7,3.5,12.5,23.5,3.0,4.0,21.0,5.0,25.0,HC,66.0,59.0,10.5,13.0,0.0,1.0,28.0,20.0,1492.0,1369.0,12.0,14.0,5.4,6.1,18.5,25.5,23.16666666666667,28.0,0.0,0.0,282.0,327.0,14.0,-45.0,22.0,26.0,540.0,599.0,32.0,9.0,0.5687804878048779,0.6438075742067554,1.0,11.0,1.839080459770115,14.0,13.0,2.4,2.5,4.0,31.0,15.0,4.0,30.5,0.52,0.625,12.0,27.0,0.6318025490592758,0.7949198417655632,1.0,19.0,3123.0,3818.0,31.5,18.0,123.0,903.0,899.0,28.0,24.0,112.0,30.0,32.0,0.09191176470588236,0.09926470588235294,6.0,10.0,5.3,5.3,8.0,25.0,1025.0,977.0,8.0,9.0,94.0,0.0,0.0,16.5,11.5,50.0,29.5,3961.0,3587.0,22.0,4.0,79.0,18.0,2.0,1.0,1.0,25.0,7.0,374.0,485.0,29.0,10.0,1.24,1.41,5.0,29.0,38.0,14.0,72.2,73.1,5.0,26.0,3402.0,17.0,0.54375,19.0,0.431219512195122,0.3561924257932446,32.0,22.0,0.48,0.375,21.0,6.0,0.3681974509407242,0.2050801582344368,32.0,14.0,442.0,348.0,1.0,17.0,12.0,9.0,5.0,19.5,1820.0,985.0,1.0,16.0,19.71717171717172,25.0,23.9,30.2,14.0,29.0,0.0,1.0,43.0,7.4,4.8,29.5,21.0,279.0,197.0,24.0,23.0,30.0,25.5,23.5,25.0,40.0,31.0,28.5,21.0,34.0,31.5,24.5,32.0,15.7,16.7,6.5,24.0,36.0,3.0,4.0,10.5,24.0,17.104683195592287,18.0,30535.0,27456.0,4.0,MIN,4943.0,4803.0,8.0,23.0,96.4,100.0,20.5,29.0,28.0,31.0,7.5,26.5,27.0,31.0,7.5,27.0,6.3,6.7,13.5,25.5,4.1,2.8,1.0,14.5,10.2,11.3,14.5,29.5,22.6,23.2,23.0,17.0,9.8,9.7,23.0,9.0,4.8,4.9,8.0,26.0,42.1,45.4,31.5,24.5,25.1,25.0,7.0,27.0,140.0,15.0,1.5365853658536586,2.3928571428571432,1.0,21.0
2007.0,190.0,192.0,23.0,12.5,294.0,305.0,20.5,19.0,139.0,222.0,32.0,31.0,131.0,67.0,1.0,1.0,24.0,16.0,10.0,9.5,3.0,0.0,3.0,0.0,5.0,5.8,20.5,19.0,7369.0,15.0,5.9,6.6,21.0,19.5,43.0,149.0,154.0,24.0,-1.6999999999999993,21.0,27.7,29.4,8.0,31.5,249.0,57.6,64.2,28.0,25.5,415.0,31.0,32.0,50.0,1.0,13.666666666666664,14.0,-3.74,-18.07,-44.57,19.0,21.0,20.5,103.43,1.0,2.0,75.52,5.0,16.0,83.3,87.5,25.0,19.0,0.0,3.0,6.0,11.0,4.0,0.0,3.0,6.0,10.0,1.0,16.0,16.0,6.5,26.0,11.666666666666664,5.0,13.375,13.0,22.0,28.0,4.75,1.0,27.0,2.0,0.0,0.5925925925925926,28.0,16.181267217630857,14.0,17.2,15.0,14.0,3.2,2.3,27.5,15.5,6.0,0.0,15.0,21.0,8.0,HC,59.0,65.0,15.5,23.0,1.0,0.0,7.0,11.5,1461.0,1441.0,17.0,17.0,5.8,6.2,18.0,19.5,14.583333333333336,15.0,0.0,2.0,365.0,311.0,12.0,54.0,10.0,15.0,432.0,646.0,32.0,32.0,0.487551867219917,0.6434619002822202,1.0,31.0,1.0610687022900764,32.0,12.0,2.8,3.4,6.5,28.0,22.0,16.0,30.0,0.35294117647058826,0.7586206896551724,6.0,31.0,0.5103179029559398,0.7809611829944547,1.0,32.0,2745.0,4225.0,32.0,28.0,86.0,662.0,763.0,24.0,13.0,110.0,28.0,13.0,0.08163265306122447,0.052459016393442616,24.0,9.0,5.2,5.7,21.5,30.5,964.0,1063.0,29.0,30.0,81.0,0.0,0.0,16.5,11.5,43.0,28.0,3621.0,3780.0,30.0,8.0,82.0,25.5,8.5,0.0,1.0,24.0,22.5,242.0,440.0,30.0,22.0,1.57,1.49,8.0,20.0,29.0,24.0,74.2,86.3,23.0,21.0,2938.0,29.0,0.9424460431654677,1.0,0.5124481327800829,0.35653809971777983,32.0,2.0,0.6470588235294117,0.2413793103448276,27.0,2.0,0.4896820970440602,0.21903881700554528,32.0,1.0,494.0,379.0,4.0,6.0,22.0,7.0,4.0,1.0,2634.0,1185.0,1.0,1.0,17.92929292929293,20.0,28.4,29.7,13.0,22.0,1.0,2.0,38.0,8.1,5.6,22.5,26.0,193.0,275.0,5.0,14.0,38.0,8.0,20.0,24.0,32.0,18.0,28.0,20.0,28.0,23.0,29.0,30.0,15.3,16.1,10.0,19.5,31.0,9.5,1.0,14.0,20.0,15.162534435261712,15.0,28310.0,29568.0,23.0,MIN,5379.0,5410.0,20.0,13.0,97.5,100.0,21.5,26.0,40.0,31.0,7.0,13.5,39.0,31.0,8.0,14.0,6.8,7.0,17.5,17.5,5.3,3.1,2.0,1.0,11.8,10.8,10.0,7.5,24.8,22.2,12.0,5.0,8.3,10.2,24.0,21.0,5.6,5.1,14.5,6.5,44.7,46.1,30.0,8.0,28.2,28.0,18.0,13.5,-31.0,18.0,1.2830188679245282,2.258064516129032,2.0,31.0
2008.0,190.0,191.0,25.0,7.5,292.0,255.0,4.0,18.0,150.0,163.0,8.5,24.0,119.0,72.0,2.0,5.0,23.0,20.0,19.5,9.0,1.0,0.0,0.0,1.0,5.3,5.6,14.0,20.5,7262.0,18.0,6.4,6.6,18.0,18.0,41.0,158.0,144.0,19.0,-2.7,24.0,29.3,32.0,26.5,23.0,267.0,59.1,61.1,17.0,23.5,324.0,21.0,25.0,24.0,11.0,8.833333333333334,5.0,-36.35,0.43,-17.9,12.0,21.0,-25.28,88.01,2.0,18.0,79.68,5.0,22.0,85.3,72.2,3.0,16.0,0.0,10.0,9.0,9.0,6.0,0.0,10.0,7.0,6.0,6.0,14.0,13.0,8.5,29.0,12.0,7.0,14.7,17.0,18.9,23.0,10.5,8.5,31.0,2.0,3.0,0.4516129032258064,18.0,15.211570247933883,17.0,16.2,17.5,17.0,3.8,2.3,24.0,30.0,0.0,2.0,12.0,23.5,23.0,HC,61.0,78.0,30.0,20.5,0.0,0.0,11.0,22.5,1369.0,1830.0,30.0,25.0,6.0,6.0,13.0,18.0,16.5,17.0,1.0,2.0,379.0,333.0,13.0,46.0,13.0,12.0,452.0,530.0,22.0,28.0,0.4881656804733728,0.6078224101479915,2.0,28.0,1.2605042016806722,30.0,22.0,4.9,2.8,4.5,5.5,15.0,5.0,11.5,0.5945945945945946,0.6,15.5,15.0,0.5590015128593041,0.7371233169480659,1.0,29.0,2956.0,3449.0,18.0,25.0,90.0,692.0,1002.0,32.0,16.0,109.0,28.5,17.0,0.07876712328767123,0.0784313725490196,11.0,9.0,5.5,5.1,2.5,20.5,1014.0,946.0,8.0,11.0,74.0,1.0,0.0,16.5,26.5,42.0,27.0,3521.0,3480.0,24.0,10.0,80.0,24.5,17.5,1.0,4.0,32.0,7.5,273.0,624.0,32.0,20.0,1.82,1.4,5.0,16.0,34.0,15.5,81.5,82.5,16.0,18.0,3217.0,26.0,0.7933333333333333,3.0,0.5118343195266273,0.3921775898520085,31.0,5.0,0.4054054054054054,0.4,17.5,18.0,0.4409984871406959,0.2628766830519341,32.0,4.0,519.0,371.0,2.0,3.0,15.0,10.0,6.5,15.5,2332.0,1230.0,1.0,5.0,18.37373737373737,23.5,34.7,27.7,5.0,14.0,3.0,1.0,43.0,8.7,7.8,4.0,28.0,261.0,304.0,4.0,22.0,45.0,4.0,26.0,34.0,36.0,25.5,11.0,29.0,26.0,19.5,10.0,31.0,14.7,12.6,17.0,23.0,25.0,15.5,-6.0,24.0,28.0,14.223140495867767,11.0,30020.0,27504.0,11.0,MIN,5288.0,4679.0,6.0,17.0,100.0,100.0,19.0,13.5,40.0,35.0,15.0,16.0,40.0,35.0,15.5,15.5,7.1,7.1,21.0,14.0,4.5,3.3,1.5,6.0,12.0,11.6,19.5,8.0,22.4,23.5,21.0,20.0,8.0,14.9,32.0,24.5,5.2,4.9,6.0,18.0,47.6,43.5,15.0,4.0,27.7,24.5,5.0,19.5,609.0,9.0,1.5777777777777775,2.1515151515151514,1.0,20.0
2009.0,188.0,188.0,20.0,15.5,343.0,271.0,2.0,3.0,220.0,183.0,19.0,5.0,99.0,63.0,1.0,15.0,24.0,25.0,23.0,15.5,1.0,0.0,0.0,0.0,7.7,6.0,20.5,3.0,8117.0,5.0,8.6,7.2,23.5,2.5,56.0,168.0,140.0,8.0,4.800000000000002,2.0,32.5,27.7,6.0,1.0,377.0,68.2,63.7,25.0,2.0,341.0,21.5,6.0,8.0,25.5,10.416666666666666,7.0,136.0,214.74,-19.54,12.0,3.0,-65.49,67.02,3.0,32.0,59.48,6.0,5.0,92.9,84.6,20.5,2.0,1.0,10.0,6.0,9.0,2.0,1.0,10.0,5.0,8.0,2.0,11.0,13.0,9.0,19.0,13.083333333333336,9.0,8.59375,4.0,4.0,2.0,13.1875,12.0,19.0,1.0,2.0,0.5789473684210527,28.0,7.023553719008262,2.0,4.2,2.0,7.0,1.3,2.1,27.0,1.0,0.0,1.0,11.0,27.0,1.0,HC,56.0,91.0,32.0,23.0,2.0,0.0,10.0,2.5,1297.0,2060.0,32.0,21.0,7.1,6.0,16.0,7.5,7.0,4.0,0.0,1.0,470.0,312.0,10.0,158.0,3.0,2.0,553.0,535.0,18.0,11.0,0.5569259962049335,0.6202127659574468,2.0,23.0,2.2222222222222223,8.0,34.0,6.1,4.9,24.0,2.0,26.0,23.0,2.0,0.6415094339622641,0.8387096774193549,2.0,17.0,0.6842278564372736,0.7148117839607201,1.0,13.0,4156.0,3494.0,19.0,8.0,101.0,757.0,902.0,26.0,13.0,109.0,28.0,24.0,0.06997084548104958,0.09225092250922508,7.0,22.0,5.8,5.1,1.0,9.0,1054.0,940.0,1.0,3.0,73.0,0.0,0.0,16.5,13.5,33.0,10.5,3202.0,3978.0,29.0,18.0,89.0,29.0,20.0,0.0,1.0,27.5,20.5,455.0,260.0,9.5,6.0,2.39,1.51,9.0,3.0,48.0,3.0,107.3,92.5,27.0,1.0,4403.0,9.0,0.45,25.0,0.4430740037950665,0.3797872340425532,31.0,10.0,0.3584905660377359,0.16129032258064513,31.0,16.0,0.3157721435627264,0.2851882160392799,32.0,20.0,467.0,357.0,1.0,9.0,19.0,5.0,1.5,7.5,1918.0,1394.0,2.0,13.0,12.883838383838382,4.0,42.0,28.2,9.0,2.0,1.0,0.0,34.0,5.8,8.2,2.0,12.5,247.0,318.0,1.0,21.0,48.0,1.0,16.5,28.0,26.0,9.5,20.0,26.0,22.0,14.0,11.0,18.0,9.0,11.7,23.0,2.0,24.0,22.5,6.0,9.0,3.0,9.847107438016527,3.0,31584.0,26320.0,3.0,MIN,6074.0,4888.0,6.0,5.0,98.2,96.8,8.0,17.0,55.0,31.0,7.5,2.0,54.0,30.0,6.5,2.0,8.0,7.1,20.0,7.0,4.1,3.9,6.0,21.5,11.7,11.2,13.5,10.0,23.2,22.6,15.0,12.0,9.5,7.9,12.0,11.5,5.8,5.2,13.5,10.0,43.9,44.7,23.0,13.0,32.2,25.9,6.0,8.0,1186.0,4.0,1.951219512195122,1.8205128205128205,7.0,5.0
2010.0,189.0,184.0,14.5,16.5,289.0,276.0,8.0,23.0,159.0,178.0,11.5,26.0,104.0,87.0,9.5,11.5,26.0,11.0,1.5,9.0,2.0,0.0,1.0,0.0,4.1,5.7,17.0,30.0,7047.0,25.0,4.8,6.4,14.0,30.0,33.0,154.0,156.0,17.5,0.3999999999999986,15.0,30.2,29.8,18.0,13.5,305.0,60.4,62.9,21.0,18.0,333.0,20.0,20.0,12.0,21.5,12.333333333333336,9.0,-89.86,-50.2,-21.22,9.0,30.0,-23.58,36.18,12.0,10.0,23.8,11.0,28.0,94.4,78.3,9.5,1.0,0.0,7.0,9.0,2.0,0.0,0.0,7.0,8.0,2.0,0.0,11.0,11.0,14.5,18.5,16.958333333333332,19.0,17.43125,20.0,24.3,30.0,10.5625,10.0,20.0,1.0,2.0,0.55,24.0,19.20922865013774,22.0,20.8,23.5,26.0,5.1,2.8,16.0,32.0,1.0,3.0,15.0,17.5,32.0,HC,64.0,61.0,14.0,14.5,1.0,1.0,21.5,11.0,1427.0,1455.0,18.0,16.0,5.7,6.0,13.5,28.5,23.58333333333333,24.0,0.0,0.0,281.0,348.0,18.0,-67.0,25.0,29.0,505.0,529.0,14.0,21.0,0.5509164969450102,0.5731832139201638,16.0,22.0,1.5288461538461535,28.0,14.0,2.8,4.7,23.0,28.0,25.0,22.0,28.5,0.4666666666666667,0.7142857142857143,12.5,32.0,0.614606072633459,0.6731307477009196,14.0,27.0,3097.0,3367.0,9.0,26.0,100.0,769.0,786.0,17.0,15.0,98.0,20.0,20.0,0.08996539792387544,0.03985507246376811,31.0,10.0,5.3,5.4,10.5,23.0,982.0,977.0,9.5,23.0,83.0,0.0,0.0,16.5,12.5,32.0,12.5,3569.0,3748.0,28.0,11.0,85.0,25.0,10.5,0.0,1.0,26.0,21.0,361.0,241.0,8.5,14.5,1.38,1.63,13.0,28.5,42.0,7.0,67.7,86.4,21.5,30.0,3327.0,27.0,0.6540880503144654,5.0,0.4490835030549898,0.4268167860798362,17.0,11.0,0.5333333333333333,0.2857142857142857,20.5,1.0,0.3853939273665409,0.3268692522990804,19.0,6.0,441.0,417.0,15.0,12.0,16.0,10.0,10.5,7.0,1942.0,1635.0,9.0,10.0,16.71212121212121,20.0,24.9,28.8,9.0,30.0,0.0,0.0,36.0,6.7,5.5,20.5,21.0,230.0,177.0,29.0,19.0,31.0,21.0,17.5,18.0,23.0,6.0,32.0,17.0,18.0,5.0,31.0,37.0,19.0,12.5,20.5,30.0,26.0,18.0,-11.0,29.0,29.5,17.61845730027548,20.0,29106.0,28704.0,18.0,MIN,5039.0,5002.0,8.0,23.0,96.8,100.0,21.0,29.0,31.0,42.0,20.5,25.5,30.0,42.0,20.5,25.5,6.6,6.7,9.0,24.0,4.4,3.9,8.5,8.5,10.9,10.6,5.5,24.0,22.3,23.9,23.0,17.0,8.6,7.5,8.0,21.0,5.1,5.1,9.0,22.0,43.0,44.1,24.0,21.0,26.4,27.2,10.0,23.0,37.0,17.0,1.4999999999999998,1.717948717948718,13.0,26.0
2012.0,191.0,199.0,30.0,10.0,279.0,345.0,27.5,29.0,185.0,203.0,25.0,16.0,71.0,104.0,21.5,28.0,23.0,38.0,32.0,26.0,1.0,0.0,0.0,1.0,4.9,5.8,14.0,28.0,7154.0,17.0,5.6,6.6,14.0,29.0,31.0,142.0,156.0,28.5,0.8999999999999986,13.0,29.0,28.1,18.5,10.0,328.0,58.0,63.0,23.0,25.5,378.0,29.0,18.5,12.0,22.5,18.33333333333333,19.0,-63.47,-33.56,-76.19,20.0,27.0,-20.42,33.52,11.0,15.0,-33.76,15.0,27.0,93.5,83.3,11.5,1.5,0.0,9.0,9.0,6.0,7.0,0.0,8.0,8.0,6.0,7.0,8.0,12.0,10.0,11.5,14.916666666666664,13.0,20.60625,26.0,20.9,24.0,20.3125,22.0,22.0,0.0,0.0,0.3636363636363637,6.0,20.033884297520657,21.0,21.7,21.0,18.0,3.2,2.8,13.0,27.0,2.0,2.0,17.0,11.5,26.5,OC,50.0,43.0,17.0,7.5,0.0,0.0,11.5,22.5,1269.0,853.0,10.0,5.0,5.7,6.1,15.5,25.0,23.91666666666667,27.0,0.0,0.0,302.0,368.0,19.0,-66.0,24.0,24.0,566.0,600.0,27.5,13.5,0.6032064128256514,0.582648401826484,17.0,11.0,2.605633802816901,7.0,16.0,2.8,4.5,18.0,28.5,27.0,21.5,28.0,0.5714285714285714,0.6585365853658537,18.0,22.0,0.6831742243436754,0.6739391857069232,11.0,14.0,3435.0,3923.0,25.0,19.0,113.0,1005.0,1008.0,29.0,31.0,120.0,28.0,28.0,0.08243727598566307,0.11014492753623188,4.0,19.0,5.4,5.6,12.0,25.5,998.0,1095.0,31.0,22.0,90.0,0.0,0.0,16.5,9.0,34.0,15.0,3766.0,0.0,16.5,11.0,88.0,25.5,3.0,1.0,1.0,23.5,9.0,606.0,343.0,15.0,1.0,1.48,1.74,14.0,25.0,41.0,9.5,73.5,86.6,16.0,29.0,3668.0,20.0,0.3837837837837838,26.0,0.3967935871743487,0.417351598173516,16.0,22.0,0.4285714285714286,0.3414634146341463,15.0,11.0,0.31682577565632464,0.3260608142930768,22.0,19.0,396.0,457.0,23.5,24.0,12.0,14.0,21.5,15.0,1593.0,1898.0,19.0,24.0,11.015151515151516,2.0,29.8,30.7,10.0,25.0,0.0,0.0,36.0,6.0,6.0,18.5,13.0,233.0,233.0,16.0,16.5,38.0,12.5,16.0,31.0,24.0,2.5,19.5,29.0,20.0,3.0,10.5,26.0,12.0,14.6,7.0,14.0,29.0,9.5,3.0,12.5,19.5,18.367768595041326,21.0,27122.0,31044.0,30.0,CLE,5028.0,5821.0,23.0,25.0,100.0,100.0,19.0,14.0,29.0,42.0,21.0,25.5,29.0,42.0,21.0,25.5,6.5,6.9,13.5,27.0,4.0,4.2,15.5,21.0,11.2,11.0,9.5,25.0,25.4,19.8,2.0,8.0,14.8,10.1,20.5,3.0,5.0,5.3,15.5,27.0,41.8,0.0,16.5,31.0,26.2,29.3,14.0,28.0,-793.0,29.0,1.625,1.6428571428571428,19.5,22.0
2016.0,186.0,191.0,17.0,17.0,305.0,342.0,25.0,23.5,197.0,209.0,23.0,19.0,86.0,102.0,26.5,22.0,22.0,31.0,16.5,29.0,2.0,0.0,2.0,1.0,6.5,5.8,9.0,14.5,7197.0,5.0,7.2,6.3,4.5,16.0,42.0,166.0,165.0,7.0,3.2,4.0,29.9,26.7,5.5,6.0,365.0,66.8,58.5,2.0,7.0,350.0,15.0,17.0,32.0,1.5,15.916666666666664,15.0,33.53,70.4,-29.04,6.0,18.0,-24.46,8.3,21.0,19.0,-5.71,9.0,17.0,88.6,83.3,10.0,6.0,0.0,9.0,17.0,7.0,2.0,0.0,8.0,15.0,6.0,2.0,9.0,15.0,1.0,17.5,10.666666666666666,6.0,15.7125,16.0,15.55,18.0,15.875,16.0,18.0,1.0,0.0,0.5,23.0,11.982782369146006,7.0,9.5,7.0,8.0,1.5,3.0,5.0,8.5,4.0,1.0,18.0,2.0,8.0,OC,40.0,35.0,19.0,4.0,1.0,0.0,13.0,4.0,943.0,843.0,24.0,4.0,6.5,6.3,16.5,15.0,16.166666666666668,14.0,0.0,0.0,389.0,311.0,7.0,78.0,4.0,13.0,546.0,598.0,27.0,25.0,0.5838383838383838,0.5888993414863594,19.0,20.0,2.2906976744186047,15.0,19.0,3.5,3.8,12.0,22.5,23.0,15.0,24.5,0.5588235294117647,0.696969696969697,13.0,27.0,0.6814868804664723,0.671302578018996,23.0,21.0,3740.0,3958.0,18.0,19.0,109.0,848.0,797.0,4.0,9.5,109.0,18.5,18.5,0.07213114754098361,0.09064327485380116,20.0,28.0,5.8,6.1,27.5,16.0,990.0,1063.0,28.0,27.0,76.0,0.0,0.0,13.0,13.5,30.0,14.0,3427.0,3076.0,12.0,12.0,69.0,10.0,14.0,2.0,0.0,12.0,2.0,592.0,157.0,6.0,1.0,1.87,1.7,7.5,16.5,40.0,5.5,93.2,79.8,3.0,15.0,3914.0,21.5,0.4365482233502538,18.0,0.4161616161616162,0.41110065851364064,14.0,13.0,0.4411764705882353,0.303030303030303,20.0,6.0,0.3185131195335277,0.32869742198100405,10.0,12.0,412.0,437.0,24.0,14.0,15.0,10.0,7.0,13.5,1748.0,1938.0,26.0,15.0,10.26262626262626,4.0,36.6,33.5,10.0,15.0,1.0,0.0,32.0,5.5,4.5,30.5,14.5,174.0,162.0,30.0,6.0,28.0,28.0,11.5,35.0,30.0,12.5,10.0,31.0,25.0,11.5,7.5,17.0,9.7,15.7,1.0,10.0,33.0,1.0,16.0,1.5,9.0,14.465564738292013,9.0,30876.0,31515.0,10.0,KC,5488.0,5896.0,24.0,20.0,92.3,100.0,30.0,20.0,39.0,30.0,7.0,13.0,36.0,30.0,9.0,14.5,7.2,6.9,12.5,16.0,4.2,4.4,22.0,16.5,10.7,11.8,23.5,25.5,23.6,24.1,29.0,9.0,14.8,5.2,3.0,1.0,5.5,5.5,15.5,16.5,45.1,44.6,11.0,19.0,30.6,32.8,24.0,16.0,-408.0,28.0,1.7142857142857142,1.5681818181818181,28.0,17.0
