Year,#Dr,#Dr_Defense,#Dr_Defense_Low_Rank,#Dr_High_Rank,1stD,1stD_Defense,1stD_Defense_Low_Rank,1stD_High_Rank,1stDpass,1stDpass_Defense,1stDpass_Defense_Low_Rank,1stDpass_High_Rank,1stDrun,1stDrun_Defense,1stDrun_Defense_Low_Rank,1stDrun_High_Rank,1stPy,1stPy_Defense,1stPy_Defense_Low_Rank,1stPy_High_Rank,2PA,2PA_Defense,2PM,2PM_Defense,ANY/A,ANY/A_Defense,ANY/A_Defense_Low_Rank,ANY/A_High_Rank,APYd,APYd_High_Rank,AY/A,AY/A_Defense,AY/A_Defense_Low_Rank,AY/A_High_Rank,AllTD,AvgDriveTime,AvgDriveTime_Defense,AvgDriveTime_Defense_Low_Rank,AvgDriveTime_High_Rank,AvgFieldPositionDifferential,AvgFieldPositionDifferential_High_Rank,AvgStartingPosition,AvgStartingPosition_Defense,AvgStartingPosition_Defense_Low_Rank,AvgStartingPosition_High_Rank,Cmp,Cmp%,Cmp%_Defense,Cmp%_Defense_Low_Rank,Cmp%_High_Rank,Cmp_Defense,Cmp_Defense_Low_Rank,Cmp_High_Rank,DefensivePtsScored,DefensivePtsScored_High_Rank,Dscore,Dscore_Rank,ExpectedPoints,ExpectedPointsPassing,ExpectedPointsPassing_Defense,ExpectedPointsPassing_Defense_High_Rank,ExpectedPointsPassing_High_Rank,ExpectedPointsRunning,ExpectedPointsRunning_Defense,ExpectedPointsRunning_Defense_High_Rank,ExpectedPointsRunning_High_Rank,ExpectedPoints_Defense,ExpectedPoints_Defense_High_Rank,ExpectedPoints_High_Rank,FG%,FG%_Defense,FG%_Defense_Low_Rank,FG%_High_Rank,FGA019,FGA2029,FGA3039,FGA4049,FGA50Plus,FGM019,FGM2029,FGM3039,FGM4049,FGM50Plus,FL,FL_Defense,FL_Defense_High_Rank,FL_Low_Rank,FantasyDstScore,FantasyDstScore_Rank,FantasyOffenseScore,FantasyOffenseScore_Rank,FantasyPassScore,FantasyPassScore_Rank,FantasyRushScore,FantasyRushScore_Rank,Fmb,FmbTD,FmbTD_Defense,Fmb_Low_Rank,FumbleLostPercent,FumbleLostPercent_Low_Rank,GameControlPlusBalance,GameControlPlusBalance_Rank,GameControlScore,GameControlScore_Rank,Int,Int%,Int%_Defense,Int%_Defense_High_Rank,Int%_Low_Rank,IntTD,IntTD_Defense,Int_Defense,Int_Defense_High_Rank,Int_Low_Rank,Job,KickRet,KickRet_Defense,KickRet_Defense_Low_Rank,KickRet_High_Rank,KrTD,KrTD_Defense,KrTD_Defense_Low_Rank,KrTD_High_Rank,KrYds,KrYds_Defense,KrYds_Defense_Low_Rank,KrYds_High_Rank,NY/A,NY/A_Defense,NY/A_Defense_Low_Rank,NY/A_High_Rank,Oscore,Oscore_Rank,OthTD,OthTD_Defense,PF,PF_Defense,PF_Defense_Low_Rank,PF_Differential,PF_Differential_High_Rank,PF_High_Rank,PassAtt,PassAtt_Defense,PassAtt_Defense_Low_Rank,PassAtt_High_Rank,PassPercent,PassPercent_Defense,PassPercent_Defense_High_Rank,PassPercent_High_Rank,PassRun1dRatio,PassRun1dRatio_High_Rank,PassTD,PassTD%,PassTD%_Defense,PassTD%_Defense_Low_Rank,PassTD%_High_Rank,PassTD_Defense,PassTD_Defense_Low_Rank,PassTD_High_Rank,PassTdPercent,PassTdPercent_Defense,PassTdPercent_Defense_High_Rank,PassTdPercent_High_Rank,PassYdPercent,PassYdPercent_Defense,PassYdPercent_Defense_High_Rank,PassYdPercent_High_Rank,PassYds,PassYds_Defense,PassYds_Defense_Low_Rank,PassYds_High_Rank,Pen,PenYds,PenYds_Defense,PenYds_Defense_Low_Rank,PenYds_Low_Rank,Pen_Defense,Pen_Defense_Low_Rank,Pen_Low_Rank,Penalty1dPercent,Penalty1dPercent_Defense,Penalty1dPercent_Defense_High_Rank,Penalty1dPercent_High_Rank,Plays/Drive,Plays/Drive_Defense,Plays/Drive_Defense_Low_Rank,Plays/Drive_High_Rank,Ply,Ply_Defense,Ply_Defense_Low_Rank,Ply_High_Rank,Pnt,PntBlck,PntBlck_Defense,PntBlck_Defense_Low_Rank,PntBlck_Low_Rank,PntRet_Defense,PntRet_Defense_Low_Rank,PntYds,PntYds_Defense,PntYds_Defense_Low_Rank,PntYds_High_Rank,Pnt_Defense,Pnt_Defense_Low_Rank,Pnt_High_Rank,PrTD,PrTD_Defense,PrTD_Defense_Low_Rank,PrTD_High_Rank,PrYds,PrYds_Defense,PrYds_Defense_Low_Rank,PrYds_High_Rank,Pts/Drive,Pts/Drive_Defense,Pts/Drive_Defense_Low_Rank,Pts/Drive_High_Rank,PuntRet,PuntRet_High_Rank,QbRating,QbRating_Defense,QbRating_Defense_Low_Rank,QbRating_High_Rank,RawPassYds,RawPassYds_High_Rank,RunPass1dRatio,RunPass1dRatio_High_Rank,RunPercent,RunPercent_Defense,RunPercent_Defense_High_Rank,RunPercent_High_Rank,RunTdPercent,RunTdPercent_Defense,RunTdPercent_Defense_High_Rank,RunTdPercent_High_Rank,RunYdPercent,RunYdPercent_Defense,RunYdPercent_Defense_High_Rank,RunYdPercent_High_Rank,RushAtt,RushAtt_Defense,RushAtt_Defense_Low_Rank,RushAtt_High_Rank,RushTD,RushTD_Defense,RushTD_Defense_Low_Rank,RushTD_High_Rank,RushYds,RushYds_Defense,RushYds_Defense_Low_Rank,RushYds_High_Rank,STscore,STscore_Rank,Sc%,Sc%_Defense,Sc%_Defense_Low_Rank,Sc%_High_Rank,Sfty,Sfty_Defense,Sk,Sk%,Sk%_Defense,Sk%_Defense_High_Rank,Sk%_Low_Rank,SkYds,SkYds_Defense,SkYds_Defense_High_Rank,SkYds_Low_Rank,Sk_Defense,Sk_Defense_High_Rank,Sk_Low_Rank,TFGA,TFGA_Defense,TFGA_Defense_Low_Rank,TFGA_High_Rank,TFGM,TFGM_Defense,TFGM_Defense_Low_Rank,TFGM_High_Rank,TO,TO%,TO%_Defense,TO%_Defense_High_Rank,TO%_Low_Rank,TO_Defense,TO_Defense_High_Rank,TO_Differential,TO_Differential_High_Rank,TO_Low_Rank,ThreePhaseScore,ThreePhaseScore_Rank,TimeOfPossession,TimeOfPossession_Defense,TimeOfPossession_High_Rank,Tm,TotalYds,TotalYds_Defense,TotalYds_Defense_Low_Rank,TotalYds_High_Rank,XP%,XP%_Defense,XP%_Defense_Low_Rank,XP%_High_Rank,XPA,XPA_Defense,XPA_Defense_Low_Rank,XPA_High_Rank,XPM,XPM_Defense,XPM_Defense_Low_Rank,XPM_High_Rank,Y/Apass,Y/Apass_Defense,Y/Apass_Defense_Low_Rank,Y/Apass_High_Rank,Y/Arun,Y/Arun_Defense,Y/Arun_Defense_Low_Rank,Y/Arun_High_Rank,Y/C,Y/C_Defense,Y/C_Defense_Low_Rank,Y/C_High_Rank,Y/KR,Y/KR_Defense,Y/KR_Defense_Low_Rank,Y/KR_High_Rank,Y/PR,Y/PR_Defense,Y/PR_Defense_Low_Rank,Y/PR_High_Rank,Y/Play,Y/Play_Defense,Y/Play_Defense_Low_Rank,Y/Play_High_Rank,Y/Pnt,Y/Pnt_Defense,Y/Pnt_Defense_Low_Rank,Y/Pnt_High_Rank,Yds/Drive,Yds/Drive_Defense,Yds/Drive_Defense_Low_Rank,Yds/Drive_High_Rank,Yds_Differential,Yds_Differential_High_Rank,YppYprRatio,YppYprRatio_Defense,YppYprRatio_Defense_High_Rank,YppYprRatio_High_Rank
1997.0,,,,,288.0,292.0,17.5,19.0,136.0,193.0,27.0,27.0,130.0,79.0,3.0,3.0,22.0,20.0,9.5,18.5,4.0,0.0,2.0,0.0,4.9,6.0,26.5,21.0,6651.0,27.0,5.8,6.8,24.0,22.0,36.0,,,,,,,,,,,220.0,52.4,59.1,23.0,26.0,321.0,23.0,30.0,24.0,12.0,16.166666666666668,16.0,,,,,,,,,,,,,77.1,73.3,10.0,18.0,2.0,6.0,11.0,14.0,2.0,2.0,6.0,10.0,7.0,2.0,13.0,18.0,1.0,17.0,17.25,17.0,13.775,13.0,21.8,28.0,5.75,4.0,31.0,2.0,2.0,23.5,0.41935483870967744,10.0,,,,,13.0,3.1,2.6,21.5,19.0,2.0,0.0,14.0,19.0,13.0,DC,58.0,71.0,22.0,20.0,0.0,0.0,9.5,21.5,1150.0,1528.0,20.0,26.0,5.5,6.3,28.0,19.5,14.916666666666664,15.0,0.0,0.0,333.0,310.0,12.0,23.0,13.0,14.0,420.0,543.0,21.5,29.0,0.4551863041289023,0.5826612903225806,6.0,30.0,1.0461538461538462,29.0,15.0,3.6,3.9,13.0,17.0,21.0,16.0,25.0,0.46875,0.6363636363636364,15.0,30.0,0.5092498475299858,0.6992926782641943,3.0,30.0,2505.0,3658.0,27.0,29.0,103.0,814.0,830.0,14.0,13.0,94.0,9.0,17.0,0.0763888888888889,0.0684931506849315,20.0,17.0,,,,,993.0,992.0,9.0,25.0,74.0,0.0,0.0,15.5,9.0,36.0,8.0,3081.0,3008.0,5.0,25.0,69.0,4.5,25.0,0.0,0.0,10.0,20.5,244.0,430.0,17.0,26.0,,,,,32.0,25.0,71.6,83.4,22.0,21.0,2704.0,29.0,0.9558823529411764,2.0,0.5448136958710976,0.4173387096774194,25.0,1.0,0.53125,0.3636363636363637,16.0,1.0,0.4907501524700142,0.3007073217358057,28.0,1.0,541.0,414.0,6.0,2.0,17.0,12.0,14.0,7.0,2414.0,1573.0,4.0,3.0,21.962962962962965,28.0,0.0,0.0,15.5,15.5,0.0,0.0,32.0,7.1,6.1,25.5,14.5,199.0,240.0,23.0,6.0,35.0,24.5,6.5,35.0,30.0,15.0,9.0,27.0,22.0,12.0,8.0,26.0,0.0,0.0,15.5,15.5,32.0,7.0,6.0,9.0,15.0,17.292929292929294,21.0,,,,TEN,4919.0,5231.0,22.0,18.0,100.0,100.0,20.5,11.0,32.0,34.0,15.5,20.0,32.0,34.0,17.0,19.5,6.4,7.2,25.5,21.0,4.5,3.8,10.5,4.0,12.3,12.1,18.5,11.5,19.8,21.5,12.0,28.0,7.6,11.9,27.0,24.5,5.0,5.3,27.0,14.0,41.6,43.6,22.0,26.0,,,,,-312.0,20.0,1.4222222222222225,1.8947368421052635,5.5,28.0
1998.0,157.0,163.0,5.0,28.0,308.0,279.0,10.0,9.5,171.0,170.0,18.0,13.5,118.0,81.0,9.0,4.0,19.0,28.0,17.5,28.0,4.0,0.0,1.0,4.0,5.7,6.4,26.5,10.0,6900.0,21.0,6.5,7.1,26.0,12.0,32.0,177.0,155.0,18.5,1.0,-3.5,24.0,26.8,30.3,10.5,29.0,305.0,58.8,62.4,29.0,9.0,319.0,24.0,10.5,24.0,8.5,17.583333333333332,19.0,,,,,,,,,,,,,90.0,83.3,18.5,3.0,1.0,8.0,15.0,16.0,0.0,1.0,8.0,15.0,12.0,0.0,9.0,7.0,26.0,10.0,19.916666666666668,26.0,10.8125,9.0,12.25,14.0,9.375,9.0,25.0,2.0,0.0,17.5,0.36,4.0,14.8506734006734,13.0,16.4,16.0,10.0,1.9,2.3,27.5,2.0,2.0,1.0,12.0,27.0,2.0,DC,56.0,55.0,8.5,24.5,0.0,0.0,9.5,22.5,1148.0,1114.0,4.0,28.0,5.9,6.5,25.5,14.0,8.75,9.0,0.0,0.0,330.0,320.0,12.0,10.0,13.0,13.0,519.0,511.0,14.0,16.5,0.5452755905511811,0.5664921465968586,14.0,20.0,1.4491525423728813,24.0,16.0,3.1,4.7,22.5,24.5,24.0,21.5,24.0,0.5714285714285714,0.7272727272727273,7.0,22.0,0.6255464740543623,0.6856082796328842,8.0,20.0,3291.0,3511.0,20.0,15.0,126.0,1135.0,704.0,2.0,27.0,93.0,2.0,25.0,0.06168831168831169,0.1003584229390681,9.0,29.0,6.1,5.6,22.0,1.0,1016.0,955.0,5.0,12.5,69.0,0.0,0.0,15.5,11.5,34.0,10.5,3258.0,3189.0,7.0,22.0,74.0,6.5,25.0,0.0,0.0,7.5,21.0,280.0,332.0,12.5,26.0,1.66,1.71,20.5,10.5,38.0,18.0,81.3,90.0,28.0,12.0,3482.0,18.0,0.6900584795321637,7.0,0.4547244094488189,0.43350785340314135,17.0,11.0,0.4285714285714286,0.2727272727272727,24.0,9.0,0.37445352594563774,0.3143917203671158,23.0,11.0,462.0,414.0,10.0,11.0,12.0,9.0,8.5,13.5,1970.0,1610.0,9.5,9.0,13.660493827160494,9.0,35.0,33.1,23.0,8.0,0.0,2.0,35.0,6.3,5.5,29.0,11.0,191.0,172.0,30.0,7.0,30.0,27.5,11.0,40.0,30.0,13.5,2.0,36.0,25.0,18.0,1.0,19.0,10.2,8.0,29.0,4.0,19.0,28.5,0.0,15.0,2.0,13.301346801346801,11.0,27789.0,25265.0,17.0,TEN,5261.0,5121.0,16.0,9.0,100.0,100.0,21.0,9.0,28.0,29.0,5.5,22.5,28.0,29.0,8.0,21.0,6.7,7.2,23.5,16.5,4.3,3.9,13.5,5.0,11.4,11.5,6.0,24.5,20.5,20.3,9.0,24.0,7.4,9.8,15.0,26.0,5.2,5.4,26.5,11.0,47.2,43.1,16.5,1.0,30.4,28.8,25.0,4.0,140.0,13.0,1.5581395348837208,1.8461538461538465,9.0,24.0
1999.0,201.0,197.0,18.0,11.0,294.0,300.0,18.0,16.0,167.0,193.0,28.5,20.0,109.0,81.0,10.0,9.0,18.0,26.0,19.5,27.0,3.0,0.0,1.0,4.0,6.1,5.7,21.5,6.5,6929.0,22.0,6.6,6.8,26.5,8.5,46.0,150.0,139.0,7.0,13.0,4.299999999999997,4.0,32.4,28.1,2.0,13.0,304.0,57.7,56.0,13.5,15.0,312.0,15.5,17.0,26.0,8.5,15.583333333333336,15.0,,,,,,,,,,,,,84.0,68.2,3.0,10.0,1.0,8.0,9.0,6.0,1.0,1.0,8.0,7.0,4.0,1.0,9.0,24.0,1.0,6.0,11.833333333333336,7.0,9.7625,5.0,9.9,9.0,9.625,8.0,17.0,2.0,1.0,1.5,0.5294117647058824,20.0,11.035858585858588,6.0,7.9,4.0,13.0,2.5,2.9,20.0,2.5,1.0,2.0,16.0,18.0,2.5,DC,56.0,76.0,24.5,26.0,0.0,2.0,30.0,21.0,1042.0,1596.0,27.0,29.0,6.3,6.0,18.5,6.5,10.583333333333334,8.0,0.0,0.0,392.0,324.0,15.0,68.0,6.5,7.0,527.0,557.0,18.5,21.0,0.5459940652818991,0.6146881287726358,4.0,23.0,1.5321100917431192,23.0,23.0,4.4,4.7,26.5,9.5,26.0,27.5,9.5,0.5476190476190477,0.7647058823529411,5.0,26.0,0.6580438066465257,0.7044804575786463,7.0,18.0,3485.0,3695.0,25.0,13.5,114.0,1069.0,1010.0,27.0,30.0,128.0,29.5,23.0,0.061224489795918366,0.08666666666666667,13.0,29.0,5.2,5.2,12.5,23.0,1011.0,994.0,12.0,19.0,90.0,0.0,0.0,16.0,12.5,45.0,24.5,3824.0,3432.0,15.0,9.0,80.0,13.5,7.0,1.0,0.0,9.5,8.5,358.0,335.0,12.0,18.0,1.78,1.44,12.0,8.0,40.0,17.0,83.1,82.3,19.5,8.0,3622.0,18.0,0.6526946107784432,9.0,0.4540059347181009,0.3853118712273642,28.0,9.0,0.4523809523809523,0.2352941176470589,27.0,6.0,0.3419561933534743,0.2955195424213537,25.0,14.0,459.0,383.0,4.0,12.0,19.0,8.0,8.0,3.0,1811.0,1550.0,10.0,13.0,17.074074074074076,21.0,31.3,24.9,6.0,11.0,4.0,2.0,25.0,4.5,8.8,3.0,2.5,137.0,305.0,5.0,2.0,54.0,3.0,3.0,25.0,22.0,2.0,28.0,21.0,15.0,1.0,21.5,22.0,10.9,18.3,4.5,4.0,40.0,4.0,18.0,2.0,3.0,14.171717171717177,9.0,30150.0,27383.0,10.0,TEN,5296.0,5245.0,17.0,13.0,100.0,100.0,21.5,10.5,43.0,33.0,15.0,7.0,43.0,33.0,15.5,7.0,6.9,7.2,27.0,11.0,3.9,4.0,21.0,18.0,11.9,12.8,27.0,15.0,18.6,21.0,14.0,31.0,9.0,7.4,8.5,17.5,5.2,5.3,25.5,9.0,42.5,42.9,26.0,9.5,26.2,26.4,17.0,14.5,51.0,17.0,1.7692307692307694,1.8,11.0,15.0
2000.0,194.0,188.0,12.0,11.5,299.0,215.0,1.0,16.0,167.0,134.0,1.5,19.0,107.0,62.0,2.5,13.5,25.0,19.0,6.0,18.0,0.0,0.0,0.0,0.0,5.9,3.6,2.5,8.0,7411.0,12.0,6.6,4.7,4.5,11.5,38.0,168.0,134.0,3.0,1.0,4.700000000000003,4.0,33.7,29.0,4.0,5.0,286.0,61.9,51.9,2.0,6.0,242.0,1.0,22.0,30.0,5.5,4.083333333333333,2.0,-48.66,28.01,117.4,2.0,11.0,-72.61,87.71,3.0,28.0,208.33,2.0,15.0,79.4,77.3,14.0,17.0,0.0,15.0,8.0,9.0,2.0,0.0,13.0,7.0,6.0,1.0,14.0,13.0,15.0,22.0,6.5,1.0,14.09375,14.0,15.5,18.0,12.6875,13.0,24.0,1.0,0.0,14.0,0.5833333333333334,24.0,7.703872053872054,3.0,5.3,3.5,16.0,3.5,3.6,11.0,18.0,4.0,3.0,17.0,15.0,16.0,DC,47.0,76.0,27.5,30.0,0.0,0.0,10.5,22.5,1227.0,1587.0,23.0,25.0,6.7,4.7,1.0,6.5,15.25,15.0,0.0,0.0,346.0,191.0,2.0,155.0,3.0,13.0,462.0,466.0,5.0,26.0,0.472007722007722,0.5737885462555066,15.0,31.0,1.5607476635514017,22.0,18.0,3.9,2.1,2.5,14.0,10.0,1.0,20.5,0.5625,0.5882352941176471,19.0,22.0,0.6104672897196262,0.6354576448990297,23.0,23.0,3266.0,2423.0,1.0,16.0,107.0,870.0,778.0,9.0,18.0,97.0,11.0,21.0,0.08361204013377926,0.08837209302325581,14.0,17.0,5.5,4.9,2.0,17.0,1036.0,908.0,1.0,11.0,76.0,0.0,0.0,16.0,10.0,28.0,6.0,3101.0,4484.0,31.0,19.0,105.0,31.0,20.0,1.0,0.0,10.5,8.0,671.0,160.0,4.0,2.0,1.57,0.9,2.0,15.0,53.0,1.0,83.2,62.0,2.0,11.0,3430.0,18.5,0.6407185628742516,10.0,0.527992277992278,0.42621145374449343,17.0,1.0,0.4375,0.4117647058823529,13.0,10.0,0.3895327102803737,0.3645423551009703,9.0,9.0,547.0,387.0,6.0,1.0,14.0,7.0,3.0,14.0,2084.0,1390.0,3.0,7.0,11.283950617283953,5.0,30.4,18.1,2.0,16.0,0.0,0.0,27.0,5.5,10.6,2.0,8.5,164.0,338.0,2.0,6.0,55.0,2.5,4.0,34.0,22.0,2.0,7.0,27.0,17.0,3.5,8.5,30.0,14.9,13.8,17.5,18.5,30.0,14.5,0.0,16.5,19.0,10.107744107744107,2.0,32592.0,25192.0,1.0,TEN,5350.0,3813.0,1.0,14.0,97.4,100.0,19.5,25.0,38.0,20.0,2.5,9.5,37.0,20.0,2.5,11.0,7.4,5.9,2.0,7.0,3.8,3.6,5.0,23.0,12.0,11.4,15.5,10.0,26.1,20.9,5.5,2.0,12.7,5.7,3.0,6.0,5.2,4.2,1.0,10.0,40.8,42.7,25.0,19.0,27.4,20.1,1.0,12.5,1537.0,2.0,1.947368421052632,1.6388888888888888,18.0,5.0
2001.0,184.0,182.0,5.5,23.5,287.0,302.0,25.0,19.0,180.0,154.0,5.0,11.5,75.0,122.0,29.0,28.0,32.0,26.0,24.0,1.0,7.0,0.0,1.0,0.0,4.8,6.4,26.5,22.0,7289.0,14.0,5.7,7.4,27.0,20.0,31.0,152.0,164.0,28.5,15.0,-9.700000000000003,31.0,26.9,36.6,31.0,31.0,327.0,58.7,62.7,29.0,16.0,284.0,5.0,7.5,18.0,17.0,25.5,28.0,-74.07,-23.38,-52.87,26.0,21.0,-32.23,-17.14,31.0,13.0,-65.3,28.0,23.0,62.1,75.7,15.0,30.0,0.0,10.0,4.0,15.0,0.0,0.0,10.0,2.0,6.0,0.0,13.0,8.0,28.0,19.0,22.66666666666667,28.0,17.98125,24.0,13.9,15.0,22.0625,26.5,26.0,0.0,3.0,15.5,0.5,21.0,23.900336700336695,30.0,26.4,30.0,20.0,3.6,2.4,27.0,18.5,3.0,2.0,11.0,29.0,21.0,HC,83.0,52.0,2.0,3.0,0.0,0.0,11.5,20.0,1651.0,987.0,3.0,6.0,5.7,6.5,24.5,17.0,17.916666666666668,20.0,0.0,0.0,265.0,420.0,29.0,-155.0,30.0,27.0,557.0,453.0,2.0,8.0,0.5976214073339939,0.5025799793601651,31.0,6.0,2.4,3.0,18.0,3.2,5.1,27.0,23.5,23.0,21.0,19.0,0.6666666666666666,0.5348837209302325,27.0,9.5,0.6717928752189994,0.5969387755102041,27.0,12.0,3451.0,3159.0,13.0,12.0,123.0,954.0,835.0,21.0,28.0,93.0,13.5,31.0,0.11149825783972124,0.08609271523178808,13.0,1.0,5.6,5.5,20.0,7.5,1009.0,969.0,8.0,16.0,80.0,0.0,0.0,16.0,12.0,40.0,20.0,3262.0,2845.0,1.0,19.0,66.0,1.0,18.0,1.0,0.0,10.0,6.5,225.0,418.0,19.0,30.0,1.32,2.12,30.0,25.0,24.0,30.0,74.7,92.2,29.0,22.0,3722.0,11.0,0.4166666666666667,29.0,0.402378592666006,0.4974200206398349,1.0,26.0,0.33333333333333337,0.4651162790697675,5.0,22.5,0.32820712478100056,0.4030612244897959,5.0,20.0,406.0,482.0,27.0,26.0,9.0,20.0,29.5,24.0,1686.0,2133.0,26.0,22.0,20.580246913580247,28.0,24.5,39.0,29.0,27.5,0.0,0.0,46.0,7.6,7.0,18.0,20.0,271.0,219.0,22.0,20.0,34.0,21.0,22.5,29.0,37.0,29.0,21.5,18.0,28.0,27.0,28.0,33.0,16.8,9.3,30.0,24.5,19.0,30.0,-14.0,29.0,20.0,21.400673400673398,29.0,27968.0,29848.0,25.0,BUF,5137.0,5292.0,21.0,13.0,95.8,100.0,22.5,27.5,24.0,48.0,29.0,27.0,23.0,48.0,29.0,28.0,6.7,7.5,26.0,18.5,4.2,4.4,23.5,11.5,11.4,11.9,21.5,19.0,19.9,19.0,4.0,26.5,9.4,10.5,22.0,17.0,5.1,5.5,26.5,15.0,40.8,43.1,25.0,23.5,27.9,28.9,25.0,8.0,-155.0,17.0,1.5952380952380951,1.7045454545454544,13.5,21.0
2002.0,184.0,188.0,17.0,22.0,355.0,303.0,17.0,3.0,218.0,160.0,9.5,3.0,90.0,107.0,19.5,23.0,47.0,36.0,31.0,1.0,2.0,0.0,0.0,1.0,5.7,5.9,24.5,13.0,7561.0,13.0,6.8,6.7,24.5,5.0,44.0,163.0,150.0,12.5,9.5,-3.5999999999999983,29.0,29.7,33.3,26.0,29.0,377.0,61.6,56.8,7.0,10.5,281.0,2.5,4.0,12.0,20.0,21.58333333333333,22.0,23.79,68.93,-34.99,21.0,9.0,-32.49,-0.18,28.0,18.0,-27.36,23.0,12.0,75.8,73.1,9.0,21.0,0.0,8.0,10.0,10.0,5.0,0.0,7.0,8.0,7.0,3.0,16.0,9.0,25.5,25.0,24.08333333333333,30.0,13.8,16.0,7.35,2.0,20.25,20.0,29.0,1.0,2.0,24.5,0.5517241379310345,26.0,18.947474747474747,24.0,20.4,23.5,15.0,2.5,2.0,27.5,8.5,1.0,1.0,10.0,27.5,14.0,HC,71.0,76.0,26.0,15.0,1.0,2.0,30.5,9.0,1405.0,1634.0,22.0,20.0,6.0,5.8,13.5,14.5,12.916666666666664,13.0,0.0,0.0,379.0,397.0,27.0,-18.0,20.0,11.0,612.0,495.0,4.0,3.0,0.6318785578747628,0.5265265265265265,29.0,2.0,2.4222222222222216,2.0,24.0,3.9,4.8,28.5,18.5,24.0,23.0,12.0,0.5853658536585366,0.5454545454545454,25.0,19.0,0.7145412269719191,0.5910580073231837,31.0,4.0,3995.0,3067.0,6.0,5.0,112.0,1031.0,1053.0,32.0,30.0,117.0,29.0,24.5,0.1323943661971831,0.1188118811881188,2.0,2.0,5.9,5.5,14.0,6.0,1054.0,999.0,14.0,9.5,67.0,1.0,0.0,16.5,21.5,29.0,10.0,2887.0,2833.0,10.0,16.0,71.0,11.5,22.0,0.0,0.0,10.5,24.5,157.0,294.0,15.0,31.0,1.97,1.94,27.0,8.0,30.0,23.0,86.0,84.7,23.0,7.5,4364.0,3.0,0.4128440366972477,31.0,0.3681214421252372,0.4734734734734735,4.0,31.0,0.41463414634146345,0.4545454545454546,8.0,14.0,0.2854587730280809,0.4089419926768163,2.0,29.0,388.0,473.0,23.0,29.0,17.0,20.0,31.0,9.5,1596.0,2122.0,29.0,24.0,18.14814814814815,21.0,35.9,33.5,21.0,9.0,0.0,0.0,54.0,8.1,5.9,21.0,27.5,369.0,212.0,23.0,30.0,31.0,25.0,30.5,33.0,26.0,8.5,9.5,25.0,19.0,7.0,12.5,31.0,15.8,10.1,31.0,22.5,19.0,32.0,-12.0,28.0,20.0,17.494949494949495,22.0,29992.0,28200.0,12.0,BUF,5591.0,5189.0,15.0,11.0,100.0,95.7,2.0,11.0,40.0,46.0,28.5,9.0,40.0,44.0,28.0,9.0,7.1,6.6,13.0,10.0,4.1,4.5,25.0,18.0,11.6,11.7,22.5,11.0,19.8,21.5,13.5,30.0,5.2,10.1,18.5,30.0,5.3,5.2,18.5,13.0,43.1,39.9,9.0,4.0,30.3,27.4,12.5,9.0,402.0,13.0,1.7317073170731707,1.4666666666666666,25.0,11.5
2003.0,187.0,193.0,22.0,20.5,268.0,270.0,5.5,24.0,150.0,153.0,6.0,22.0,96.0,92.0,12.5,21.0,22.0,25.0,16.0,24.5,2.0,0.0,0.0,2.0,3.9,4.8,12.0,28.0,6363.0,31.0,5.0,5.6,13.0,25.5,27.0,153.0,151.0,11.5,18.0,-3.2,29.0,30.3,33.5,30.0,25.5,293.0,58.4,56.1,7.0,18.0,285.0,7.5,22.0,24.0,9.0,8.75,6.0,-134.59,-83.78,29.93,10.0,27.0,-39.33,38.77,11.0,20.0,77.5,10.0,29.0,70.8,74.2,9.0,27.0,0.0,12.0,3.0,7.0,2.0,0.0,11.0,3.0,3.0,0.0,17.0,8.0,27.5,29.0,13.666666666666664,8.0,21.5,29.0,22.0,27.5,21.0,21.0,36.0,1.0,0.0,31.0,0.4722222222222222,17.0,20.294781144781147,22.0,23.3,24.0,17.0,3.4,2.0,30.0,17.0,2.0,1.0,10.0,30.5,16.0,HC,63.0,55.0,5.0,23.0,0.0,0.0,11.5,22.0,1369.0,1080.0,3.0,22.0,4.9,5.0,3.5,29.0,27.16666666666667,31.0,0.0,0.0,243.0,279.0,5.0,-36.0,20.0,30.5,502.0,508.0,14.0,22.5,0.5642857142857143,0.5405940594059406,18.0,11.0,1.5625,18.0,11.0,2.2,3.5,11.0,31.0,18.0,10.5,31.0,0.4583333333333333,0.6206896551724138,16.0,28.0,0.6172953081876725,0.6276373753767679,17.0,18.0,2684.0,2707.0,2.0,28.0,106.0,891.0,996.0,24.0,18.0,110.0,21.5,16.0,0.08208955223880597,0.0925925925925926,13.0,19.0,5.4,5.4,13.0,20.0,980.0,1010.0,18.0,24.0,85.0,0.0,0.0,16.5,8.5,52.0,30.5,3788.0,3553.0,23.0,4.0,93.0,30.0,9.5,0.0,0.0,9.5,22.5,248.0,577.0,31.0,26.0,1.17,1.41,7.0,29.0,41.0,9.0,69.4,76.5,14.0,25.0,3069.0,25.0,0.64,15.0,0.4357142857142857,0.4594059405940594,15.0,22.0,0.5416666666666667,0.3793103448275862,17.0,5.0,0.38270469181232747,0.3723626246232321,16.0,15.0,427.0,464.0,23.0,20.0,13.0,11.0,11.0,17.0,1664.0,1606.0,8.0,21.0,15.506172839506176,16.0,21.9,26.9,8.0,31.0,3.0,0.0,51.0,9.2,7.0,8.5,31.5,385.0,231.0,12.0,32.0,38.0,10.0,32.0,24.0,31.0,19.5,28.0,17.0,23.0,15.5,29.0,34.0,17.6,9.3,32.0,30.0,18.0,32.0,-16.0,31.5,27.5,17.289562289562294,21.0,28611.0,29143.0,19.0,BUF,4348.0,4313.0,2.0,30.0,100.0,100.0,23.0,8.5,24.0,26.0,3.5,29.0,24.0,26.0,4.0,28.5,6.1,5.8,3.0,25.0,3.9,3.5,4.5,22.0,10.5,10.3,3.0,30.0,21.7,19.6,3.0,12.0,6.0,11.1,25.0,31.0,4.4,4.3,2.5,31.0,44.6,38.2,2.5,2.0,23.0,22.4,3.0,28.0,35.0,17.0,1.5641025641025639,1.657142857142857,14.0,18.0
2004.0,198.0,198.0,28.0,7.5,269.0,251.0,3.0,27.0,156.0,153.0,7.5,23.0,91.0,67.0,1.0,21.0,22.0,31.0,23.0,26.5,1.0,0.0,1.0,2.0,4.0,4.5,3.0,30.0,6149.0,32.0,4.8,5.3,3.0,30.0,26.0,152.0,139.0,2.5,18.0,0.8000000000000007,11.0,31.7,30.9,16.0,10.0,288.0,56.0,57.1,9.0,28.0,294.0,13.0,21.5,12.0,23.0,6.25,3.0,-139.15,-52.22,32.3,7.0,26.0,-74.9,86.18,1.0,29.0,130.16,3.0,28.0,70.4,85.0,21.5,29.5,1.0,10.0,6.0,7.0,3.0,1.0,10.0,5.0,3.0,0.0,10.0,8.0,29.5,10.5,14.083333333333336,10.0,21.8625,28.0,21.6,27.0,22.125,25.0,20.0,0.0,3.0,8.5,0.5,19.0,15.513468013468016,13.0,14.5,12.0,17.0,3.3,3.5,13.5,17.0,1.0,1.0,18.0,13.5,18.0,DC,55.0,57.0,8.0,30.0,0.0,1.0,24.0,22.0,1203.0,1223.0,9.0,29.0,4.8,5.4,3.5,29.5,26.91666666666667,28.5,1.0,0.0,240.0,265.0,5.0,-25.0,19.0,31.0,514.0,515.0,17.5,18.0,0.5395894428152492,0.5698151950718686,10.0,22.0,1.7142857142857142,17.0,18.0,3.5,3.3,5.5,24.0,17.0,5.0,24.0,0.75,0.7083333333333334,9.0,6.0,0.5985899476916079,0.6953982714319085,3.0,26.0,2632.0,2977.0,7.0,29.0,115.0,1047.0,797.0,5.0,30.5,97.0,4.0,17.5,0.08178438661710037,0.12350597609561753,3.0,20.0,5.3,5.0,3.0,22.5,1023.0,974.0,10.0,9.0,104.0,1.0,0.0,16.5,27.0,65.0,32.0,4588.0,4181.0,30.0,2.0,104.0,32.0,2.0,0.0,1.0,27.0,20.5,331.0,718.0,32.0,14.0,1.14,1.11,1.0,31.0,42.0,9.5,70.0,72.2,5.0,28.0,2874.0,29.0,0.5833333333333334,16.0,0.4604105571847508,0.4301848049281314,23.0,11.0,0.25,0.29166666666666663,24.0,27.0,0.4014100523083921,0.30460172856809153,30.0,7.0,471.0,419.0,8.0,12.0,6.0,7.0,3.5,31.5,1765.0,1304.0,2.0,21.0,16.376543209876544,18.0,21.7,20.7,1.0,31.0,0.0,1.0,38.0,6.9,7.2,13.0,17.0,242.0,245.0,13.0,18.0,40.0,10.0,18.5,27.0,20.0,4.5,17.0,19.0,17.0,6.0,23.5,27.0,13.1,12.6,22.0,13.0,26.0,22.0,-1.0,20.5,15.5,16.526936026936028,16.0,30096.0,27522.0,8.0,WAS,4397.0,4281.0,3.0,30.0,100.0,100.0,21.5,12.0,25.0,28.0,6.5,29.0,25.0,28.0,7.0,29.0,5.6,6.3,3.0,30.5,3.7,3.1,1.0,28.5,10.0,11.0,2.5,31.0,21.9,21.5,13.5,12.0,7.9,11.0,26.0,20.0,4.3,4.4,2.0,30.0,44.1,40.2,5.0,3.0,22.1,21.6,1.0,30.0,116.0,14.0,1.5135135135135134,2.032258064516129,2.0,26.0
2005.0,192.0,196.0,26.5,11.0,301.0,258.0,3.0,15.5,166.0,158.0,8.0,18.0,114.0,74.0,2.0,8.0,21.0,26.0,10.0,29.0,2.0,0.0,1.0,2.0,6.1,4.7,5.0,10.0,7172.0,16.0,7.0,5.4,5.5,10.0,44.0,159.0,140.0,2.5,9.5,-1.6999999999999993,21.0,30.0,31.7,19.0,24.0,278.0,57.8,54.4,1.0,22.0,291.0,8.0,24.0,12.0,21.0,10.416666666666666,7.0,-34.74,31.38,42.55,4.0,14.0,-54.51,48.99,14.0,22.0,102.07,5.0,14.0,81.0,71.0,4.0,16.0,1.0,4.0,8.0,7.0,1.0,1.0,4.0,6.0,6.0,0.0,16.0,12.0,15.5,29.0,16.833333333333332,19.0,11.625,11.0,12.0,11.5,11.25,10.0,29.0,1.0,1.0,24.0,0.5517241379310345,24.0,12.372053872053876,10.0,12.0,10.0,11.0,2.3,3.0,16.0,6.0,1.0,1.0,16.0,16.0,5.5,DC,62.0,72.0,24.0,23.0,2.0,0.0,11.5,1.5,1438.0,1503.0,21.0,22.0,6.1,5.4,5.0,13.5,13.166666666666664,11.0,0.0,0.0,359.0,293.0,9.0,66.0,11.0,13.0,481.0,535.0,23.0,22.0,0.4937319189971071,0.581039755351682,9.0,27.0,1.4561403508771933,24.0,25.0,5.2,2.8,3.5,6.0,15.0,3.5,6.0,0.625,0.5,28.0,17.5,0.587256570240121,0.6463184392699811,15.0,25.0,3106.0,3081.0,10.0,21.0,108.0,925.0,879.0,12.0,19.0,105.0,8.0,12.0,0.06976744186046513,0.1007751937984496,16.0,28.0,5.5,5.2,6.0,18.0,1037.0,981.0,11.5,7.0,87.0,0.0,0.0,16.5,12.0,40.0,21.0,3503.0,3634.0,23.0,11.0,88.0,26.0,6.0,0.0,0.0,12.5,20.5,180.0,189.0,3.0,29.0,1.72,1.41,6.5,12.0,30.0,27.0,87.0,70.1,3.0,11.0,3346.0,22.0,0.6867469879518072,9.0,0.5062680810028929,0.4189602446483181,24.0,6.0,0.375,0.5,5.0,15.5,0.412743429759879,0.3536815607300189,18.0,8.0,525.0,411.0,7.5,4.0,15.0,15.0,21.0,12.5,2183.0,1686.0,13.0,7.0,15.283950617283953,11.0,29.7,26.5,5.5,16.0,0.0,1.0,31.0,6.1,6.1,21.5,14.0,240.0,237.0,15.0,18.0,35.0,20.5,12.0,21.0,31.0,20.5,32.0,17.0,22.0,12.5,32.0,27.0,13.0,13.8,16.0,14.5,28.0,16.0,1.0,15.0,16.0,12.744107744107744,7.0,30528.0,27440.0,4.0,WAS,5289.0,4767.0,9.0,11.0,100.0,100.0,22.5,10.0,42.0,29.0,7.5,10.5,42.0,29.0,8.5,10.0,7.0,6.2,3.0,12.5,4.2,4.1,20.5,10.0,12.0,11.4,16.0,10.0,23.2,20.9,6.0,11.0,6.0,4.7,2.0,28.0,5.1,4.9,10.5,13.5,40.3,41.3,10.0,29.0,27.5,24.3,6.5,13.5,522.0,9.0,1.6666666666666663,1.5121951219512195,30.0,17.5
2006.0,179.0,179.0,4.5,27.0,295.0,301.0,19.0,16.0,150.0,169.0,14.5,25.0,123.0,104.0,16.0,4.0,22.0,28.0,25.5,19.5,2.0,0.0,2.0,1.0,6.0,7.6,32.0,9.0,7361.0,15.0,6.6,8.1,32.0,10.5,34.0,162.0,162.0,22.5,9.0,-0.5999999999999979,19.0,29.1,29.7,12.0,25.0,274.0,58.3,59.5,18.0,21.0,289.0,9.0,24.0,2.0,31.5,27.58333333333333,32.0,10.31,29.45,-143.88,32.0,13.0,-4.89,15.0,22.0,6.0,-114.28,32.0,10.0,73.3,88.2,26.0,27.0,0.0,5.0,12.0,11.0,2.0,0.0,5.0,10.0,6.0,1.0,7.0,6.0,30.0,4.5,27.41666666666667,32.0,11.59375,9.0,15.25,15.0,7.9375,4.0,20.0,0.0,0.0,6.5,0.35,5.0,19.78299663299664,23.0,21.3,24.0,10.0,2.1,1.2,32.0,5.0,0.0,2.0,6.0,32.0,5.0,DC,73.0,67.0,19.0,5.0,1.0,0.0,13.0,5.0,1631.0,1396.0,14.0,6.0,6.2,6.9,32.0,10.5,11.583333333333336,9.0,0.0,0.0,307.0,376.0,27.0,-69.0,24.0,20.0,470.0,486.0,5.0,24.0,0.4994892747701736,0.5065195586760279,28.0,27.0,1.2195121951219512,30.0,19.0,4.0,6.2,32.0,17.0,30.0,32.0,18.0,0.59375,0.7692307692307693,1.0,18.0,0.577341216860576,0.6137482419127989,23.0,26.0,3027.0,3491.0,23.0,21.0,106.0,939.0,856.0,24.0,28.0,94.0,16.0,24.0,0.07457627118644068,0.09302325581395347,8.0,19.0,5.6,5.8,27.0,12.5,979.0,997.0,16.0,23.0,82.0,1.0,0.0,16.5,26.5,45.0,27.0,3514.0,3318.0,17.0,13.0,79.0,18.0,11.0,1.0,0.0,10.0,7.0,342.0,319.0,16.0,16.0,1.62,2.03,28.5,15.5,39.0,12.5,83.4,97.8,32.0,13.0,3174.0,23.0,0.82,3.0,0.5005107252298264,0.4934804413239721,5.0,6.0,0.40625,0.23076923076923075,32.0,15.0,0.422658783139424,0.3862517580872011,10.0,7.0,490.0,492.0,26.5,8.0,13.0,9.0,5.0,15.5,2216.0,2197.0,27.0,4.0,14.753086419753089,8.0,30.2,38.5,30.5,19.5,1.0,1.0,19.0,3.9,3.8,32.0,5.0,147.0,95.0,32.0,4.0,19.0,32.0,3.0,30.0,34.0,27.5,13.0,22.0,30.0,27.0,22.5,17.0,9.5,5.6,32.0,3.0,12.0,32.0,-5.0,24.5,2.0,18.265993265993266,23.0,28998.0,28998.0,16.0,WAS,5243.0,5688.0,31.0,13.0,100.0,100.0,20.5,11.5,31.0,36.0,16.0,22.5,31.0,36.0,16.5,22.0,6.8,7.4,29.5,15.5,4.5,4.5,24.5,8.0,11.6,12.4,30.5,15.0,22.3,20.8,4.5,19.5,8.8,7.1,8.0,14.0,5.4,5.7,32.0,9.5,42.9,42.0,9.0,20.0,29.2,31.8,30.0,8.0,-445.0,23.0,1.5111111111111108,1.6444444444444446,18.0,23.0
2007.0,193.0,193.0,26.5,7.5,307.0,291.0,13.0,12.5,192.0,174.0,12.0,11.5,103.0,89.0,11.5,13.0,12.0,28.0,30.5,30.0,5.0,0.0,2.0,0.0,6.0,5.0,9.5,13.0,7320.0,16.0,6.6,5.6,6.5,10.5,35.0,155.0,147.0,6.5,19.0,0.1999999999999993,18.5,32.0,31.8,21.0,9.0,319.0,60.8,58.3,4.0,16.0,351.0,26.0,18.0,16.0,14.5,11.083333333333336,8.0,-56.19,48.38,29.23,6.0,11.0,-88.08,12.8,24.0,32.0,57.1,7.0,20.0,82.9,73.0,5.0,20.5,0.0,10.0,10.0,15.0,0.0,0.0,10.0,8.0,11.0,0.0,18.0,10.0,21.0,31.0,15.083333333333336,15.0,13.29375,12.0,12.4,13.0,14.1875,14.0,35.0,0.0,2.0,29.0,0.5142857142857142,22.0,13.887037037037034,11.0,13.7,11.0,11.0,2.1,2.3,27.5,4.0,2.0,0.0,14.0,25.0,4.0,DC,65.0,66.0,17.0,18.5,0.0,1.0,20.5,24.5,1544.0,1289.0,8.0,13.0,6.3,5.4,6.5,14.0,16.833333333333332,18.0,0.0,0.0,334.0,310.0,11.0,24.0,12.0,19.0,525.0,602.0,30.5,20.0,0.5266159695817489,0.6189083820662769,4.0,25.0,1.864077669902913,17.0,18.0,3.4,3.3,4.5,20.0,20.0,12.0,21.5,0.5454545454545454,0.6666666666666666,12.0,26.5,0.6492313460817398,0.7010647010647011,5.0,18.0,3463.0,3424.0,16.0,14.0,90.0,751.0,684.0,12.0,20.0,88.0,14.5,15.0,0.03908794788273615,0.09621993127147767,3.0,30.0,5.6,5.5,13.0,15.0,1052.0,1026.0,23.0,4.0,75.0,0.0,0.0,16.5,11.5,32.0,11.5,3072.0,3483.0,23.0,17.0,81.0,23.5,15.0,0.0,0.0,9.0,22.5,299.0,202.0,6.0,17.0,1.65,1.51,9.5,18.5,40.0,10.5,84.2,77.1,10.0,14.0,3622.0,15.0,0.5364583333333334,16.0,0.473384030418251,0.3810916179337232,29.0,8.0,0.4545454545454546,0.33333333333333337,21.0,6.5,0.3507686539182602,0.2989352989352989,28.0,15.0,498.0,391.0,7.0,5.0,15.0,10.0,10.0,8.0,1871.0,1460.0,4.0,12.0,14.382716049382715,10.0,32.1,29.5,11.5,18.0,2.0,1.0,29.0,5.2,5.2,27.0,12.0,159.0,198.0,20.5,7.0,33.0,17.0,13.0,35.0,37.0,28.0,5.5,29.0,27.0,18.5,6.0,29.0,15.0,12.4,24.0,17.0,24.0,25.0,-5.0,21.0,16.0,14.074074074074074,11.0,29915.0,28371.0,8.0,WAS,5334.0,4884.0,8.0,15.0,96.7,96.7,5.5,28.0,30.0,30.0,5.5,21.0,29.0,29.0,5.0,21.0,6.9,6.0,4.0,15.5,3.8,3.7,3.0,24.5,11.4,10.3,4.0,12.5,23.8,19.5,2.5,8.0,7.5,6.3,6.0,26.0,5.1,4.8,4.5,19.0,41.0,43.0,15.0,28.0,27.4,25.3,6.0,19.0,450.0,9.0,1.8157894736842104,1.6216216216216215,20.0,13.0
2008.0,172.0,170.0,5.5,28.5,312.0,289.0,11.0,10.0,183.0,166.0,13.0,12.0,107.0,98.0,15.0,10.5,22.0,25.0,25.0,10.5,2.0,0.0,0.0,1.0,5.3,7.1,29.5,20.5,7418.0,14.0,6.2,7.9,29.5,21.0,35.0,176.0,162.0,21.0,5.0,-3.899999999999999,27.0,27.3,31.2,23.0,30.0,335.0,62.4,63.9,24.0,12.5,297.0,12.0,11.0,20.0,15.5,20.5,22.0,10.38,6.62,-104.82,30.0,19.0,9.18,27.25,13.0,6.0,-70.01,26.0,15.0,76.0,90.0,24.0,29.0,0.0,7.0,6.0,7.0,5.0,0.0,7.0,3.0,5.0,4.0,11.0,4.0,32.0,18.5,19.83333333333333,25.0,14.65625,16.0,14.5,15.0,14.8125,12.0,23.0,1.0,1.0,20.0,0.4782608695652174,20.0,19.710606060606054,23.0,21.3,23.0,13.0,2.4,2.8,15.0,10.0,2.0,1.0,13.0,18.5,13.0,DC,74.0,51.0,4.0,10.0,0.0,0.0,11.0,22.5,1678.0,1015.0,1.0,9.0,5.8,7.3,30.5,23.0,17.666666666666668,21.0,0.0,0.0,302.0,367.0,21.0,-65.0,24.0,24.0,537.0,465.0,4.0,11.0,0.5761194029850746,0.5357917570498916,21.0,10.0,1.7102803738317758,16.0,15.0,2.8,5.4,29.0,28.0,25.0,28.5,24.5,0.46875,0.6410256410256411,9.0,27.0,0.6525656090873482,0.6772426817752597,9.0,15.0,3332.0,3586.0,24.0,15.0,104.0,813.0,691.0,16.0,26.0,80.0,5.5,27.0,0.07051282051282051,0.08650519031141868,8.0,14.0,6.0,5.6,16.5,7.0,1005.0,922.0,2.0,14.0,67.0,0.0,0.0,16.5,11.5,31.0,11.0,2904.0,2881.0,10.0,20.0,67.0,12.0,19.5,0.0,0.0,11.5,21.5,275.0,269.0,13.0,19.0,1.63,2.08,26.0,23.5,29.0,23.5,81.4,95.4,28.0,20.0,3620.0,14.0,0.5846994535519126,17.0,0.4238805970149254,0.4642082429501084,12.0,23.0,0.53125,0.3589743589743589,24.0,6.0,0.3474343909126518,0.3227573182247403,24.0,18.0,426.0,428.0,14.0,18.0,17.0,14.0,17.0,10.0,1774.0,1709.0,13.5,18.0,15.555555555555555,17.0,29.7,38.8,26.0,24.0,1.0,0.0,42.0,7.3,5.9,15.5,23.0,288.0,191.0,18.0,28.0,29.0,20.5,25.0,25.0,30.0,16.5,27.5,19.0,27.0,21.0,31.0,24.0,12.8,9.4,29.0,18.0,17.0,31.0,-7.0,25.5,13.5,18.12121212121212,24.0,30272.0,27540.0,8.0,JAX,5106.0,5295.0,17.0,20.0,100.0,100.0,19.0,13.5,33.0,40.0,23.5,24.0,33.0,40.0,23.5,24.0,6.7,8.1,30.0,20.0,4.2,4.0,12.5,15.5,10.8,12.7,29.0,23.0,22.7,19.9,3.0,18.0,9.5,8.7,12.0,15.0,5.1,5.7,26.0,21.5,43.3,43.0,10.5,21.5,29.7,31.1,21.5,13.0,-189.0,22.0,1.5952380952380951,2.025,2.0,19.0
2009.0,185.0,194.0,27.0,19.0,348.0,310.0,22.5,2.0,215.0,175.0,10.5,6.5,115.0,111.0,25.0,5.0,18.0,24.0,18.5,24.0,1.0,0.0,0.0,0.0,8.0,4.8,8.5,2.0,8205.0,3.0,8.5,5.4,5.0,4.0,64.0,164.0,145.0,4.0,12.5,2.8999999999999986,5.0,31.4,28.5,9.5,6.0,378.0,69.5,57.5,4.5,1.0,330.0,19.0,5.0,48.0,1.0,19.166666666666668,21.0,170.92,188.33,51.46,3.0,4.0,-12.64,-27.56,31.0,12.0,32.38,11.0,1.0,78.6,84.4,19.0,24.0,1.0,9.0,14.0,3.0,1.0,1.0,9.0,10.0,2.0,0.0,16.0,13.0,9.0,29.5,14.291666666666664,11.0,6.1375,1.0,3.9,1.0,8.375,6.0,25.0,2.0,2.0,21.0,0.64,31.0,10.14915824915825,7.0,5.8,4.0,12.0,2.2,4.5,3.0,6.5,5.0,0.0,26.0,3.0,6.0,DC,57.0,74.0,25.5,21.5,1.0,0.0,10.0,9.0,1393.0,1813.0,28.0,17.0,7.7,6.2,19.5,2.0,4.833333333333333,1.0,1.0,0.0,510.0,341.0,20.0,169.0,1.0,1.0,544.0,574.0,27.0,15.0,0.5465116279069767,0.5833333333333334,11.0,24.0,1.8695652173913044,17.0,34.0,6.3,2.6,3.0,1.0,15.0,5.0,2.0,0.6181818181818182,0.4411764705882353,29.0,22.0,0.6740442655935613,0.6584556254367575,18.0,14.0,4355.0,3769.0,26.0,4.0,89.0,787.0,717.0,8.0,17.0,86.0,7.5,13.0,0.05172413793103448,0.07741935483870968,14.0,29.0,5.7,5.5,15.0,13.0,1032.0,1044.0,27.0,9.5,58.0,0.0,0.0,16.5,13.5,25.0,4.0,2528.0,3053.0,9.0,30.0,71.0,8.5,30.0,0.0,1.0,27.5,20.5,152.0,358.0,22.0,30.5,2.44,1.64,14.5,2.0,33.0,23.5,106.0,68.6,3.0,2.0,4490.0,7.0,0.5348837209302325,16.0,0.4534883720930233,0.4166666666666666,22.0,9.0,0.3818181818181817,0.5588235294117647,4.0,11.0,0.32595573440643866,0.3415443745632425,15.0,19.0,468.0,435.0,18.0,7.5,21.0,19.0,28.5,3.5,2106.0,1955.0,21.0,6.0,21.160493827160497,29.0,41.6,31.4,15.5,3.0,0.0,1.0,20.0,3.5,5.7,21.5,4.0,135.0,192.0,22.0,5.0,35.0,14.0,4.0,28.0,32.0,22.5,20.0,22.0,27.0,23.0,20.0,28.0,13.5,18.0,3.0,16.5,39.0,2.0,11.0,3.0,17.0,14.4983164983165,11.0,30340.0,28130.0,11.0,NO,6461.0,5724.0,25.0,1.0,95.2,100.0,23.0,31.0,63.0,36.0,16.0,1.0,60.0,36.0,17.0,1.0,8.3,6.9,16.0,3.0,4.5,4.5,26.0,6.0,11.9,12.0,26.0,9.0,24.4,24.5,29.0,4.5,4.6,14.3,32.0,31.0,6.3,5.5,20.5,1.5,43.6,43.0,9.5,16.0,34.9,29.5,20.0,3.0,737.0,9.0,1.8444444444444448,1.5333333333333334,24.0,9.0
2010.0,174.0,173.0,1.0,30.0,351.0,273.0,7.0,5.0,236.0,150.0,1.5,2.5,94.0,94.0,17.0,15.5,21.0,29.0,24.5,19.5,0.0,0.0,0.0,2.0,6.0,5.6,15.5,15.0,7570.0,13.0,6.5,6.5,17.5,16.0,44.0,177.0,159.0,22.0,1.5,-0.4000000000000021,17.5,29.2,29.6,14.0,20.5,450.0,68.1,61.9,17.0,1.0,306.0,8.0,1.5,14.0,19.0,11.25,8.0,98.07,137.35,-32.03,14.0,5.0,-36.1,27.69,17.0,19.0,4.21,13.0,6.0,80.6,82.4,15.0,21.0,1.0,8.0,13.0,7.0,2.0,1.0,5.0,11.0,6.0,2.0,9.0,16.0,3.0,10.5,16.5,17.5,15.63125,17.0,8.2,6.0,23.0625,26.0,23.0,0.0,2.0,18.0,0.39130434782608703,6.0,12.917845117845118,11.0,11.6,9.0,22.0,3.3,1.8,32.0,20.0,2.0,4.0,9.0,32.0,30.0,DC,52.0,66.0,19.5,30.0,0.0,0.0,7.0,24.5,1181.0,1592.0,27.0,29.0,6.5,5.9,11.0,9.5,12.5,12.0,0.0,0.0,384.0,307.0,7.0,77.0,7.0,11.0,661.0,494.0,4.0,2.0,0.6438612933458294,0.5559071729957806,24.0,3.0,2.5106382978723403,4.5,33.0,5.0,2.6,3.0,11.0,13.0,1.0,2.5,0.7857142857142857,0.5,30.0,2.0,0.7451342281879194,0.6332653061224489,23.0,2.0,4441.0,3103.0,4.0,3.0,90.0,884.0,701.0,6.0,22.0,88.0,11.0,12.5,0.05982905982905984,0.10622710622710622,7.0,26.0,6.3,5.7,24.5,1.5,1067.0,948.0,2.5,4.0,57.0,0.0,0.0,16.5,12.5,26.0,3.5,2616.0,2995.0,9.0,29.0,67.0,7.0,30.5,0.0,0.0,10.5,21.0,210.0,310.0,18.0,31.0,2.12,1.58,10.5,6.5,27.0,28.0,90.8,83.2,15.0,10.5,4636.0,3.0,0.3983050847457627,28.5,0.3561387066541706,0.44409282700421937,9.0,30.0,0.2142857142857143,0.5,3.0,31.0,0.2548657718120806,0.36673469387755103,10.0,31.0,380.0,421.0,16.0,30.0,9.0,13.0,18.5,26.0,1519.0,1797.0,16.0,28.0,20.530864197530867,29.0,38.5,31.8,17.5,7.0,1.0,0.0,26.0,3.8,6.3,11.5,3.5,195.0,250.0,12.0,9.5,33.0,18.5,5.0,31.0,34.0,24.0,11.0,25.0,28.0,23.5,14.0,31.0,16.7,12.7,18.0,27.0,25.0,20.5,-6.0,23.5,23.0,14.235690235690234,10.0,30798.0,27507.0,6.0,NO,5960.0,4900.0,4.0,6.0,100.0,93.1,1.0,12.5,43.0,29.0,4.5,10.0,43.0,27.0,4.0,9.0,7.0,6.8,11.5,17.0,4.0,4.3,18.0,20.5,10.3,11.0,10.0,30.0,22.7,24.1,24.0,15.0,7.8,11.9,28.0,23.0,5.6,5.2,14.5,9.0,45.9,44.7,26.0,4.0,34.2,28.2,16.0,3.0,1060.0,4.0,1.75,1.5813953488372092,24.0,13.0
2011.0,175.0,182.0,8.0,30.0,416.0,326.0,22.0,1.0,280.0,196.0,23.5,1.0,116.0,92.0,13.5,6.0,20.0,38.0,28.0,28.5,3.0,0.0,2.0,0.0,8.2,6.4,25.0,3.0,9052.0,1.0,8.8,7.2,24.0,3.0,66.0,175.0,150.0,13.0,3.0,2.3999999999999986,8.0,28.2,25.8,5.0,17.0,472.0,71.3,57.8,9.0,1.0,362.0,26.0,1.0,18.0,14.0,22.75,25.0,330.95,294.47,-68.83,22.0,1.0,43.36,-13.9,28.0,3.0,-68.42,24.0,1.0,82.4,84.4,22.0,19.0,0.0,11.0,10.0,8.0,5.0,0.0,11.0,10.0,5.0,2.0,5.0,7.0,26.5,2.5,19.75,26.0,5.4375,1.0,3.25,3.0,7.625,6.0,6.0,2.0,0.0,1.0,0.8333333333333334,32.0,10.156228956228958,3.0,7.4,4.0,14.0,2.1,1.4,32.0,6.5,1.0,1.0,9.0,29.0,14.0,DC,42.0,36.0,10.5,17.5,0.0,1.0,28.0,21.0,1111.0,927.0,12.0,10.0,7.8,6.3,16.5,3.0,2.6666666666666665,1.0,0.0,0.0,547.0,339.0,13.0,208.0,1.0,2.0,662.0,626.0,30.0,2.0,0.6141450313339302,0.6524752475247525,1.0,4.0,2.413793103448276,9.0,46.0,6.9,3.8,11.0,2.0,24.0,17.5,2.0,0.7419354838709677,0.6857142857142857,12.5,5.0,0.7154134332352154,0.7051738761662426,8.0,6.0,5347.0,4157.0,30.0,1.0,99.0,851.0,912.0,22.0,16.0,109.0,22.0,14.0,0.04807692307692308,0.1165644171779141,5.0,31.0,6.6,5.7,22.5,1.0,1117.0,1010.0,17.0,1.0,47.0,1.0,0.0,16.5,28.0,19.0,1.0,2224.0,0.0,16.5,32.0,71.0,10.0,31.5,1.0,0.0,9.5,9.5,294.0,118.0,1.0,22.0,2.96,1.79,20.0,1.0,29.0,27.5,110.5,86.4,22.0,2.0,5505.0,1.0,0.4142857142857143,24.0,0.3858549686660698,0.3475247524752475,32.0,29.0,0.25806451612903225,0.3142857142857143,20.5,28.0,0.2845865667647845,0.2948261238337574,25.0,27.0,431.0,351.0,1.0,20.0,16.0,11.0,16.0,8.0,2127.0,1738.0,12.0,6.0,13.456790123456793,6.0,51.4,34.1,22.0,1.0,0.0,0.0,24.0,3.5,5.0,28.5,1.0,158.0,256.0,13.0,3.0,33.0,20.5,2.5,34.0,32.0,19.0,10.0,28.0,27.0,18.0,11.5,19.0,10.9,8.8,29.0,9.0,16.0,31.0,-3.0,20.0,4.5,12.912457912457912,6.0,30625.0,27300.0,6.0,NO,7474.0,5895.0,24.0,1.0,100.0,97.3,3.0,13.0,63.0,37.0,16.0,2.0,63.0,36.0,15.0,2.0,8.3,7.0,14.0,4.0,4.9,5.0,30.0,4.5,11.7,12.2,19.5,18.0,26.5,25.8,28.0,3.0,10.1,6.2,5.0,17.0,6.7,5.8,26.0,1.0,47.3,0.0,16.5,7.0,42.6,32.4,26.5,1.0,1579.0,2.0,1.6938775510204085,1.4,29.5,18.0
2014.0,186.0,182.0,16.5,13.5,288.0,301.0,4.0,26.5,189.0,189.0,9.5,18.0,79.0,83.0,9.5,24.0,20.0,29.0,12.5,31.0,1.0,0.0,1.0,0.0,5.5,6.3,19.0,25.5,6915.0,20.0,6.6,7.2,18.5,23.0,36.0,151.0,162.0,23.5,23.0,2.3999999999999986,8.0,28.0,25.6,3.0,15.0,327.0,63.5,68.1,31.0,14.0,368.0,27.0,19.5,18.0,15.5,15.333333333333336,13.0,-56.29,5.26,-57.93,16.0,25.0,-56.47,54.74,6.0,28.0,5.33,6.0,28.0,80.0,86.2,22.0,25.0,1.0,7.0,12.0,3.0,7.0,1.0,6.0,10.0,2.0,5.0,11.0,12.0,7.5,21.0,14.25,13.0,19.91875,26.0,19.15,23.0,20.6875,22.0,27.0,0.0,3.0,27.5,0.4074074074074074,10.5,18.36851851851852,21.0,19.7,22.0,16.0,3.1,2.4,19.5,23.5,3.0,5.0,13.0,19.0,21.0,DC,45.0,35.0,13.0,9.0,0.0,1.0,29.5,19.0,1099.0,849.0,13.0,9.0,6.0,6.7,21.5,21.5,23.08333333333333,27.0,0.0,1.0,324.0,354.0,16.5,-30.0,21.0,21.0,515.0,540.0,9.0,23.0,0.587251828631139,0.5771144278606966,18.0,17.0,2.392405063291139,11.0,20.0,3.9,3.3,3.0,22.5,18.0,3.5,24.0,0.6451612903225806,0.6,29.0,22.0,0.6752730883813307,0.686277995023107,17.0,19.0,3400.0,3861.0,19.0,23.0,123.0,1139.0,882.0,17.0,32.0,105.0,18.0,30.0,0.06944444444444445,0.09634551495016612,20.0,31.0,5.3,5.7,16.0,28.5,957.0,1005.0,10.0,30.0,81.0,1.0,0.0,16.5,21.0,28.0,9.5,3721.0,3268.0,11.0,7.0,76.0,18.0,8.5,2.0,0.0,10.0,2.0,482.0,192.0,6.0,3.0,1.55,1.57,7.0,25.0,37.0,9.5,84.9,91.8,22.0,22.0,3695.0,21.0,0.417989417989418,22.0,0.41274817136886105,0.42288557213930345,15.0,16.0,0.3548387096774194,0.4,4.0,11.0,0.3247269116186693,0.3137220049768929,16.0,14.0,395.0,425.0,17.0,26.0,11.0,12.0,17.5,18.5,1635.0,1765.0,14.0,20.0,11.246913580246916,6.0,29.6,30.2,7.0,26.0,0.0,0.0,47.0,8.4,6.9,10.0,23.0,295.0,265.0,10.0,24.0,40.0,14.0,24.5,30.0,29.0,12.0,20.5,24.0,25.0,13.0,23.5,27.0,14.0,13.2,12.5,26.0,25.0,16.5,-2.0,19.5,24.0,17.037037037037035,18.0,28086.0,29484.0,25.0,LAR,5035.0,5626.0,17.0,28.0,97.1,100.0,20.0,28.0,35.0,39.0,16.5,18.5,34.0,39.0,16.5,18.5,7.2,7.6,23.0,15.5,4.1,4.2,16.5,17.5,11.3,11.2,11.0,20.5,24.4,24.3,20.0,11.0,13.0,6.9,7.0,2.5,5.3,5.6,24.0,18.0,45.9,43.0,2.5,10.0,26.9,30.8,20.5,26.0,-591.0,25.0,1.75609756097561,1.8095238095238089,12.0,18.0
2015.0,196.0,198.0,29.5,6.0,241.0,320.0,18.0,32.0,126.0,192.0,14.5,32.0,92.0,98.0,18.0,15.5,23.0,30.0,16.0,28.5,2.0,0.0,1.0,2.0,5.2,6.1,13.0,29.0,6017.0,32.0,5.6,6.9,13.0,32.0,31.0,138.0,161.0,23.5,31.0,1.5,11.0,27.9,26.4,7.5,13.0,273.0,57.7,66.8,28.0,31.0,399.0,28.0,32.0,20.0,10.0,15.25,12.0,-83.37,-41.85,-38.11,11.0,32.0,-30.95,63.43,4.0,15.0,26.21,9.0,32.0,67.7,94.6,29.0,32.0,1.0,2.0,11.0,8.0,9.0,1.0,2.0,10.0,5.0,3.0,11.0,13.0,6.0,24.5,13.666666666666664,11.0,18.1875,22.0,25.25,32.0,11.125,8.0,22.0,2.0,1.0,18.5,0.5,20.0,19.57609427609428,23.0,20.6,23.0,11.0,2.3,2.2,20.0,19.0,1.0,2.0,13.0,18.0,9.5,DC,35.0,27.0,10.0,13.5,0.0,0.0,13.5,19.0,830.0,605.0,12.0,14.0,5.7,6.4,14.5,29.5,23.91666666666667,28.0,0.0,0.0,280.0,330.0,13.0,-50.0,19.0,29.0,473.0,597.0,22.0,29.5,0.533695652173913,0.5847846012832264,17.0,28.0,1.3695652173913044,29.0,11.0,2.3,3.5,6.0,32.0,21.0,8.0,32.0,0.4074074074074074,0.75,12.0,32.0,0.5891619407687461,0.6907391673746814,17.0,30.0,2805.0,4065.0,23.0,32.0,122.0,1057.0,992.0,23.0,24.0,109.0,12.5,26.5,0.0954356846473029,0.09375,19.0,17.0,4.9,5.7,15.5,32.0,920.0,1091.0,29.0,32.0,96.0,0.0,0.0,11.0,11.5,40.0,22.5,4601.0,3711.0,25.0,1.0,83.0,26.0,1.5,1.0,1.0,26.5,7.0,300.0,289.0,19.0,15.0,1.29,1.52,7.5,31.0,39.0,11.5,74.1,90.4,16.0,32.0,2931.0,32.0,0.7301587301587301,4.0,0.46630434782608704,0.4152153987167736,16.0,5.0,0.5925925925925926,0.25,21.0,1.0,0.4108380592312539,0.30926083262531856,16.0,3.0,429.0,453.0,24.0,14.5,16.0,7.0,4.0,7.5,1956.0,1820.0,20.0,7.0,15.802469135802472,15.0,24.5,31.8,11.0,32.0,1.0,0.0,18.0,3.7,6.4,12.0,3.0,126.0,236.0,20.0,2.0,41.0,11.0,1.0,31.0,37.0,29.5,16.5,21.0,35.0,31.0,28.0,22.0,10.2,12.1,13.0,12.0,26.0,10.5,4.0,14.0,15.5,18.552188552188554,22.0,27048.0,31878.0,28.0,LAR,4761.0,5885.0,23.0,32.0,93.1,100.0,30.0,20.0,29.0,29.0,6.5,28.0,27.0,29.0,9.5,29.0,6.2,7.2,15.5,32.0,4.6,4.0,12.5,5.5,10.7,10.8,5.5,29.5,23.7,22.4,11.0,18.0,7.7,7.2,13.0,21.0,5.2,5.4,13.0,26.0,47.9,44.7,11.5,1.0,24.3,29.6,11.0,32.0,-1124.0,31.0,1.347826086956522,1.8,14.0,32.0
2016.0,193.0,192.0,19.0,13.5,245.0,325.0,16.0,32.0,151.0,194.0,16.0,32.0,68.0,91.0,13.5,31.0,26.0,40.0,31.0,23.5,1.0,0.0,0.0,1.0,4.0,6.4,21.5,32.0,6028.0,32.0,5.0,7.1,18.0,32.0,24.0,146.0,153.0,8.0,29.0,0.09999999999999787,15.0,27.4,27.3,10.5,24.0,312.0,58.2,64.9,27.0,30.0,378.0,24.0,27.0,6.0,22.5,15.083333333333336,13.0,-164.49,-102.82,-81.75,18.0,32.0,-51.81,11.26,17.0,28.0,-59.12,17.0,32.0,86.4,88.9,25.0,11.0,0.0,5.0,9.0,4.0,4.0,0.0,5.0,9.0,3.0,2.0,9.0,8.0,21.0,17.5,17.833333333333332,18.0,27.79375,32.0,27.65,32.0,27.9375,30.0,24.0,1.0,1.0,24.5,0.375,8.5,22.675084175084173,28.0,26.0,29.0,20.0,3.7,1.7,26.0,31.0,0.0,5.0,10.0,24.5,30.0,DC,47.0,22.0,4.0,1.0,0.0,0.0,13.0,19.5,1122.0,430.0,3.0,1.0,5.0,6.1,9.0,32.0,31.16666666666667,32.0,0.0,0.0,224.0,394.0,23.0,-170.0,30.0,32.0,536.0,582.0,20.0,27.0,0.609375,0.5911282545805208,18.0,10.0,2.2205882352941178,17.0,14.0,2.6,5.5,27.5,30.5,32.0,29.5,32.0,0.6086956521739131,0.7272727272727273,7.0,22.0,0.7021175350939804,0.6921364985163204,16.0,16.0,2951.0,3732.0,10.0,31.0,126.0,1091.0,920.0,14.5,28.0,108.0,16.0,30.0,0.10612244897959183,0.12307692307692307,2.0,11.0,5.1,5.5,7.5,31.0,960.0,1037.0,23.0,31.0,98.0,0.0,1.0,29.0,13.5,35.0,21.0,4680.0,4313.0,31.0,1.0,96.0,32.0,2.0,0.0,0.0,12.0,20.0,341.0,152.0,5.0,6.0,1.13,1.85,13.0,32.0,49.0,1.0,69.5,95.5,25.0,31.0,3313.0,30.0,0.4503311258278146,16.0,0.390625,0.4088717454194792,15.0,23.0,0.3913043478260869,0.2727272727272727,26.0,11.0,0.29788246490601955,0.3078635014836796,17.0,17.0,375.0,424.0,20.5,28.0,9.0,12.0,14.5,27.0,1252.0,1660.0,16.0,31.0,9.283950617283953,2.0,21.8,31.3,7.0,32.0,0.0,0.0,49.0,8.4,5.1,24.5,29.0,362.0,196.0,24.0,31.0,31.0,25.0,31.0,22.0,18.0,1.0,29.5,19.0,16.0,1.5,28.5,29.0,14.5,9.4,23.5,28.0,18.0,24.0,-11.0,28.0,28.0,19.350168350168353,28.0,28178.0,29376.0,27.0,LAR,4203.0,5392.0,9.0,32.0,100.0,93.6,16.0,3.0,23.0,47.0,30.0,32.0,23.0,44.0,29.0,30.5,6.2,6.7,5.5,30.5,3.3,3.9,9.5,31.0,10.6,10.4,2.5,27.5,23.9,19.5,5.0,6.0,7.0,4.3,1.0,23.5,4.4,5.2,9.0,32.0,47.8,44.9,12.5,5.0,21.7,28.0,7.0,32.0,-1189.0,30.0,1.8787878787878791,1.717948717948718,17.0,11.0
