Year,#Dr,#Dr_Defense,#Dr_Defense_Low_Rank,#Dr_High_Rank,1stD,1stD_Defense,1stD_Defense_Low_Rank,1stD_High_Rank,1stDpass,1stDpass_Defense,1stDpass_Defense_Low_Rank,1stDpass_High_Rank,1stDrun,1stDrun_Defense,1stDrun_Defense_Low_Rank,1stDrun_High_Rank,1stPy,1stPy_Defense,1stPy_Defense_Low_Rank,1stPy_High_Rank,2PA,2PA_Defense,2PM,2PM_Defense,ANY/A,ANY/A_Defense,ANY/A_Defense_Low_Rank,ANY/A_High_Rank,APYd,APYd_High_Rank,AY/A,AY/A_Defense,AY/A_Defense_Low_Rank,AY/A_High_Rank,AllTD,AvgDriveTime,AvgDriveTime_Defense,AvgDriveTime_Defense_Low_Rank,AvgDriveTime_High_Rank,AvgFieldPositionDifferential,AvgFieldPositionDifferential_High_Rank,AvgStartingPosition,AvgStartingPosition_Defense,AvgStartingPosition_Defense_Low_Rank,AvgStartingPosition_High_Rank,Cmp,Cmp%,Cmp%_Defense,Cmp%_Defense_Low_Rank,Cmp%_High_Rank,Cmp_Defense,Cmp_Defense_Low_Rank,Cmp_High_Rank,DefensivePtsScored,DefensivePtsScored_High_Rank,Dscore,Dscore_Rank,ExpectedPoints,ExpectedPointsPassing,ExpectedPointsPassing_Defense,ExpectedPointsPassing_Defense_High_Rank,ExpectedPointsPassing_High_Rank,ExpectedPointsRunning,ExpectedPointsRunning_Defense,ExpectedPointsRunning_Defense_High_Rank,ExpectedPointsRunning_High_Rank,ExpectedPoints_Defense,ExpectedPoints_Defense_High_Rank,ExpectedPoints_High_Rank,FG%,FG%_Defense,FG%_Defense_Low_Rank,FG%_High_Rank,FGA019,FGA2029,FGA3039,FGA4049,FGA50Plus,FGM019,FGM2029,FGM3039,FGM4049,FGM50Plus,FL,FL_Defense,FL_Defense_High_Rank,FL_Low_Rank,FantasyDstScore,FantasyDstScore_Rank,FantasyOffenseScore,FantasyOffenseScore_Rank,FantasyPassScore,FantasyPassScore_Rank,FantasyRushScore,FantasyRushScore_Rank,Fmb,FmbTD,FmbTD_Defense,Fmb_Low_Rank,FumbleLostPercent,FumbleLostPercent_Low_Rank,GameControlPlusBalance,GameControlPlusBalance_Rank,GameControlScore,GameControlScore_Rank,Int,Int%,Int%_Defense,Int%_Defense_High_Rank,Int%_Low_Rank,IntTD,IntTD_Defense,Int_Defense,Int_Defense_High_Rank,Int_Low_Rank,Job,KickRet,KickRet_Defense,KickRet_Defense_Low_Rank,KickRet_High_Rank,KrTD,KrTD_Defense,KrTD_Defense_Low_Rank,KrTD_High_Rank,KrYds,KrYds_Defense,KrYds_Defense_Low_Rank,KrYds_High_Rank,NY/A,NY/A_Defense,NY/A_Defense_Low_Rank,NY/A_High_Rank,Oscore,Oscore_Rank,OthTD,OthTD_Defense,PF,PF_Defense,PF_Defense_Low_Rank,PF_Differential,PF_Differential_High_Rank,PF_High_Rank,PassAtt,PassAtt_Defense,PassAtt_Defense_Low_Rank,PassAtt_High_Rank,PassPercent,PassPercent_Defense,PassPercent_Defense_High_Rank,PassPercent_High_Rank,PassRun1dRatio,PassRun1dRatio_High_Rank,PassTD,PassTD%,PassTD%_Defense,PassTD%_Defense_Low_Rank,PassTD%_High_Rank,PassTD_Defense,PassTD_Defense_Low_Rank,PassTD_High_Rank,PassTdPercent,PassTdPercent_Defense,PassTdPercent_Defense_High_Rank,PassTdPercent_High_Rank,PassYdPercent,PassYdPercent_Defense,PassYdPercent_Defense_High_Rank,PassYdPercent_High_Rank,PassYds,PassYds_Defense,PassYds_Defense_Low_Rank,PassYds_High_Rank,Pen,PenYds,PenYds_Defense,PenYds_Defense_Low_Rank,PenYds_Low_Rank,Pen_Defense,Pen_Defense_Low_Rank,Pen_Low_Rank,Penalty1dPercent,Penalty1dPercent_Defense,Penalty1dPercent_Defense_High_Rank,Penalty1dPercent_High_Rank,Plays/Drive,Plays/Drive_Defense,Plays/Drive_Defense_Low_Rank,Plays/Drive_High_Rank,Ply,Ply_Defense,Ply_Defense_Low_Rank,Ply_High_Rank,Pnt,PntBlck,PntBlck_Defense,PntBlck_Defense_Low_Rank,PntBlck_Low_Rank,PntRet_Defense,PntRet_Defense_Low_Rank,PntYds,PntYds_Defense,PntYds_Defense_Low_Rank,PntYds_High_Rank,Pnt_Defense,Pnt_Defense_Low_Rank,Pnt_High_Rank,PrTD,PrTD_Defense,PrTD_Defense_Low_Rank,PrTD_High_Rank,PrYds,PrYds_Defense,PrYds_Defense_Low_Rank,PrYds_High_Rank,Pts/Drive,Pts/Drive_Defense,Pts/Drive_Defense_Low_Rank,Pts/Drive_High_Rank,PuntRet,PuntRet_High_Rank,QbRating,QbRating_Defense,QbRating_Defense_Low_Rank,QbRating_High_Rank,RawPassYds,RawPassYds_High_Rank,RunPass1dRatio,RunPass1dRatio_High_Rank,RunPercent,RunPercent_Defense,RunPercent_Defense_High_Rank,RunPercent_High_Rank,RunTdPercent,RunTdPercent_Defense,RunTdPercent_Defense_High_Rank,RunTdPercent_High_Rank,RunYdPercent,RunYdPercent_Defense,RunYdPercent_Defense_High_Rank,RunYdPercent_High_Rank,RushAtt,RushAtt_Defense,RushAtt_Defense_Low_Rank,RushAtt_High_Rank,RushTD,RushTD_Defense,RushTD_Defense_Low_Rank,RushTD_High_Rank,RushYds,RushYds_Defense,RushYds_Defense_Low_Rank,RushYds_High_Rank,STscore,STscore_Rank,Sc%,Sc%_Defense,Sc%_Defense_Low_Rank,Sc%_High_Rank,Sfty,Sfty_Defense,Sk,Sk%,Sk%_Defense,Sk%_Defense_High_Rank,Sk%_Low_Rank,SkYds,SkYds_Defense,SkYds_Defense_High_Rank,SkYds_Low_Rank,Sk_Defense,Sk_Defense_High_Rank,Sk_Low_Rank,TFGA,TFGA_Defense,TFGA_Defense_Low_Rank,TFGA_High_Rank,TFGM,TFGM_Defense,TFGM_Defense_Low_Rank,TFGM_High_Rank,TO,TO%,TO%_Defense,TO%_Defense_High_Rank,TO%_Low_Rank,TO_Defense,TO_Defense_High_Rank,TO_Differential,TO_Differential_High_Rank,TO_Low_Rank,ThreePhaseScore,ThreePhaseScore_Rank,TimeOfPossession,TimeOfPossession_Defense,TimeOfPossession_High_Rank,Tm,TotalYds,TotalYds_Defense,TotalYds_Defense_Low_Rank,TotalYds_High_Rank,XP%,XP%_Defense,XP%_Defense_Low_Rank,XP%_High_Rank,XPA,XPA_Defense,XPA_Defense_Low_Rank,XPA_High_Rank,XPM,XPM_Defense,XPM_Defense_Low_Rank,XPM_High_Rank,Y/Apass,Y/Apass_Defense,Y/Apass_Defense_Low_Rank,Y/Apass_High_Rank,Y/Arun,Y/Arun_Defense,Y/Arun_Defense_Low_Rank,Y/Arun_High_Rank,Y/C,Y/C_Defense,Y/C_Defense_Low_Rank,Y/C_High_Rank,Y/KR,Y/KR_Defense,Y/KR_Defense_Low_Rank,Y/KR_High_Rank,Y/PR,Y/PR_Defense,Y/PR_Defense_Low_Rank,Y/PR_High_Rank,Y/Play,Y/Play_Defense,Y/Play_Defense_Low_Rank,Y/Play_High_Rank,Y/Pnt,Y/Pnt_Defense,Y/Pnt_Defense_Low_Rank,Y/Pnt_High_Rank,Yds/Drive,Yds/Drive_Defense,Yds/Drive_Defense_Low_Rank,Yds/Drive_High_Rank,Yds_Differential,Yds_Differential_High_Rank,YppYprRatio,YppYprRatio_Defense,YppYprRatio_Defense_High_Rank,YppYprRatio_High_Rank
1996.0,,,,,338.0,351.0,29.0,2.5,208.0,213.0,30.0,2.5,108.0,115.0,25.0,8.5,22.0,23.0,8.0,18.5,9.0,0.0,5.0,7.0,6.2,6.8,28.0,3.5,8128.0,1.0,7.1,7.4,28.0,3.0,45.0,,,,,,,,,,,335.0,58.8,65.2,30.0,11.0,350.0,29.0,7.0,6.0,25.0,26.5,29.0,,,,,,,,,,,,,76.0,90.3,27.0,22.0,0.0,8.0,6.0,10.0,1.0,0.0,8.0,5.0,5.0,1.0,13.0,7.0,30.0,16.5,24.25,30.0,10.375,7.0,6.0,3.0,14.75,14.0,23.0,0.0,1.0,6.5,0.5652173913043478,24.0,,,,,20.0,3.5,2.8,20.0,19.0,1.0,3.0,15.0,20.0,21.0,DC,86.0,70.0,19.5,2.0,0.0,0.0,11.5,19.5,1734.0,1402.0,14.0,3.0,6.5,7.0,28.5,4.0,7.333333333333332,5.0,0.0,1.0,371.0,441.0,28.0,-70.0,24.0,6.0,570.0,537.0,17.5,6.0,0.59375,0.5274418604651163,24.0,7.0,1.9259259259259256,9.0,34.0,6.0,5.0,26.0,2.0,27.0,26.0,2.0,0.7727272727272727,0.6,18.5,5.0,0.6950899877686528,0.6739684156902701,11.0,8.0,3978.0,3969.0,30.0,2.0,94.0,818.0,744.0,5.0,12.0,104.0,16.5,7.5,0.0650887573964497,0.06552706552706553,25.0,25.0,,,,,1024.0,1075.0,27.0,16.0,69.0,1.0,0.0,15.5,24.5,27.0,2.0,3024.0,2883.0,4.0,24.0,68.0,3.5,24.5,0.0,0.0,10.0,20.0,357.0,273.0,11.0,13.0,,,,,38.0,15.5,87.6,93.4,28.0,4.0,4274.0,2.0,0.5192307692307693,22.0,0.40625,0.4725581395348837,7.0,24.0,0.2272727272727273,0.4,12.5,26.0,0.3049100122313472,0.32603158430972995,20.0,23.0,416.0,508.0,25.0,24.0,10.0,18.0,26.0,17.0,1745.0,1920.0,23.0,14.0,15.814814814814815,18.0,0.0,0.0,15.5,15.5,0.0,1.0,38.0,6.3,5.3,25.0,14.0,296.0,146.0,30.0,26.5,30.0,26.0,16.5,25.0,31.0,17.0,26.0,19.0,28.0,24.5,26.0,33.0,0.0,0.0,15.5,15.5,22.0,28.5,-11.0,27.0,21.5,16.616161616161616,18.0,,,,BAL,5723.0,5889.0,30.0,3.0,97.1,100.0,21.0,22.5,35.0,41.0,25.5,13.0,34.0,41.0,26.5,14.0,7.5,7.7,28.0,2.5,4.2,3.8,15.0,7.0,12.8,11.8,19.5,2.0,20.2,20.0,4.0,26.0,9.4,10.1,16.0,18.5,5.6,5.5,29.0,1.0,43.8,42.4,13.0,12.5,,,,,-166.0,16.0,1.7857142857142856,2.0263157894736845,1.0,13.0
1997.0,,,,,292.0,306.0,23.0,17.0,176.0,180.0,21.5,10.0,99.0,101.0,17.0,13.0,17.0,25.0,18.0,29.0,3.0,0.0,2.0,2.0,5.6,5.5,18.0,10.0,7501.0,6.0,6.3,6.5,19.0,11.0,35.0,,,,,,,,,,,338.0,57.7,59.7,25.5,9.0,332.0,28.0,2.0,8.0,23.0,18.25,21.0,,,,,,,,,,,,,76.5,70.6,6.0,19.5,0.0,9.0,12.0,11.0,2.0,0.0,8.0,12.0,6.0,0.0,17.0,11.0,22.5,26.5,17.583333333333332,19.5,15.36875,16.0,8.3,8.0,22.4375,26.0,37.0,0.0,1.0,29.0,0.4594594594594595,16.0,,,,,16.0,2.7,3.1,13.0,12.5,1.0,0.0,17.0,11.5,17.5,DC,71.0,58.0,13.0,7.0,0.0,1.0,24.0,21.5,1435.0,1323.0,14.0,14.0,5.9,6.1,23.0,11.0,15.75,16.0,0.0,0.0,326.0,345.0,18.0,-19.0,18.0,16.0,586.0,556.0,25.0,5.0,0.5973154362416108,0.5599250936329588,15.0,5.0,1.7777777777777777,18.0,25.0,4.3,3.6,10.0,10.5,20.0,12.5,8.0,0.78125,0.5405405405405406,24.0,3.0,0.6996786996786997,0.6848778668655603,4.0,4.0,3702.0,3673.0,28.0,5.0,101.0,777.0,828.0,13.0,9.0,106.0,18.5,15.0,0.05821917808219178,0.08169934640522876,12.0,28.0,,,,,1043.0,1068.0,25.0,8.5,83.0,0.0,0.0,15.5,9.0,53.0,29.0,3540.0,3608.0,15.0,16.0,82.0,12.5,16.5,2.0,0.0,10.0,3.0,564.0,460.0,23.0,3.0,,,,,42.0,12.0,80.9,80.8,19.0,11.0,3929.0,6.0,0.5625,13.0,0.4026845637583893,0.4400749063670412,16.0,26.0,0.21875,0.4594594594594594,7.0,28.0,0.30032130032130033,0.3151221331344397,27.0,27.0,420.0,470.0,19.5,24.0,7.0,17.0,25.5,27.0,1589.0,1690.0,10.0,22.0,16.419753086419753,18.5,0.0,0.0,15.5,15.5,1.0,1.0,37.0,5.9,7.0,18.0,8.0,227.0,293.0,13.0,10.0,42.0,15.5,13.0,34.0,34.0,23.5,10.0,26.0,24.0,16.5,10.5,33.0,0.0,0.0,15.5,15.5,28.0,15.5,-5.0,23.0,23.5,16.841750841750837,18.0,,,,BAL,5291.0,5363.0,25.0,9.0,100.0,94.3,2.0,11.0,32.0,35.0,19.0,20.0,32.0,33.0,14.5,19.5,6.7,7.1,23.0,15.0,3.8,3.6,5.0,18.0,11.6,11.9,13.0,21.0,20.2,22.8,20.0,27.0,13.4,8.7,11.0,2.0,5.1,5.0,17.5,11.5,42.7,44.0,25.0,15.0,,,,,-72.0,15.0,1.7631578947368425,1.9722222222222217,2.0,13.0
1998.0,168.0,172.0,7.0,24.0,243.0,298.0,17.0,30.0,140.0,180.0,24.0,27.0,86.0,90.0,14.0,22.5,17.0,28.0,17.5,29.0,4.0,0.0,2.0,0.0,4.9,5.6,20.5,19.5,6974.0,18.0,5.9,6.5,21.0,18.5,29.0,144.0,163.0,28.0,20.0,-2.2,20.0,28.5,30.7,13.5,25.5,272.0,57.0,58.6,22.5,15.0,316.0,23.0,24.0,16.0,16.5,18.0,20.0,,,,,,,,,,,,,75.0,86.7,25.5,21.5,0.0,6.0,5.0,17.0,0.0,0.0,6.0,5.0,10.0,0.0,15.0,6.0,30.0,22.5,16.375,18.0,20.81875,28.0,19.7,25.0,21.9375,23.0,31.0,0.0,1.0,25.0,0.4838709677419355,18.0,20.04057239057239,23.0,22.8,24.5,15.0,3.1,3.2,18.0,15.5,2.0,0.0,17.0,16.0,12.5,DC,69.0,57.0,12.0,6.0,2.0,2.0,28.0,2.5,1700.0,1168.0,6.0,3.5,5.5,6.2,23.0,21.0,22.33333333333333,26.0,0.0,1.0,269.0,335.0,16.0,-66.0,20.0,26.0,477.0,539.0,19.5,25.0,0.5593952483801296,0.5504761904761905,17.0,14.0,1.627906976744186,17.0,16.0,3.4,3.7,9.0,22.0,20.0,10.0,24.0,0.6956521739130435,0.625,18.0,10.0,0.6378390395731436,0.6781196903907872,12.0,17.0,2869.0,3592.0,24.0,25.0,113.0,909.0,1013.0,26.0,14.0,122.0,24.0,14.5,0.06995884773662553,0.09395973154362416,14.0,28.0,5.1,5.7,26.5,26.0,926.0,1050.0,24.0,30.0,92.0,2.0,0.0,15.5,29.5,40.0,17.5,4036.0,3655.0,22.0,9.0,86.0,21.0,8.0,2.0,1.0,22.5,3.0,541.0,284.0,6.0,6.0,1.21,1.62,15.0,25.5,43.0,10.0,75.2,80.1,19.5,19.0,3152.0,25.0,0.6142857142857143,14.0,0.4406047516198705,0.4495238095238096,14.0,17.0,0.3043478260869565,0.375,13.0,21.0,0.3621609604268564,0.3218803096092128,19.0,14.0,408.0,472.0,16.0,23.0,7.0,12.0,16.0,26.5,1629.0,1705.0,17.0,20.0,9.586419753086421,2.0,23.8,31.4,19.0,26.0,2.0,0.0,41.0,7.9,6.7,20.0,19.0,283.0,286.0,6.0,20.0,39.0,16.0,18.5,28.0,30.0,13.5,15.0,21.0,26.0,21.5,19.0,30.0,14.9,11.6,23.0,17.0,23.0,23.0,-7.0,23.0,16.5,17.28114478114478,20.0,24192.0,28036.0,26.0,BAL,4498.0,5297.0,22.0,26.0,100.0,100.0,21.0,9.0,24.0,35.0,16.0,25.0,24.0,35.0,16.5,25.0,6.6,7.2,23.5,20.0,4.0,3.6,7.0,14.5,11.6,12.3,19.0,19.5,24.6,20.5,10.0,4.0,12.6,7.1,4.0,4.5,4.9,5.0,15.5,17.0,43.9,42.5,10.0,13.0,24.5,28.8,25.0,20.5,-799.0,25.0,1.65,2.0,5.0,21.0
1999.0,217.0,211.0,29.0,1.0,259.0,260.0,5.5,27.0,148.0,158.0,10.0,26.0,87.0,70.0,2.0,19.0,24.0,32.0,28.0,15.0,1.0,0.0,1.0,4.0,4.2,3.8,2.0,26.5,6639.0,26.0,5.3,4.6,2.0,25.5,34.0,131.0,139.0,7.0,28.0,2.9999999999999964,6.0,32.8,29.8,7.0,8.0,270.0,49.5,54.8,7.5,31.0,328.0,26.0,29.0,26.0,8.5,5.166666666666667,1.0,,,,,,,,,,,,,84.8,76.0,12.0,7.5,4.0,9.0,8.0,7.0,5.0,4.0,9.0,6.0,7.0,2.0,11.0,10.0,22.5,13.0,9.166666666666666,3.0,18.775,23.0,20.8,27.0,16.75,17.0,24.0,0.0,1.0,12.5,0.4583333333333333,17.0,12.582154882154882,8.0,11.4,7.0,20.0,3.7,3.5,14.0,23.5,4.0,3.0,21.0,9.5,22.5,DC,54.0,70.0,21.5,28.5,0.0,0.0,11.0,21.0,1098.0,1479.0,20.0,28.0,5.0,4.6,1.0,27.5,19.416666666666668,23.0,0.0,0.0,324.0,277.0,6.0,47.0,11.0,14.0,546.0,599.0,30.0,13.5,0.5827686350435625,0.6230769230769231,3.0,13.0,1.7011494252873562,17.0,21.0,3.8,3.3,6.5,18.0,20.0,13.5,15.5,0.7,0.7692307692307693,3.0,12.0,0.6329007953118461,0.7084320227380388,6.0,21.0,3024.0,2991.0,6.0,25.0,125.0,1010.0,1118.0,30.0,27.0,122.0,26.0,28.0,0.09266409266409266,0.12307692307692307,1.0,11.0,4.9,5.0,2.5,29.0,1033.0,1040.0,21.5,13.0,104.0,1.0,0.0,16.0,26.0,43.0,21.5,4397.0,4853.0,31.0,3.0,115.0,31.0,3.5,0.0,1.0,23.5,22.5,452.0,468.0,26.0,7.0,1.35,1.13,3.0,22.0,59.0,1.0,66.5,67.1,4.0,27.0,3360.0,24.0,0.5878378378378378,15.0,0.4172313649564375,0.3769230769230769,29.0,19.0,0.30000000000000004,0.23076923076923075,29.0,20.0,0.3670992046881541,0.29156797726196115,26.0,11.0,431.0,392.0,5.0,16.0,9.0,6.0,4.0,22.0,1754.0,1231.0,2.0,16.0,17.69135802469136,23.0,26.7,21.3,1.0,22.0,1.0,0.0,56.0,9.3,7.6,9.0,27.0,336.0,291.0,6.5,27.0,49.0,6.0,28.5,33.0,25.0,6.0,11.0,28.0,19.0,6.0,7.0,31.0,13.8,12.8,19.5,12.0,31.0,15.0,0.0,14.0,14.0,13.764309764309766,8.0,28427.0,29329.0,21.0,BAL,4778.0,4222.0,2.0,24.0,100.0,96.3,3.5,10.5,32.0,27.0,7.0,14.5,32.0,26.0,6.5,14.5,6.2,5.5,1.5,26.0,4.1,3.1,1.5,10.0,12.4,10.0,1.0,11.5,20.3,21.1,15.5,19.5,7.7,10.9,25.0,24.0,4.6,4.1,1.0,25.0,42.3,42.2,21.0,12.0,22.0,19.9,1.0,27.0,556.0,5.0,1.5121951219512195,1.7741935483870968,14.0,27.0
2000.0,195.0,194.0,20.0,9.5,288.0,216.0,2.0,18.0,156.0,135.0,3.0,21.5,116.0,59.0,1.0,6.5,16.0,22.0,11.0,26.5,2.0,0.0,2.0,0.0,4.3,3.9,4.5,23.0,7023.0,18.0,5.3,4.5,2.5,21.5,32.0,164.0,132.0,1.0,3.5,8.199999999999996,1.0,36.8,28.6,2.0,1.0,287.0,56.9,55.9,9.5,23.0,295.0,11.0,21.0,8.0,20.5,2.25,1.0,-117.72,-57.46,190.45,1.0,24.0,-48.51,154.0,1.0,19.0,359.48,1.0,24.0,89.7,73.7,9.0,4.0,2.0,9.0,13.0,12.0,3.0,2.0,9.0,12.0,10.0,2.0,7.0,26.0,1.0,1.0,10.416666666666666,6.0,14.18125,15.0,18.3,21.0,10.0625,6.0,26.0,0.0,0.0,19.5,0.2692307692307692,1.0,6.043771043771044,1.0,2.0,1.0,19.0,3.8,4.4,4.0,21.5,1.0,2.0,23.0,5.0,21.5,DC,45.0,73.0,24.0,31.0,0.0,0.0,10.5,22.5,1005.0,1558.0,22.0,31.0,5.1,5.3,6.5,24.5,15.333333333333336,16.0,0.0,0.0,333.0,165.0,1.0,168.0,2.0,14.0,504.0,528.0,13.0,20.0,0.5170132325141777,0.6093073593073594,5.0,23.0,1.3448275862068966,26.0,20.0,4.0,2.1,2.5,12.5,11.0,2.5,15.5,0.6896551724137931,0.6875,5.0,8.0,0.5614280015955325,0.7554827325434837,1.0,28.0,2815.0,2997.0,8.0,22.0,95.0,730.0,535.0,1.0,10.0,84.0,4.0,11.5,0.05555555555555555,0.10185185185185183,8.0,26.0,5.6,4.9,2.0,10.5,1058.0,924.0,2.0,6.0,86.0,0.0,0.0,16.0,10.0,40.0,20.5,3457.0,3872.0,29.0,15.0,87.0,21.5,10.5,2.0,0.0,10.5,1.5,713.0,373.0,19.0,1.0,1.58,0.79,1.0,14.0,45.0,3.5,72.7,62.5,3.0,20.0,3102.0,23.0,0.7435897435897436,6.0,0.4829867674858223,0.3906926406926407,27.0,9.0,0.31034482758620685,0.3125,27.0,24.0,0.4385719984044675,0.24451726745651625,31.0,4.0,511.0,361.0,3.0,5.0,9.0,5.0,1.0,24.5,2199.0,970.0,1.0,5.0,13.543209876543212,13.0,32.8,15.5,1.0,10.0,1.0,0.0,43.0,7.9,6.2,22.0,21.0,287.0,178.0,25.0,25.0,35.0,22.0,19.5,39.0,19.0,1.0,1.0,35.0,14.0,2.0,1.0,26.0,12.8,23.7,1.0,9.5,49.0,1.0,23.0,1.0,10.5,10.087542087542088,1.0,31980.0,25608.0,2.0,BAL,5014.0,3967.0,2.0,16.0,100.0,83.3,1.0,12.5,30.0,18.0,1.0,20.0,30.0,15.0,1.0,20.0,6.2,6.0,4.5,22.5,4.3,2.7,1.0,9.0,10.8,10.8,5.5,24.5,22.3,21.3,9.0,12.0,15.8,9.3,14.0,1.0,4.7,4.3,2.0,22.0,40.2,44.5,31.0,23.0,25.5,20.4,2.0,20.0,1047.0,4.0,1.4418604651162792,2.222222222222222,2.0,27.5
2001.0,202.0,204.0,30.5,1.0,299.0,262.0,4.0,8.0,180.0,161.0,11.0,11.5,92.0,81.0,5.0,17.5,27.0,20.0,12.0,6.0,6.0,0.0,1.0,0.0,4.6,4.4,7.0,25.5,7306.0,13.0,5.5,5.3,8.0,25.0,31.0,141.0,143.0,3.0,27.0,1.0,13.0,33.4,32.4,24.0,3.5,320.0,57.5,57.8,10.0,20.5,321.0,23.0,11.0,12.0,24.0,5.583333333333332,2.0,-132.23,-41.41,78.03,5.0,25.0,-74.55,76.07,4.0,29.0,161.58,4.0,27.0,85.7,57.6,2.0,5.0,0.0,16.0,10.0,9.0,0.0,0.0,16.0,9.0,5.0,0.0,16.0,12.0,16.5,28.0,10.75,6.0,15.94375,17.5,15.45,18.0,16.4375,17.0,31.0,1.0,0.0,25.0,0.5161290322580645,24.0,12.746801346801345,9.0,13.8,14.0,20.0,3.6,2.9,21.0,18.5,1.0,3.0,16.0,18.0,21.0,DC,57.0,64.0,15.0,23.5,0.0,0.0,11.5,20.0,1347.0,1393.0,17.0,16.0,5.6,5.1,3.0,19.5,18.416666666666668,22.0,0.0,1.0,303.0,265.0,4.0,38.0,11.0,18.0,557.0,555.0,25.0,8.0,0.5527777777777778,0.594059405940594,6.0,20.0,1.9565217391304348,13.0,18.0,3.2,2.9,7.0,23.5,16.0,8.5,19.0,0.6206896551724138,0.6153846153846154,21.0,20.0,0.646760343481655,0.6826360773729194,9.0,19.0,3314.0,3035.0,8.0,16.0,89.0,728.0,903.0,29.0,10.0,105.0,30.0,12.0,0.0903010033444816,0.07633587786259542,17.5,8.0,5.5,5.1,1.5,13.0,1080.0,1010.0,18.0,1.0,87.0,2.0,0.0,16.0,30.0,33.0,8.0,3387.0,4077.0,30.0,15.0,98.0,30.0,7.5,0.0,0.0,10.0,21.5,563.0,183.0,5.0,1.0,1.45,1.17,4.0,20.0,48.0,2.0,72.7,72.8,12.0,25.0,3595.0,17.0,0.5111111111111111,19.0,0.4472222222222222,0.405940594059406,26.0,12.0,0.3793103448275862,0.3846153846153846,11.0,12.0,0.3532396565183449,0.3173639226270806,23.0,13.0,483.0,410.0,9.0,5.0,11.0,10.0,13.5,16.5,1810.0,1411.0,4.0,11.0,10.876543209876543,2.0,29.2,22.1,4.0,18.0,0.0,0.0,40.0,6.7,7.5,9.0,14.0,281.0,290.0,8.0,22.0,45.0,8.0,18.0,35.0,33.0,20.5,6.0,30.0,19.0,5.0,3.0,36.0,16.3,13.2,20.0,22.5,28.0,18.0,-8.0,23.0,25.0,11.693602693602696,5.0,28482.0,29172.0,18.0,BAL,5124.0,4446.0,2.0,14.0,100.0,100.0,22.5,8.0,25.0,28.0,9.5,25.0,25.0,28.0,11.0,25.0,6.5,6.0,1.5,22.5,3.7,3.4,2.5,26.0,11.2,10.4,3.0,22.5,23.6,21.8,19.0,3.0,11.7,5.5,3.0,5.5,4.7,4.4,1.0,23.5,38.9,41.6,14.0,30.0,25.3,21.8,1.0,22.0,678.0,4.0,1.7567567567567566,1.7647058823529411,10.0,11.0
2002.0,197.0,192.0,22.0,7.0,303.0,281.0,7.0,20.0,165.0,155.0,6.0,21.0,107.0,96.0,13.0,12.0,31.0,30.0,25.5,7.0,2.0,0.0,1.0,1.0,4.7,4.9,9.5,25.0,7464.0,16.0,5.6,5.7,9.5,24.5,37.0,144.0,152.0,14.0,26.5,-4.800000000000002,30.0,30.7,35.5,31.5,23.0,300.0,53.7,57.3,8.0,28.0,304.0,12.0,21.0,14.0,16.5,11.916666666666664,8.0,-71.26,-30.27,32.87,6.0,25.0,-33.04,18.26,19.0,19.0,66.59,6.0,26.0,64.0,91.2,31.0,30.0,0.0,6.0,9.0,9.0,1.0,0.0,6.0,6.0,3.0,1.0,20.0,12.0,15.5,32.0,13.916666666666664,10.5,18.0875,21.0,18.05,21.0,18.125,18.0,34.0,1.0,1.0,30.0,0.5882352941176471,29.0,20.676430976430968,25.0,23.4,25.0,20.0,3.6,2.6,23.5,23.5,1.0,2.0,14.0,22.5,23.5,DC,78.0,62.0,10.0,7.0,0.0,1.0,24.0,23.0,1617.0,1392.0,10.0,11.0,5.5,5.3,5.0,24.5,21.83333333333333,25.0,0.0,1.0,307.0,365.0,21.0,-58.0,26.0,25.0,559.0,531.0,13.0,12.0,0.5745909528392685,0.5675944333996024,16.0,13.0,1.5420560747663552,23.0,24.0,4.3,3.6,10.0,11.0,19.0,10.5,12.0,0.7058823529411765,0.5757575757575758,21.5,6.0,0.6327046470931363,0.6335909755588051,19.0,17.0,3254.0,3033.0,5.0,21.0,116.0,968.0,972.0,30.0,27.0,119.0,30.5,27.0,0.10231023102310233,0.10676156583629894,5.0,6.0,5.4,5.4,10.0,24.0,1039.0,1006.0,16.0,13.0,73.0,1.0,0.0,16.5,21.5,37.0,17.5,2895.0,3397.0,26.0,15.0,86.0,27.0,14.5,1.0,1.0,23.5,11.5,450.0,507.0,28.0,6.0,1.45,1.69,16.0,25.0,43.0,7.0,72.5,76.5,11.0,26.0,3523.0,20.0,0.6484848484848484,10.0,0.42540904716073147,0.4324055666003976,17.0,20.0,0.2941176470588235,0.4242424242424242,11.5,27.0,0.3672953529068637,0.3664090244411949,14.0,16.0,442.0,435.0,15.0,15.0,10.0,14.0,13.5,24.0,1889.0,1754.0,12.0,13.0,20.827160493827158,30.0,25.4,33.3,20.0,27.0,1.0,0.0,38.0,6.4,7.0,10.5,18.5,269.0,250.0,12.5,24.0,40.0,10.0,20.0,25.0,34.0,27.5,27.0,16.0,31.0,31.0,28.0,40.0,18.3,13.0,22.0,29.0,26.0,22.5,-14.0,29.0,29.5,17.95286195286195,23.0,28368.0,29184.0,18.0,WAS,5143.0,4787.0,5.0,20.0,97.1,100.0,24.0,26.5,34.0,36.0,16.5,20.5,33.0,36.0,17.0,22.0,6.3,6.2,5.0,25.5,4.3,4.0,11.0,12.0,11.7,10.8,7.5,9.0,20.7,22.5,24.0,21.0,10.5,13.7,29.0,11.0,4.9,4.8,4.5,24.0,39.7,39.5,7.0,27.0,26.0,24.8,5.5,25.0,356.0,14.0,1.4651162790697674,1.55,21.0,25.0
2003.0,180.0,181.0,5.0,29.5,313.0,320.0,26.0,8.5,181.0,177.0,23.5,9.5,101.0,119.0,24.0,15.0,31.0,24.0,12.0,5.5,0.0,0.0,0.0,2.0,5.7,6.0,25.0,11.0,7408.0,12.0,6.6,6.7,24.5,8.5,40.0,165.0,155.0,16.0,5.5,-3.3999999999999986,30.0,29.0,32.4,23.5,32.0,324.0,62.3,58.5,11.0,8.5,297.0,14.0,7.0,6.0,27.5,26.83333333333333,30.5,37.91,65.25,-64.69,29.0,6.0,-14.97,-20.59,30.0,11.0,-74.9,31.0,7.0,88.0,84.8,24.0,5.5,0.0,5.0,10.0,8.0,2.0,0.0,5.0,10.0,7.0,0.0,7.0,10.0,24.0,5.0,24.75,30.0,11.1375,8.0,8.65,8.0,13.625,13.0,16.0,1.0,0.0,2.0,0.4375,10.0,18.8479797979798,20.0,19.1,19.0,15.0,2.9,2.8,23.0,10.5,0.0,2.0,14.0,22.0,10.5,HC,74.0,71.0,20.5,7.0,0.0,0.0,11.5,22.0,1474.0,1470.0,17.0,16.0,6.0,6.3,26.5,13.5,11.333333333333336,9.0,0.0,0.0,346.0,384.0,28.0,-38.0,21.0,13.0,520.0,508.0,14.0,15.5,0.5366088631984586,0.5385385385385385,20.0,20.0,1.792079207920792,11.0,26.0,5.0,4.5,23.5,6.0,23.0,23.5,7.0,0.6842105263157895,0.5609756097560976,23.0,10.0,0.6271345468192907,0.605338078291815,24.0,17.0,3342.0,3402.0,24.0,12.0,107.0,846.0,921.0,19.0,14.0,108.0,20.0,18.0,0.09904153354632587,0.075,24.0,9.0,5.9,5.7,26.0,3.0,1038.0,999.0,17.0,8.5,77.0,0.0,0.0,16.5,8.5,47.0,28.5,3045.0,2848.0,4.0,23.0,67.0,3.5,20.0,1.0,0.0,9.5,9.5,331.0,403.0,22.0,19.0,1.84,2.05,30.0,11.0,30.0,29.5,87.4,83.9,25.0,8.0,3591.0,11.0,0.5580110497237569,22.0,0.4633911368015414,0.4614614614614615,13.0,13.0,0.3157894736842105,0.4390243902439024,10.0,23.0,0.3728654531807093,0.3946619217081849,9.0,16.0,481.0,461.0,21.5,10.5,12.0,18.0,26.5,19.0,1987.0,2218.0,25.5,13.0,17.296296296296298,21.0,33.3,38.1,32.0,11.0,0.0,0.0,37.0,6.6,5.6,23.0,16.0,249.0,196.0,23.0,22.0,30.0,24.5,18.5,25.0,33.0,24.5,26.0,22.0,28.0,27.0,19.5,22.0,11.1,13.3,18.0,5.0,24.0,23.0,2.0,11.5,5.5,18.595959595959595,23.0,29700.0,28055.0,12.0,CIN,5329.0,5620.0,28.0,13.0,100.0,100.0,23.0,8.5,40.0,38.0,22.5,11.0,40.0,38.0,22.5,10.0,6.9,7.1,26.0,11.0,4.1,4.8,29.5,14.5,11.1,12.1,29.0,22.0,19.9,20.7,10.0,28.0,11.0,8.6,12.0,12.0,5.1,5.6,28.5,16.5,39.5,42.5,26.5,25.0,29.6,30.9,30.0,7.0,-291.0,21.0,1.6829268292682928,1.4791666666666667,24.0,12.0
2004.0,202.0,195.0,26.0,3.0,286.0,303.0,15.0,18.0,172.0,158.0,9.5,16.5,93.0,123.0,31.0,19.0,21.0,22.0,8.5,29.5,1.0,0.0,0.0,0.0,4.9,5.1,11.5,23.0,7107.0,18.0,5.6,6.0,13.5,26.0,42.0,139.0,151.0,12.0,29.0,0.4000000000000021,15.5,32.1,31.7,22.5,8.0,324.0,60.4,60.2,16.5,13.0,313.0,19.0,11.0,30.0,6.5,15.5,16.0,-74.72,-21.48,32.81,6.0,21.0,-33.1,16.62,20.0,19.0,66.27,9.0,23.0,87.1,90.3,30.0,5.0,0.0,7.0,12.0,8.0,4.0,0.0,7.0,10.0,7.0,3.0,10.0,16.0,3.5,10.5,14.666666666666664,12.0,16.19375,17.0,16.95,19.0,15.4375,13.0,17.0,1.0,2.0,2.5,0.5882352941176471,28.0,16.622053872053872,16.0,17.5,18.5,22.0,4.1,3.8,8.0,28.5,4.0,4.0,20.0,7.5,29.0,HC,68.0,80.0,28.0,15.0,0.0,0.0,9.0,22.0,1403.0,1573.0,20.0,21.0,5.8,5.9,11.5,20.5,17.583333333333332,17.5,0.0,1.0,374.0,372.0,21.0,2.0,15.0,10.0,536.0,520.0,21.0,11.5,0.5647410358565738,0.5402521823472357,21.0,13.0,1.849462365591397,13.0,23.0,4.3,4.4,16.5,16.0,23.0,17.5,14.0,0.6216216216216216,0.6764705882352942,13.0,17.0,0.6422178988326849,0.6156570363466916,26.0,15.0,3301.0,3303.0,13.0,17.0,103.0,810.0,887.0,14.0,4.0,106.0,9.0,7.5,0.07342657342657342,0.07260726072607261,24.0,29.0,5.1,5.5,17.5,28.0,1004.0,1031.0,25.0,13.5,84.0,1.0,0.0,16.5,27.0,51.0,28.5,3541.0,3310.0,19.0,10.0,79.0,17.0,10.5,0.0,0.0,12.0,20.5,328.0,378.0,23.0,17.0,1.68,1.65,15.0,16.0,35.0,21.5,77.0,79.5,17.0,19.0,3520.0,17.0,0.5406976744186046,20.0,0.43525896414342624,0.4597478176527643,12.0,20.0,0.3783783783783784,0.32352941176470584,20.0,16.0,0.3577821011673151,0.3843429636533085,7.0,18.0,437.0,474.0,21.5,18.0,14.0,11.0,12.0,13.5,1839.0,2062.0,26.0,17.0,13.617283950617285,6.0,31.7,31.8,18.0,15.0,0.0,1.0,31.0,5.5,6.6,19.5,8.0,219.0,257.0,10.0,13.0,37.0,18.5,7.5,31.0,31.0,25.5,6.5,27.0,28.0,30.0,5.5,32.0,15.8,16.4,13.0,23.5,36.0,4.0,4.0,15.0,24.0,15.744107744107742,13.0,28078.0,29445.0,22.0,CIN,5140.0,5365.0,19.0,18.0,100.0,100.0,21.5,12.0,41.0,40.0,22.0,10.0,41.0,40.0,22.0,9.5,6.6,6.8,11.5,22.5,4.2,4.4,22.5,15.0,10.9,11.4,10.0,26.5,20.6,19.7,5.0,23.5,9.4,7.4,12.0,11.0,5.1,5.2,15.0,20.5,42.2,41.9,18.5,15.0,25.4,27.4,13.0,23.0,-225.0,20.0,1.5714285714285712,1.5454545454545452,27.0,24.0
2005.0,179.0,179.0,7.0,25.5,342.0,321.0,28.0,4.0,203.0,185.0,26.0,6.0,109.0,109.0,24.5,9.0,30.0,27.0,12.0,13.0,1.0,0.0,1.0,2.0,6.9,4.7,5.0,3.5,7661.0,6.0,7.3,5.3,4.0,7.5,48.0,165.0,156.0,19.0,6.0,3.6999999999999957,5.0,34.3,30.6,14.5,1.5,362.0,67.3,62.4,27.5,2.0,324.0,25.0,4.0,6.0,29.0,22.41666666666667,25.0,86.71,111.15,-41.11,24.0,5.0,-10.64,10.69,25.0,7.0,-26.11,25.0,5.0,87.5,89.3,29.0,6.5,0.0,11.0,11.0,9.0,1.0,0.0,11.0,10.0,7.0,0.0,6.0,13.0,12.0,1.0,21.625,27.0,7.5875,4.0,5.05,2.0,10.125,8.0,18.0,0.0,0.0,4.5,0.3333333333333333,1.0,11.718855218855223,9.0,9.0,8.5,14.0,2.6,6.0,1.0,9.0,1.0,1.0,31.0,1.0,11.0,HC,67.0,85.0,30.5,20.0,0.0,1.0,27.0,21.5,1580.0,1787.0,27.0,9.5,6.8,6.5,29.0,7.0,6.0,5.0,0.0,0.0,421.0,350.0,22.0,71.0,10.0,4.0,538.0,519.0,17.0,12.0,0.5491159135559921,0.5604508196721312,16.0,16.0,1.8623853211009167,16.0,32.0,5.9,4.0,19.5,2.0,21.0,21.0,1.0,0.6808510638297872,0.5675675675675675,21.0,6.0,0.6666666666666666,0.658608599372578,11.0,11.0,3820.0,3569.0,26.0,5.0,110.0,920.0,985.0,21.5,17.0,110.0,12.0,14.0,0.08771929824561403,0.08411214953271028,23.5,18.0,5.9,5.6,20.0,3.5,1018.0,976.0,10.0,18.0,61.0,1.0,0.0,16.5,28.0,32.0,5.5,2634.0,2105.0,1.0,30.0,50.0,1.0,31.0,0.0,0.0,12.5,20.5,157.0,260.0,11.5,32.0,2.31,1.87,25.0,3.0,28.0,30.0,97.6,72.8,5.0,2.0,3935.0,7.0,0.5369458128078818,17.0,0.4508840864440079,0.4395491803278688,17.0,17.0,0.3191489361702128,0.4324324324324325,12.0,27.0,0.33333333333333337,0.34139140062742196,22.0,22.0,459.0,429.0,12.0,14.0,15.0,16.0,23.5,12.5,1910.0,1850.0,20.0,11.0,15.049382716049385,10.0,41.9,34.6,26.0,2.0,0.0,0.0,21.0,3.8,5.1,28.0,2.0,115.0,180.0,30.0,2.0,28.0,29.0,2.0,32.0,28.0,12.0,10.0,28.0,25.0,19.5,5.0,20.0,11.2,23.5,1.0,6.0,44.0,1.0,24.0,1.0,5.0,14.43771043771044,12.0,29535.0,27924.0,14.0,CIN,5730.0,5419.0,28.0,6.0,100.0,100.0,22.5,10.0,47.0,37.0,21.5,4.0,47.0,37.0,22.0,4.0,7.3,7.2,27.0,8.5,4.2,4.3,26.5,10.0,10.9,11.6,21.0,22.0,23.6,21.0,7.0,9.0,5.6,8.1,16.5,31.5,5.6,5.6,29.5,4.5,43.2,42.1,17.0,14.5,32.0,30.2,29.0,3.0,311.0,15.0,1.738095238095238,1.6744186046511629,18.5,13.0
2006.0,188.0,186.0,14.0,16.5,313.0,337.0,32.0,8.0,200.0,206.0,32.0,6.0,88.0,109.0,22.5,23.0,25.0,22.0,13.5,13.0,0.0,0.0,0.0,0.0,6.8,5.8,22.5,4.5,7141.0,19.0,7.7,6.6,21.5,4.0,43.0,146.0,162.0,22.5,27.0,1.6999999999999993,8.5,31.0,29.3,8.5,13.0,327.0,62.5,62.9,26.0,7.0,349.0,31.0,10.0,6.0,28.0,22.33333333333333,24.5,45.9,90.31,-61.78,26.0,6.0,-29.92,21.65,18.0,17.0,-30.17,25.0,8.0,83.3,72.0,5.0,14.0,0.0,9.0,9.0,8.0,4.0,0.0,9.0,8.0,6.0,2.0,11.0,12.0,15.0,15.0,21.166666666666668,27.0,12.83125,11.0,5.6,5.0,20.0625,22.0,25.0,0.0,0.0,18.0,0.44,15.0,15.090909090909092,14.0,14.0,13.0,13.0,2.5,3.4,14.0,8.0,1.0,1.0,19.0,8.5,9.0,HC,59.0,70.0,23.5,22.5,0.0,0.0,13.0,20.0,1209.0,1472.0,18.0,26.0,6.9,6.5,26.5,5.0,10.833333333333336,8.0,0.0,0.0,373.0,331.0,17.0,42.0,10.0,8.0,523.0,555.0,29.0,15.0,0.562374245472837,0.5684007707129094,8.0,13.0,2.272727272727273,2.0,28.0,5.4,4.3,19.5,3.0,24.0,25.5,3.0,0.6666666666666666,0.6153846153846154,13.0,10.5,0.7017575979494689,0.6720647773279352,8.0,5.0,3833.0,3818.0,31.5,6.0,92.0,717.0,836.0,22.0,10.0,97.0,21.5,14.0,0.07987220447284345,0.06528189910979229,24.0,15.0,5.5,5.7,21.0,17.0,994.0,1038.0,28.0,19.5,77.0,0.0,0.0,16.5,11.5,42.0,23.0,3428.0,3132.0,12.0,14.0,72.0,10.5,18.5,0.0,0.0,10.0,22.0,239.0,236.0,5.0,27.0,1.96,1.76,22.0,7.0,36.0,18.5,94.1,84.9,22.0,4.0,4066.0,7.0,0.44,31.0,0.43762575452716296,0.4315992292870906,25.0,20.0,0.33333333333333337,0.3846153846153846,20.0,22.5,0.29824240205053104,0.3279352226720648,25.0,28.0,435.0,448.0,15.0,20.0,14.0,15.0,23.5,12.0,1629.0,1863.0,15.0,26.0,15.111111111111116,11.0,35.6,30.6,15.0,6.0,0.0,0.0,36.0,6.4,5.9,22.5,16.5,233.0,211.0,20.0,19.0,35.0,17.0,18.5,30.0,25.0,7.0,13.0,25.0,18.0,5.0,13.5,24.0,12.2,14.5,16.0,10.0,31.0,8.5,7.0,6.5,9.5,16.181818181818183,14.0,27448.0,30132.0,27.0,CIN,5462.0,5681.0,30.0,8.0,95.2,97.4,6.0,32.0,42.0,38.0,20.5,8.0,40.0,37.0,19.5,10.0,7.8,7.3,27.0,5.0,3.7,4.2,20.0,26.5,12.4,11.5,17.0,4.5,20.5,21.0,6.5,29.0,6.6,5.6,1.0,29.0,5.5,5.5,27.5,7.0,44.5,43.5,16.5,8.0,29.0,30.5,26.5,9.0,-219.0,18.0,2.108108108108108,1.738095238095238,12.0,3.0
2007.0,177.0,181.0,10.0,24.0,320.0,313.0,24.0,9.0,213.0,200.0,28.0,4.0,81.0,98.0,18.0,24.0,26.0,15.0,7.0,7.0,3.0,0.0,1.0,2.0,6.1,6.1,25.0,10.0,7648.0,8.0,6.5,6.6,21.0,13.0,41.0,159.0,162.0,24.0,14.5,-0.7999999999999972,20.0,31.1,31.9,22.0,16.0,373.0,64.9,65.4,30.0,5.0,353.0,27.0,4.0,26.0,7.5,21.33333333333333,21.0,30.63,80.79,-68.42,26.0,8.0,-36.71,46.34,8.0,19.0,-14.52,21.0,9.0,91.2,92.6,31.0,3.0,1.0,12.0,13.0,7.0,1.0,1.0,11.0,13.0,6.0,0.0,10.0,16.0,6.5,12.0,19.08333333333333,20.0,16.03125,17.0,10.0,7.0,22.0625,25.0,20.0,2.0,0.0,8.0,0.5,20.0,17.416161616161617,17.0,17.6,16.0,20.0,3.5,3.5,9.0,20.0,1.0,3.0,19.0,7.5,25.0,HC,73.0,76.0,27.5,7.5,1.0,0.0,7.0,11.5,1684.0,1732.0,27.0,8.0,6.8,6.6,28.0,5.5,14.0,13.5,1.0,0.0,380.0,385.0,24.0,-5.0,17.5,11.0,575.0,540.0,18.0,8.0,0.5873015873015873,0.5558852621167161,20.0,13.0,2.6296296296296298,5.0,26.0,4.5,5.4,28.0,11.5,29.0,29.5,11.0,0.7222222222222222,0.725,9.0,8.0,0.7205459770114943,0.6607526881720429,18.0,5.0,4012.0,3687.0,26.0,7.0,90.0,670.0,712.0,16.0,14.0,88.0,14.5,15.0,0.08125,0.04792332268370607,27.0,10.0,5.9,5.7,21.5,7.0,1008.0,1011.0,19.0,15.0,59.0,0.0,0.0,16.5,11.5,33.0,13.0,2437.0,2303.0,1.0,28.0,58.0,2.0,28.0,0.0,1.0,24.0,22.5,131.0,299.0,13.0,32.0,1.95,1.96,26.0,7.0,27.0,25.0,86.7,89.2,27.0,10.5,4131.0,9.0,0.38028169014084506,28.0,0.4126984126984127,0.4441147378832839,13.0,20.0,0.2777777777777778,0.275,24.0,25.0,0.2794540229885057,0.339247311827957,15.0,28.0,416.0,449.0,19.0,23.0,10.0,11.0,14.0,20.5,1556.0,1893.0,21.0,24.0,16.074074074074073,14.0,37.9,35.9,23.0,6.0,1.0,0.0,17.0,2.9,3.9,32.0,2.0,119.0,128.0,32.0,2.0,22.0,32.0,2.0,34.0,27.0,9.5,8.0,31.0,25.0,13.5,3.0,30.0,15.3,18.8,3.0,19.5,35.0,4.0,5.0,8.5,20.0,17.232323232323232,16.0,28143.0,29322.0,25.0,CIN,5568.0,5580.0,27.0,10.0,100.0,100.0,21.5,12.0,37.0,42.0,24.5,15.0,37.0,42.0,25.0,15.0,7.2,7.1,21.5,11.0,3.7,4.2,21.0,28.5,11.1,10.8,10.0,20.5,23.1,22.8,17.0,13.0,4.9,9.1,17.5,32.0,5.5,5.5,25.5,10.5,41.3,39.7,1.0,27.0,31.4,30.7,27.0,7.0,-12.0,17.0,1.9459459459459456,1.6904761904761902,16.5,6.0
2008.0,186.0,184.0,18.5,13.0,245.0,296.0,16.0,29.0,145.0,169.0,17.0,26.0,80.0,106.0,20.0,29.5,20.0,21.0,21.5,16.5,2.0,0.0,0.0,3.0,3.5,6.1,23.0,31.0,6075.0,31.0,4.3,6.6,18.0,31.0,20.0,151.0,167.0,24.0,24.0,-1.0,21.0,30.1,31.1,21.5,18.0,303.0,59.1,62.3,20.0,23.5,315.0,18.0,20.5,18.0,19.0,15.666666666666664,16.0,-156.24,-89.66,-48.38,19.0,29.0,-63.28,29.93,12.0,31.0,-4.81,15.0,31.0,88.0,95.7,31.0,10.0,1.0,6.0,7.0,11.0,0.0,1.0,6.0,6.0,9.0,0.0,11.0,12.0,11.0,18.5,19.416666666666668,24.0,25.6,31.0,23.7,30.0,27.5,31.0,27.0,2.0,1.0,22.5,0.4074074074074074,11.0,22.463973063973064,26.0,23.8,25.5,15.0,2.9,2.4,22.5,19.0,1.0,2.0,12.0,23.5,18.0,HC,67.0,47.0,2.5,15.0,0.0,0.0,11.0,22.5,1551.0,1059.0,2.0,13.0,4.3,6.3,19.0,32.0,28.83333333333333,32.0,0.0,1.0,204.0,364.0,19.0,-160.0,30.0,32.0,513.0,506.0,13.0,16.0,0.573170731707317,0.5162882527147088,27.0,13.0,1.8125,14.0,11.0,2.1,4.5,25.5,31.5,23.0,24.0,31.0,0.6470588235294118,0.6052631578947368,14.0,8.5,0.6128374936321956,0.6311443932411674,22.0,21.0,2406.0,3287.0,15.0,30.0,75.0,591.0,772.0,24.0,4.5,102.0,27.0,5.0,0.08163265306122447,0.07094594594594594,15.0,6.0,5.4,5.6,16.5,24.5,984.0,1013.0,23.0,17.0,101.0,1.0,0.0,16.5,26.5,48.0,30.0,3984.0,3444.0,22.0,4.0,79.0,23.0,1.0,0.0,1.0,25.5,21.5,253.0,436.0,28.0,23.0,0.99,1.8,18.0,32.0,32.0,18.5,68.0,87.3,21.0,30.0,2677.0,30.0,0.5517241379310345,19.0,0.426829268292683,0.4837117472852912,6.0,20.0,0.3529411764705882,0.3947368421052632,19.0,24.5,0.3871625063678044,0.36885560675883255,11.0,12.0,420.0,490.0,27.0,21.0,6.0,15.0,20.0,31.5,1520.0,1921.0,21.0,29.0,18.135802469135804,23.0,21.0,32.6,14.0,32.0,0.0,0.0,51.0,9.0,3.3,31.0,30.0,271.0,122.0,30.0,26.0,17.0,30.5,30.0,25.0,23.0,3.0,27.5,22.0,22.0,8.0,25.5,26.0,13.4,12.0,20.5,19.0,24.0,18.0,-2.0,20.0,18.0,21.127946127946128,26.0,28086.0,30728.0,22.0,CIN,3926.0,5208.0,12.0,32.0,100.0,100.0,19.0,13.5,18.0,40.0,23.5,31.5,18.0,40.0,23.5,31.5,5.2,6.7,11.5,31.5,3.6,3.9,10.0,30.0,8.8,10.8,6.0,32.0,23.1,22.5,12.5,14.5,7.9,9.1,13.5,26.0,4.0,5.1,11.0,32.0,39.4,43.6,17.0,32.0,21.0,28.2,12.0,32.0,-1282.0,26.0,1.4444444444444444,1.717948717948718,11.0,27.0
2009.0,177.0,185.0,13.5,27.0,295.0,276.0,5.0,18.0,159.0,165.0,6.0,22.5,109.0,95.0,17.5,10.0,27.0,16.0,3.0,8.0,5.0,0.0,2.0,0.0,5.4,4.7,6.5,19.0,7087.0,22.0,6.2,5.5,7.5,17.0,34.0,176.0,148.0,9.0,2.0,-1.6999999999999993,25.0,29.7,31.4,26.0,17.0,286.0,60.0,58.1,6.0,20.0,318.0,16.0,25.0,18.0,14.0,7.916666666666668,5.0,-31.87,11.94,2.81,9.0,17.0,-30.48,29.4,12.0,16.0,40.59,9.0,19.0,82.1,79.3,13.0,19.0,0.0,11.0,10.0,3.0,4.0,0.0,10.0,8.0,3.0,2.0,12.0,6.0,30.0,23.5,11.666666666666664,6.0,16.4375,20.0,17.5,20.0,15.375,14.0,24.0,1.0,0.0,17.0,0.5,19.5,15.237373737373733,14.0,16.0,15.0,13.0,2.7,3.5,9.0,13.5,2.0,2.0,19.0,9.5,9.0,HC,62.0,58.0,12.5,16.5,1.0,0.0,10.0,9.0,1356.0,1289.0,14.0,18.0,5.7,5.6,6.5,20.0,19.75,21.0,0.0,0.0,305.0,291.0,6.0,14.0,16.0,22.0,477.0,547.0,22.0,27.0,0.5004945598417408,0.5928571428571429,10.0,28.0,1.4587155963302751,27.0,21.0,4.4,3.3,8.0,15.5,18.0,8.5,17.5,0.7,0.6,20.0,8.5,0.5843105539830166,0.6737868104520945,13.0,27.0,2890.0,3249.0,6.0,26.0,114.0,863.0,767.0,16.0,26.0,99.0,19.0,27.0,0.09152542372881356,0.05797101449275361,27.0,10.0,5.9,5.5,15.0,5.5,1011.0,980.0,11.0,18.0,86.0,0.0,0.0,16.5,13.5,39.0,19.5,3713.0,3644.0,25.0,9.0,83.0,26.0,9.5,0.0,0.0,11.5,20.5,474.0,393.0,26.0,1.0,1.58,1.51,9.0,20.5,40.0,8.5,82.7,73.6,7.0,17.0,3134.0,24.5,0.6855345911949685,6.0,0.4995054401582592,0.4071428571428571,23.0,5.0,0.30000000000000004,0.4,13.0,24.5,0.4156894460169834,0.32621318954790546,20.0,6.0,505.0,399.0,7.0,4.0,9.0,12.0,15.0,23.0,2056.0,1573.0,7.0,9.0,16.18518518518519,15.0,29.9,28.6,10.5,19.0,0.0,0.0,29.0,5.7,5.9,17.5,10.5,244.0,237.0,12.5,20.0,34.0,16.5,9.0,28.0,29.0,18.0,20.0,23.0,23.0,17.0,17.5,25.0,13.0,13.5,18.5,13.0,25.0,20.0,0.0,18.0,13.0,14.474747474747474,10.0,31152.0,27380.0,5.0,CIN,4946.0,4822.0,4.0,24.0,96.6,100.0,23.0,28.0,29.0,30.0,6.0,23.5,28.0,30.0,6.5,24.5,6.6,6.4,5.5,18.0,4.1,3.9,6.0,21.5,11.0,11.0,11.5,22.5,21.9,22.2,13.0,21.5,11.9,10.1,25.0,2.0,4.9,4.9,3.5,24.5,43.2,43.9,15.0,19.0,27.8,25.8,4.5,19.0,124.0,16.0,1.6097560975609757,1.6410256410256412,18.0,16.0
2010.0,190.0,182.0,11.5,14.0,317.0,290.0,12.0,12.0,206.0,170.0,8.0,5.0,85.0,97.0,18.0,21.5,26.0,23.0,16.5,9.0,4.0,0.0,2.0,1.0,5.5,5.9,19.5,18.5,7385.0,17.0,6.1,6.5,17.5,22.5,36.0,158.0,152.0,11.5,14.0,1.5,11.0,31.2,29.7,16.0,7.0,365.0,61.9,63.4,22.0,15.0,326.0,15.5,5.5,12.0,21.5,18.916666666666668,21.0,-37.44,49.8,-39.6,17.0,15.0,-81.08,4.85,26.0,32.0,-28.78,23.0,21.0,77.4,84.8,20.5,26.0,1.0,12.0,9.0,5.0,4.0,1.0,10.0,9.0,2.0,2.0,14.0,10.0,18.0,25.5,20.666666666666668,27.0,19.40625,23.0,12.75,16.0,26.0625,30.0,21.0,1.0,1.0,12.0,0.6666666666666666,31.5,18.97474747474748,21.0,18.5,19.0,20.0,3.4,3.1,14.0,22.5,1.0,5.0,16.0,15.0,23.5,HC,71.0,64.0,16.5,7.0,0.0,2.0,30.5,24.5,1551.0,1504.0,22.0,10.0,6.1,6.4,24.0,16.0,21.5,23.0,0.0,0.0,322.0,395.0,24.0,-73.0,26.0,22.0,590.0,514.0,9.0,5.5,0.5908221797323135,0.5653082549634274,20.0,9.0,2.4235294117647057,6.0,26.0,4.4,4.1,14.0,18.0,21.0,7.5,12.5,0.7647058823529411,0.5833333333333334,25.0,3.0,0.7122329362828512,0.6530496987951807,21.0,7.0,3767.0,3469.0,14.5,13.0,90.0,725.0,776.0,16.0,12.0,95.0,15.5,12.5,0.08201892744479496,0.07931034482758621,15.0,12.0,5.7,5.4,10.5,13.0,1046.0,957.0,4.5,8.0,72.0,1.0,0.0,16.5,27.0,26.0,3.5,2995.0,3139.0,12.0,26.0,76.0,14.5,24.0,0.0,0.0,10.5,21.0,258.0,124.0,2.0,25.0,1.63,1.85,23.0,21.0,36.0,16.5,82.4,85.2,19.0,18.0,3988.0,13.0,0.41262135922330095,27.0,0.4091778202676865,0.4346917450365726,13.0,24.0,0.2352941176470589,0.4166666666666666,8.0,30.0,0.2877670637171488,0.3469503012048193,12.0,26.0,428.0,416.0,13.5,16.5,8.0,15.0,24.5,29.5,1522.0,1843.0,19.0,27.0,17.425925925925927,21.0,30.5,35.2,22.5,21.0,0.0,0.0,28.0,4.5,5.0,27.0,6.0,221.0,179.0,27.0,14.5,27.0,28.0,8.5,31.0,33.0,22.5,11.0,24.0,28.0,23.5,19.0,34.0,16.3,13.2,15.5,26.0,26.0,18.0,-8.0,25.5,27.0,19.449494949494948,25.0,30020.0,27664.0,12.0,CIN,5289.0,5312.0,15.0,20.0,93.8,100.0,21.0,32.0,32.0,43.0,22.0,23.5,30.0,43.0,22.0,25.5,6.8,7.1,20.5,20.0,3.6,4.4,20.5,32.0,10.9,11.2,14.5,24.0,21.8,23.5,19.0,20.5,7.2,4.8,1.0,25.0,5.1,5.6,26.0,22.0,41.6,41.3,4.0,28.0,27.9,29.2,18.5,18.5,-23.0,18.0,1.8888888888888888,1.6136363636363635,23.0,6.0
2011.0,197.0,200.0,27.0,7.5,285.0,284.0,7.0,22.0,160.0,170.0,8.0,25.0,93.0,94.0,15.0,17.0,32.0,20.0,6.0,8.0,1.0,0.0,0.0,0.0,5.6,5.7,11.5,17.5,6985.0,20.0,6.2,6.7,15.5,18.0,35.0,148.0,142.0,6.5,21.0,4.0,5.0,30.1,26.1,7.0,6.0,308.0,57.6,59.2,12.0,23.0,319.0,13.0,20.0,20.0,11.0,9.333333333333334,7.5,-34.31,13.03,-12.06,9.0,17.0,-39.47,28.67,13.0,26.0,32.41,9.0,19.0,86.8,81.5,11.5,8.0,0.0,14.0,8.0,16.0,0.0,0.0,14.0,5.0,14.0,0.0,8.0,12.0,5.0,12.5,10.416666666666666,6.0,17.51875,20.0,16.6,17.0,18.4375,19.0,17.0,2.0,0.0,11.0,0.4705882352941176,19.5,12.894444444444444,11.0,12.4,12.0,14.0,2.6,1.9,26.0,13.5,1.0,1.0,10.0,26.5,14.0,HC,45.0,44.0,15.0,14.0,0.0,0.0,12.0,21.0,1026.0,916.0,11.0,15.0,6.0,5.8,4.0,16.5,18.83333333333333,18.0,0.0,0.0,344.0,323.0,9.0,21.0,13.0,18.0,535.0,539.0,18.0,20.0,0.5517241379310345,0.578790882061447,15.0,24.0,1.7204301075268815,22.0,21.0,3.9,3.9,12.0,18.5,21.0,10.5,15.0,0.6774193548387096,0.6,23.5,10.0,0.6525986713559985,0.6689723320158103,12.0,18.0,3340.0,3385.0,9.0,20.0,99.0,874.0,878.0,17.0,20.0,101.0,17.5,14.0,0.11228070175438597,0.07042253521126761,26.0,2.0,5.3,5.2,3.5,24.5,1015.0,1009.0,16.0,17.0,91.0,0.0,0.0,16.5,12.0,38.0,19.0,4023.0,0.0,16.5,8.0,98.0,32.0,7.0,1.0,1.0,23.0,9.5,610.0,273.0,11.0,2.0,1.6,1.56,9.0,20.0,53.0,1.0,79.6,85.0,17.0,16.0,3507.0,21.0,0.58125,11.0,0.4482758620689655,0.4212091179385529,18.0,9.0,0.3225806451612904,0.4,9.5,23.0,0.34740132864400153,0.3310276679841897,21.0,15.0,455.0,425.0,14.0,10.0,10.0,14.0,21.0,21.5,1778.0,1675.0,10.0,19.0,11.537037037037035,3.0,32.5,28.5,5.0,16.5,1.0,0.0,25.0,4.5,7.7,4.0,5.5,167.0,277.0,9.0,5.0,45.0,5.0,4.5,38.0,27.0,5.5,5.5,33.0,22.0,7.0,2.5,22.0,9.6,11.0,23.0,4.0,22.0,22.0,0.0,17.0,9.5,13.388888888888884,7.0,29156.0,28400.0,14.0,CIN,5118.0,5060.0,7.0,20.0,97.1,100.0,20.0,31.0,34.0,35.0,12.0,20.5,33.0,35.0,12.5,22.5,6.6,6.8,8.0,23.5,3.9,3.9,7.0,27.0,11.4,11.5,7.0,24.0,22.8,20.8,2.5,24.0,11.5,7.2,7.0,7.0,5.0,5.0,4.5,24.0,44.2,0.0,16.5,19.0,26.0,25.0,4.0,21.5,58.0,13.0,1.6923076923076923,1.7435897435897436,14.0,19.5
2012.0,195.0,191.0,21.0,5.5,292.0,307.0,13.0,24.5,173.0,183.0,11.5,20.0,95.0,99.0,17.5,17.0,24.0,25.0,6.5,23.5,0.0,0.0,0.0,1.0,5.8,5.1,6.5,18.0,7010.0,20.0,6.8,6.2,8.5,15.5,43.0,150.0,149.0,7.5,25.5,5.599999999999998,2.0,31.2,25.6,6.0,3.5,335.0,62.0,61.8,18.5,13.0,346.0,18.5,15.0,18.0,18.5,8.75,7.0,-3.9,5.27,25.72,4.0,23.0,-6.56,18.86,16.0,10.0,51.85,5.0,20.0,85.7,84.4,17.5,15.0,2.0,8.0,9.0,12.0,4.0,2.0,8.0,9.0,9.0,2.0,10.0,16.0,3.0,18.5,9.333333333333334,5.0,16.19375,18.0,14.2,17.0,18.1875,18.0,19.0,1.0,0.0,10.0,0.5263157894736842,25.0,11.937878787878788,9.0,9.8,9.0,16.0,3.0,2.5,16.5,25.0,2.0,4.0,14.0,17.0,19.5,HC,41.0,60.0,29.5,19.0,0.0,1.0,26.0,22.5,928.0,1468.0,30.0,22.0,6.1,5.6,6.0,19.0,19.33333333333333,19.0,0.0,0.0,391.0,320.0,8.0,71.0,10.0,12.0,540.0,560.0,18.0,19.5,0.5767716535433071,0.5909090909090909,13.0,18.0,1.8210526315789481,18.0,28.0,5.2,2.9,4.5,8.5,16.0,4.5,7.0,0.7179487179487181,0.5517241379310345,26.0,11.0,0.6721773436032312,0.6647116324535679,16.0,18.0,3578.0,3400.0,7.0,17.0,99.0,857.0,779.0,10.0,17.5,90.0,9.0,12.0,0.0821917808219178,0.08143322475570032,24.0,20.0,5.4,5.6,12.0,25.5,1016.0,1034.0,21.0,16.0,76.0,0.0,0.0,16.5,9.0,27.0,5.5,3540.0,0.0,16.5,15.0,86.0,23.5,18.0,1.0,0.0,9.5,9.0,488.0,210.0,5.0,3.0,1.86,1.49,6.0,17.0,47.0,3.0,88.1,80.7,12.0,12.5,3807.0,17.0,0.5491329479768786,15.0,0.42322834645669294,0.40909090909090906,20.0,15.0,0.28205128205128205,0.4482758620689655,7.0,22.0,0.3278226563967688,0.3352883675464321,17.0,15.0,430.0,423.0,15.0,17.0,11.0,13.0,19.0,19.0,1745.0,1715.0,12.0,18.0,14.166666666666668,7.0,35.4,29.3,7.0,15.0,0.0,0.0,46.0,7.8,8.3,3.0,24.5,229.0,361.0,2.0,15.0,51.0,3.0,26.0,35.0,32.0,18.5,7.5,30.0,27.0,17.5,7.5,26.0,12.8,14.1,10.0,19.0,30.0,8.0,4.0,11.0,19.5,14.075757575757574,10.0,29250.0,28459.0,15.0,CIN,5323.0,5115.0,6.0,22.0,100.0,100.0,19.0,14.0,43.0,33.0,10.0,12.0,43.0,33.0,10.5,11.5,7.1,6.7,8.0,14.5,4.1,4.1,11.5,19.0,11.4,10.9,8.0,20.0,22.6,24.5,20.0,19.0,10.4,7.8,6.5,11.0,5.2,4.9,4.5,22.5,46.6,0.0,16.5,11.5,27.2,26.7,7.0,24.0,208.0,11.0,1.7317073170731707,1.6341463414634148,21.0,13.0
2013.0,201.0,197.0,22.0,6.5,330.0,282.0,4.0,9.5,205.0,178.0,7.5,11.0,101.0,72.0,5.0,17.0,24.0,32.0,23.5,23.5,1.0,0.0,0.0,0.0,6.3,4.4,2.0,11.5,7625.0,8.0,6.9,5.2,2.0,12.5,54.0,157.0,140.0,4.0,10.5,-2.6000000000000014,24.0,26.9,29.5,23.0,23.0,364.0,62.0,59.0,10.0,11.0,362.0,24.0,13.0,42.0,1.5,5.5,2.5,12.59,64.92,52.31,2.0,15.0,-43.09,31.96,15.0,23.0,92.93,2.0,19.0,81.8,83.9,10.0,23.0,0.0,2.0,7.0,9.0,4.0,0.0,2.0,6.0,7.0,3.0,10.0,11.0,12.5,20.0,5.416666666666668,1.0,13.89375,12.0,10.6,12.0,17.1875,18.0,20.0,2.0,1.0,17.0,0.5,19.5,10.751178451178449,6.0,9.6,7.0,20.0,3.4,3.3,7.0,24.0,4.0,2.0,20.0,6.0,25.0,HC,39.0,52.0,26.5,18.5,0.0,0.0,12.5,19.0,980.0,1219.0,27.0,13.0,6.7,5.1,2.0,9.0,14.583333333333336,14.0,1.0,0.0,430.0,305.0,5.5,125.0,5.0,6.5,587.0,614.0,28.0,12.0,0.5615314494074749,0.6305182341650671,3.0,23.0,2.0297029702970297,19.0,33.0,5.6,3.6,7.0,6.5,22.0,11.0,3.5,0.7021276595744681,0.7857142857142857,4.0,13.0,0.7020879307418095,0.6841243862520459,15.0,13.0,4136.0,3344.0,5.0,8.0,102.0,1000.0,692.0,4.0,27.5,69.0,1.5,19.5,0.07272727272727272,0.11347517730496455,7.0,26.0,5.6,5.4,9.0,15.0,1097.0,1042.0,19.5,6.0,75.0,0.0,0.0,16.5,9.0,27.0,6.0,3330.0,0.0,16.5,23.0,90.0,29.0,23.5,0.0,1.0,27.0,22.5,424.0,254.0,12.0,4.0,1.91,1.39,3.0,13.0,47.0,3.0,89.0,74.2,2.0,12.0,4318.0,11.0,0.4926829268292683,14.0,0.4384685505925251,0.3694817658349329,30.0,10.0,0.2978723404255319,0.2142857142857143,29.0,20.0,0.2979120692581905,0.3158756137479541,18.0,20.0,481.0,385.0,5.0,8.0,14.0,6.0,4.0,14.5,1755.0,1544.0,5.0,18.0,16.864197530864196,17.0,32.3,27.4,3.0,18.0,0.0,1.0,29.0,4.7,6.5,14.5,3.0,182.0,279.0,11.0,5.0,43.0,10.0,3.0,22.0,31.0,18.5,32.0,18.0,26.0,15.0,32.0,30.0,14.9,15.2,5.5,26.5,31.0,4.0,1.0,13.0,25.0,11.902356902356901,3.0,31557.0,27580.0,2.0,CIN,5891.0,4888.0,3.0,10.0,98.1,100.0,19.0,28.0,53.0,31.0,5.0,2.0,52.0,31.0,5.0,2.5,7.4,5.9,2.0,10.0,3.6,4.0,14.5,27.5,11.9,10.0,2.0,10.0,25.1,23.4,17.5,5.0,9.0,9.4,20.5,15.5,5.4,4.7,2.0,12.0,44.4,0.0,16.5,20.0,29.2,24.8,3.0,14.0,1003.0,4.0,2.055555555555556,1.475,31.0,4.0
2014.0,191.0,184.0,20.0,11.5,313.0,337.0,25.0,18.5,164.0,197.0,21.0,27.0,122.0,105.0,24.0,2.0,27.0,35.0,24.0,24.0,1.0,0.0,1.0,0.0,5.8,5.3,7.0,20.0,7370.0,9.0,6.3,5.7,3.5,26.0,40.0,153.0,159.0,18.5,21.5,4.100000000000001,3.0,30.3,26.2,9.0,4.0,323.0,64.2,60.0,9.0,13.0,365.0,24.5,22.0,12.0,24.5,16.75,20.0,7.02,9.94,-53.38,15.0,24.0,3.67,9.88,22.0,4.0,-30.61,16.0,19.0,78.8,81.3,10.5,26.0,0.0,6.0,12.0,12.0,3.0,0.0,6.0,10.0,10.0,0.0,9.0,6.0,28.0,14.0,17.666666666666668,21.0,13.55,11.0,21.1,27.0,6.0,2.0,20.0,0.0,1.0,15.0,0.45,17.0,14.628282828282828,14.0,14.1,14.0,17.0,3.4,3.3,5.5,29.5,1.0,2.0,20.0,4.0,24.5,HC,45.0,44.0,23.0,9.0,0.0,0.0,13.5,19.0,1241.0,1123.0,25.0,4.0,6.5,6.2,13.5,16.0,16.25,15.0,0.0,0.0,365.0,344.0,12.0,21.0,14.0,15.0,503.0,608.0,30.0,25.0,0.5166994106090373,0.5885660731021556,14.0,29.0,1.3442622950819672,31.0,20.0,4.0,3.0,2.0,20.0,18.0,3.5,24.0,0.5128205128205128,0.5294117647058824,31.0,29.0,0.6144037356321839,0.6762915289615585,18.0,28.0,3421.0,3888.0,20.0,21.0,102.0,812.0,876.0,16.0,8.0,105.0,18.0,12.0,0.08626198083067092,0.10385756676557864,14.0,24.0,5.5,6.0,27.5,23.0,1018.0,1067.0,26.5,17.0,73.0,0.0,0.0,16.5,6.5,30.0,14.5,3419.0,3274.0,12.0,12.0,75.0,15.0,17.5,0.0,1.0,26.0,21.5,436.0,226.0,10.0,4.0,1.84,1.72,12.5,16.0,40.0,7.0,84.2,75.8,3.0,24.0,3551.0,25.0,0.7439024390243902,2.0,0.4833005893909626,0.4114339268978444,19.0,4.0,0.4871794871794872,0.4705882352941176,2.0,4.0,0.3855962643678161,0.3237084710384415,15.0,5.0,492.0,439.0,21.0,5.0,19.0,16.0,27.0,2.0,2147.0,1861.0,20.0,6.0,11.574074074074074,8.0,34.0,32.6,14.5,16.0,3.0,0.0,23.0,4.4,3.2,32.0,6.5,130.0,125.0,32.0,3.0,20.0,32.0,3.0,33.0,32.0,17.0,13.0,26.0,26.0,16.0,15.5,26.0,13.1,13.6,9.5,23.5,26.0,11.5,0.0,16.5,22.0,15.156565656565654,15.0,29223.0,29256.0,16.0,CIN,5568.0,5749.0,22.0,15.0,100.0,100.0,20.0,13.5,39.0,34.0,9.5,16.0,39.0,34.0,9.5,16.0,7.1,6.6,6.0,18.0,4.4,4.2,16.5,11.0,11.0,11.0,7.5,24.0,27.6,25.5,22.0,4.0,10.9,7.5,10.0,7.0,5.5,5.4,16.0,12.5,46.8,43.7,9.0,3.0,29.1,31.1,22.0,20.0,-181.0,21.0,1.6136363636363635,1.5714285714285712,27.0,22.0
2015.0,182.0,180.0,8.5,20.5,324.0,307.0,10.5,15.0,191.0,202.0,21.5,23.0,99.0,74.0,4.5,10.0,34.0,31.0,18.0,13.0,1.0,0.0,1.0,0.0,7.7,4.9,3.5,2.5,6959.0,19.0,8.6,5.7,2.5,3.0,50.0,165.0,159.0,20.5,11.0,5.400000000000002,3.0,30.1,24.7,4.0,4.5,334.0,66.1,64.2,19.5,7.0,415.0,31.0,23.0,6.0,29.0,9.583333333333334,8.0,97.28,159.94,-15.92,7.0,5.0,-50.08,27.56,19.0,25.0,24.23,10.0,7.0,82.1,83.9,16.5,22.0,0.0,6.0,6.0,13.0,3.0,0.0,6.0,5.0,10.0,2.0,8.0,7.0,27.5,10.5,12.5,9.0,11.0375,6.0,11.45,9.0,10.625,6.0,17.0,0.0,2.0,9.0,0.4705882352941176,14.5,9.565319865319864,4.0,6.9,4.0,9.0,1.8,3.3,3.5,5.5,1.0,1.0,21.0,3.0,6.0,HC,34.0,46.0,27.5,16.0,0.0,0.0,13.5,19.0,700.0,1041.0,25.0,22.0,7.3,5.8,5.5,3.0,11.333333333333336,8.5,0.0,0.0,419.0,279.0,2.0,140.0,5.0,7.0,505.0,646.0,31.0,26.0,0.5348605577689243,0.6666666666666666,1.0,27.0,1.9292929292929293,21.0,31.0,6.1,2.8,2.0,4.0,18.0,2.0,11.5,0.6326530612244898,0.6923076923076923,19.0,23.0,0.6848812849162011,0.7291399229781772,3.0,20.0,3923.0,3976.0,20.0,15.0,111.0,917.0,1063.0,27.0,18.0,116.0,23.5,19.0,0.10493827160493828,0.1009771986970684,12.0,12.0,5.7,5.9,27.0,16.5,1004.0,1032.0,18.0,25.0,69.0,1.0,0.0,11.0,27.0,32.0,14.0,3116.0,3450.0,17.0,25.0,77.0,18.5,24.5,0.0,0.0,11.5,22.5,350.0,203.0,9.0,11.0,2.26,1.44,3.0,5.0,43.0,5.0,104.1,78.9,5.0,2.0,4104.0,18.0,0.518324607329843,12.0,0.4651394422310757,0.33333333333333337,32.0,6.0,0.36734693877551017,0.3076923076923077,14.0,10.0,0.31511871508379885,0.2708600770218228,30.0,13.0,467.0,344.0,1.0,7.0,18.0,8.0,6.5,4.5,1805.0,1477.0,7.0,13.0,16.956790123456788,20.0,39.6,28.9,6.5,6.0,0.0,0.0,32.0,6.0,6.1,17.5,18.5,181.0,288.0,7.0,6.0,42.0,10.0,9.0,28.0,31.0,19.0,21.5,23.0,26.0,16.5,24.0,17.0,9.3,15.0,4.0,7.5,28.0,6.5,11.0,3.0,5.5,12.23063973063973,5.0,30030.0,28620.0,11.5,CIN,5728.0,5453.0,11.0,15.0,98.0,100.0,30.0,6.0,49.0,27.0,2.0,4.0,48.0,27.0,4.0,4.0,8.1,6.6,4.5,4.0,3.9,4.3,22.0,22.5,12.3,10.3,1.5,5.5,20.6,22.6,12.0,28.5,8.1,6.3,7.0,17.5,5.7,5.3,10.0,7.5,45.2,44.8,13.0,17.5,31.2,30.3,14.0,10.5,275.0,12.0,2.0769230769230766,1.5348837209302326,32.0,4.0
2016.0,176.0,176.0,5.5,28.0,341.0,327.0,18.0,9.0,204.0,196.0,17.0,15.0,100.0,95.0,20.0,10.0,37.0,36.0,28.0,6.5,0.0,0.0,0.0,0.0,6.5,5.6,5.0,14.5,7224.0,4.0,7.5,6.2,3.0,10.0,35.0,165.0,167.0,28.0,9.0,-0.3999999999999986,21.0,26.8,27.2,9.0,28.0,364.0,64.7,63.1,17.0,12.5,374.0,22.0,18.0,2.0,28.0,15.666666666666664,14.0,95.82,99.42,-67.84,15.0,13.0,1.28,6.8,22.0,5.0,-52.04,16.0,9.0,80.0,87.1,21.5,24.0,0.0,13.0,10.0,9.0,3.0,0.0,13.0,9.0,6.0,0.0,9.0,3.0,31.0,17.5,17.208333333333332,17.0,13.1875,11.0,14.0,15.0,12.375,9.0,20.0,0.0,0.0,15.0,0.45,18.0,17.02946127946128,17.0,18.0,19.0,8.0,1.4,2.9,7.5,7.0,0.0,0.0,17.0,6.0,8.0,HC,39.0,40.0,25.5,5.5,0.0,0.0,13.0,19.5,1003.0,891.0,25.0,2.0,6.5,6.1,9.0,15.0,15.25,13.0,0.0,0.0,325.0,315.0,8.0,10.0,19.0,24.0,563.0,593.0,25.0,20.5,0.5752380952380952,0.603082851637765,11.0,23.0,2.04,21.0,18.0,3.2,3.7,9.0,26.0,22.0,12.5,26.0,0.5142857142857142,0.6470588235294118,17.0,29.0,0.6902468919628787,0.6771204561653599,22.0,20.0,3942.0,3800.0,11.0,15.0,88.0,726.0,950.0,21.0,1.0,105.0,14.0,2.5,0.10850439882697947,0.11009174311926606,7.0,8.0,6.1,6.0,23.5,4.5,1050.0,1038.0,24.0,10.0,78.0,0.0,0.0,13.0,13.5,38.0,26.0,3613.0,3333.0,21.0,9.0,74.0,21.0,10.0,0.0,0.0,12.0,20.0,246.0,369.0,26.0,16.5,1.87,1.81,11.0,16.5,38.0,8.5,91.8,83.1,5.0,16.0,4206.0,13.0,0.4901960784313725,12.0,0.4247619047619048,0.39691714836223496,22.0,10.0,0.4857142857142858,0.3529411764705882,16.0,4.0,0.3097531080371213,0.32287954383464,11.0,13.0,446.0,412.0,17.0,9.0,17.0,12.0,14.5,7.5,1769.0,1812.0,21.0,13.0,17.660493827160497,18.0,35.8,34.7,12.0,17.0,1.0,1.0,41.0,6.8,5.3,22.0,26.0,264.0,185.0,25.0,25.0,33.0,21.0,25.5,35.0,31.0,15.0,10.0,28.0,27.0,18.0,12.5,17.0,8.5,11.4,18.5,6.5,20.0,20.0,3.0,12.0,9.0,16.05892255892256,16.0,29040.0,29392.0,23.0,CIN,5711.0,5612.0,17.0,13.0,82.9,87.5,2.5,30.5,35.0,32.0,8.5,17.0,29.0,28.0,5.0,25.0,7.5,6.7,5.5,10.0,4.0,4.4,22.0,21.5,11.6,10.7,7.5,14.5,25.7,22.3,19.0,3.0,6.5,9.7,27.0,28.0,5.4,5.4,11.5,18.5,46.3,45.0,14.0,9.5,32.4,31.8,19.0,11.0,99.0,15.0,1.875,1.5227272727272727,30.0,12.0
