Year,#Dr,#Dr_Defense,#Dr_Defense_Low_Rank,#Dr_High_Rank,1stD,1stD_Defense,1stD_Defense_Low_Rank,1stD_High_Rank,1stDpass,1stDpass_Defense,1stDpass_Defense_Low_Rank,1stDpass_High_Rank,1stDrun,1stDrun_Defense,1stDrun_Defense_Low_Rank,1stDrun_High_Rank,1stPy,1stPy_Defense,1stPy_Defense_Low_Rank,1stPy_High_Rank,2PA,2PA_Defense,2PM,2PM_Defense,ANY/A,ANY/A_Defense,ANY/A_Defense_Low_Rank,ANY/A_High_Rank,APYd,APYd_High_Rank,AY/A,AY/A_Defense,AY/A_Defense_Low_Rank,AY/A_High_Rank,AllTD,AvgDriveTime,AvgDriveTime_Defense,AvgDriveTime_High_Rank,AvgFieldPositionDifferential,AvgFieldPositionDifferential_High_Rank,AvgStartingPosition,AvgStartingPosition_Defense,AvgStartingPosition_Defense_Low_Rank,AvgStartingPosition_High_Rank,Cmp,Cmp%,Cmp%_Defense,Cmp%_Defense_Low_Rank,Cmp%_High_Rank,Cmp_Defense,Cmp_Defense_Low_Rank,Cmp_High_Rank,DefensivePtsScored,DefensivePtsScored_High_Rank,Dscore,Dscore_Rank,ExpectedPoints,ExpectedPointsPassing,ExpectedPointsPassing_Defense,ExpectedPointsPassing_Defense_High_Rank,ExpectedPointsPassing_High_Rank,ExpectedPointsRunning,ExpectedPointsRunning_Defense,ExpectedPointsRunning_Defense_High_Rank,ExpectedPointsRunning_High_Rank,ExpectedPoints_Defense,ExpectedPoints_Defense_High_Rank,ExpectedPoints_High_Rank,FG%,FG%_Defense,FG%_Defense_Low_Rank,FG%_High_Rank,FGA019,FGA2029,FGA3039,FGA4049,FGA50Plus,FGM019,FGM2029,FGM3039,FGM4049,FGM50Plus,FL,FL_Defense,FL_Defense_High_Rank,FL_Low_Rank,FantasyDstScore,FantasyDstScore_Rank,FantasyOffenseScore,FantasyOffenseScore_Rank,FantasyPassScore,FantasyPassScore_Rank,FantasyRushScore,FantasyRushScore_Rank,Fmb,FmbTD,FmbTD_Defense,FumbleLostPercent,FumbleLostPercent_Low_Rank,GameControlPlusBalance,GameControlPlusBalance_Rank,GameControlScore,GameControlScore_Rank,Int,Int%,Int%_Defense,Int%_Defense_High_Rank,Int%_Low_Rank,IntTD,IntTD_Defense,Int_Defense,Int_Defense_High_Rank,Int_Low_Rank,Job,KickRet,KickRet_Defense,KickRet_Defense_Low_Rank,KickRet_High_Rank,KrTD,KrTD_Defense,KrTD_Defense_Low_Rank,KrTD_High_Rank,KrYds,KrYds_Defense,KrYds_Defense_Low_Rank,KrYds_High_Rank,NY/A,NY/A_Defense,NY/A_Defense_Low_Rank,NY/A_High_Rank,Oscore,Oscore_Rank,OthTD,OthTD_Defense,PF,PF_Defense,PF_Defense_Low_Rank,PF_Differential,PF_Differential_High_Rank,PF_High_Rank,PassAtt,PassAtt_Defense,PassAtt_Defense_Low_Rank,PassAtt_High_Rank,PassPercent,PassPercent_Defense,PassPercent_Defense_High_Rank,PassPercent_High_Rank,PassRun1dRatio,PassRun1dRatio_High_Rank,PassTD,PassTD%,PassTD%_Defense,PassTD%_Defense_Low_Rank,PassTD%_High_Rank,PassTD_Defense,PassTD_Defense_Low_Rank,PassTD_High_Rank,PassTdPercent,PassTdPercent_Defense,PassTdPercent_Defense_High_Rank,PassTdPercent_High_Rank,PassYdPercent,PassYdPercent_Defense,PassYdPercent_Defense_High_Rank,PassYdPercent_High_Rank,PassYds,PassYds_Defense,PassYds_Defense_Low_Rank,PassYds_High_Rank,Pen,PenYds,PenYds_Defense,PenYds_Defense_Low_Rank,PenYds_Low_Rank,Pen_Defense,Pen_Defense_Low_Rank,Pen_Low_Rank,Penalty1dPercent,Penalty1dPercent_Defense,Penalty1dPercent_Defense_High_Rank,Penalty1dPercent_High_Rank,Plays/Drive,Plays/Drive_Defense,Plays/Drive_Defense_Low_Rank,Plays/Drive_High_Rank,Ply,Ply_Defense,Ply_Defense_Low_Rank,Ply_High_Rank,Pnt,PntBlck,PntBlck_Defense,PntBlck_Defense_Low_Rank,PntBlck_Low_Rank,PntRet_Defense,PntRet_Defense_Low_Rank,PntYds,PntYds_Defense,PntYds_Defense_Low_Rank,PntYds_High_Rank,Pnt_Defense,Pnt_Defense_Low_Rank,Pnt_High_Rank,PrTD,PrTD_Defense,PrTD_Defense_Low_Rank,PrTD_High_Rank,PrYds,PrYds_Defense,PrYds_Defense_Low_Rank,PrYds_High_Rank,Pts/Drive,Pts/Drive_Defense,Pts/Drive_Defense_Low_Rank,Pts/Drive_High_Rank,PuntRet,PuntRet_High_Rank,QbRating,QbRating_Defense,QbRating_Defense_Low_Rank,QbRating_High_Rank,RawPassYds,RawPassYds_High_Rank,RunPass1dRatio,RunPass1dRatio_High_Rank,RunPercent,RunPercent_Defense,RunPercent_Defense_High_Rank,RunPercent_High_Rank,RunTdPercent,RunTdPercent_Defense,RunTdPercent_Defense_High_Rank,RunTdPercent_High_Rank,RunYdPercent,RunYdPercent_Defense,RunYdPercent_Defense_High_Rank,RunYdPercent_High_Rank,RushAtt,RushAtt_Defense,RushAtt_Defense_Low_Rank,RushAtt_High_Rank,RushTD,RushTD_Defense,RushTD_Defense_Low_Rank,RushTD_High_Rank,RushYds,RushYds_Defense,RushYds_Defense_Low_Rank,RushYds_High_Rank,STscore,STscore_Rank,Sc%,Sc%_Defense,Sc%_Defense_Low_Rank,Sc%_High_Rank,Sfty,Sfty_Defense,Sk,Sk%,Sk%_Defense,Sk%_Defense_High_Rank,Sk%_Low_Rank,SkYds,SkYds_Defense,SkYds_Defense_High_Rank,SkYds_Low_Rank,Sk_Defense,Sk_Defense_High_Rank,Sk_Low_Rank,TFGA,TFGA_Defense,TFGA_Defense_Low_Rank,TFGA_High_Rank,TFGM,TFGM_Defense,TFGM_Defense_Low_Rank,TFGM_High_Rank,TO,TO%,TO%_Defense,TO%_Defense_High_Rank,TO%_Low_Rank,TO_Defense,TO_Defense_High_Rank,TO_Differential,TO_Differential_High_Rank,TO_Low_Rank,ThreePhaseScore,ThreePhaseScore_Rank,TimeOfPossession,TimeOfPossession_Defense,TimeOfPossession_High_Rank,Tm,TotalYds,TotalYds_Defense,TotalYds_Defense_Low_Rank,TotalYds_High_Rank,XP%,XP%_Defense,XP%_Defense_Low_Rank,XP%_High_Rank,XPA,XPA_Defense,XPA_Defense_Low_Rank,XPA_High_Rank,XPM,XPM_Defense,XPM_Defense_Low_Rank,XPM_High_Rank,Y/Apass,Y/Apass_Defense,Y/Apass_Defense_Low_Rank,Y/Apass_High_Rank,Y/Arun,Y/Arun_Defense,Y/Arun_Defense_Low_Rank,Y/Arun_High_Rank,Y/C,Y/C_Defense,Y/C_Defense_Low_Rank,Y/C_High_Rank,Y/KR,Y/KR_Defense,Y/KR_Defense_Low_Rank,Y/KR_High_Rank,Y/PR,Y/PR_Defense,Y/PR_Defense_Low_Rank,Y/PR_High_Rank,Y/Play,Y/Play_Defense,Y/Play_Defense_Low_Rank,Y/Play_High_Rank,Y/Pnt,Y/Pnt_Defense,Y/Pnt_Defense_Low_Rank,Y/Pnt_High_Rank,Yds/Drive,Yds/Drive_Defense,Yds/Drive_Defense_Low_Rank,Yds/Drive_High_Rank,Yds_Differential,Yds_Differential_High_Rank,YppYprRatio,YppYprRatio_Defense,YppYprRatio_Defense_High_Rank,YppYprRatio_High_Rank
2003.0,183.0,182.0,6.0,27.0,305.0,276.0,10.0,12.0,163.0,172.0,20.5,16.0,118.0,84.0,7.0,6.5,24.0,20.0,5.5,18.5,1.0,0.0,0.0,1.0,5.3,5.7,23.0,15.5,7189.0,14.0,5.8,6.2,21.5,17.0,31.0,158.0,157.0,8.5,-5.0,32.0,29.5,34.5,32.0,31.0,303.0,58.8,59.4,17.0,13.0,303.0,17.0,17.5,6.0,27.5,12.25,9.0,-26.71,-4.58,-68.97,30.0,15.0,-10.09,88.48,1.0,9.0,28.96,15.0,14.0,60.6,88.9,28.0,32.0,0.0,11.0,8.0,12.0,2.0,0.0,10.0,4.0,5.0,1.0,14.0,12.0,15.5,23.5,19.58333333333333,24.0,14.35625,13.0,15.9,18.0,12.8125,11.0,27.0,1.0,1.0,0.5185185185185185,25.0,17.929201101928374,19.0,20.2,20.0,17.0,3.3,2.9,19.0,16.0,0.0,1.0,15.0,16.5,16.0,DC,67.0,58.0,8.0,16.0,0.0,0.0,11.5,22.0,1316.0,1227.0,7.0,26.0,6.0,6.1,22.0,13.5,16.083333333333332,16.5,0.0,0.0,276.0,331.0,18.0,-55.0,22.0,25.0,515.0,510.0,16.5,17.5,0.5302734375,0.5471311475409836,17.0,23.0,1.38135593220339,24.0,17.0,3.3,4.5,23.5,24.0,23.0,23.5,22.5,0.5666666666666667,0.6571428571428571,10.0,21.0,0.6131019036954087,0.6980888984324672,2.0,20.0,3285.0,3251.0,18.0,15.0,108.0,895.0,881.0,17.0,19.0,103.0,15.0,20.0,0.07868852459016394,0.07246376811594203,26.0,22.0,5.8,5.5,19.0,5.0,1024.0,976.0,9.5,11.0,69.0,1.0,0.0,16.5,22.5,40.0,22.0,2895.0,3075.0,13.0,26.0,75.0,10.5,28.0,0.0,0.0,9.5,22.5,376.0,420.0,25.0,15.0,1.48,1.78,24.0,18.0,34.0,22.5,76.0,82.0,22.0,17.0,3421.0,15.0,0.7239263803680982,9.0,0.4697265625,0.4528688524590164,16.0,10.0,0.43333333333333335,0.3428571428571429,23.0,12.0,0.3868980963045913,0.3019111015675328,31.0,13.0,481.0,442.0,12.0,10.5,13.0,12.0,14.5,17.0,2073.0,1406.0,2.0,8.0,19.63636363636364,28.0,27.3,33.0,22.5,20.0,0.0,1.0,28.0,5.2,4.5,29.0,9.0,136.0,134.0,29.0,4.5,24.0,29.0,9.5,33.0,27.0,11.5,9.5,20.0,24.0,17.0,23.5,31.0,15.8,14.8,12.0,24.0,27.0,16.5,-4.0,23.0,22.0,15.658402203856747,16.0,28914.0,28574.0,17.0,JAX,5358.0,4657.0,6.0,12.0,100.0,97.1,7.5,8.5,30.0,34.0,14.5,21.5,30.0,33.0,14.5,20.5,6.6,6.6,15.5,18.5,4.3,3.2,1.0,12.0,11.3,11.2,15.5,19.0,19.6,21.2,14.0,30.0,11.1,10.5,21.0,10.5,5.2,4.8,8.0,14.5,42.0,41.0,15.5,10.5,29.2,25.4,10.0,10.0,701.0,7.0,1.5348837209302326,2.0625,1.0,19.0
2004.0,178.0,174.0,2.5,26.5,279.0,290.0,10.5,23.0,161.0,181.0,21.5,21.0,88.0,83.0,6.0,22.0,30.0,26.0,13.5,12.0,4.0,0.0,4.0,2.0,5.5,5.6,19.0,17.5,6616.0,28.0,6.2,6.5,19.0,17.0,26.0,165.0,164.0,8.0,0.0,19.0,28.7,28.7,2.0,28.5,305.0,59.5,61.6,23.0,15.0,306.0,15.0,16.0,4.0,31.0,13.666666666666664,10.0,-45.58,-3.29,-44.37,20.0,17.0,-36.48,37.83,11.0,20.0,0.68,19.0,19.0,77.4,75.0,9.0,23.0,0.0,10.0,11.0,7.0,3.0,0.0,10.0,8.0,5.0,1.0,11.0,12.0,15.5,16.5,17.583333333333332,19.0,17.7125,21.0,15.8,17.0,19.625,21.0,23.0,0.0,3.0,0.4782608695652174,16.5,16.441460055096414,15.0,15.5,14.0,11.0,2.1,3.2,19.0,4.0,0.0,1.0,16.0,17.5,4.5,DC,57.0,50.0,2.0,27.0,0.0,0.0,9.0,22.0,1087.0,995.0,1.0,31.0,5.8,6.3,20.0,20.5,19.75,22.0,0.0,0.0,261.0,280.0,7.0,-19.0,18.0,29.0,513.0,497.0,10.5,19.0,0.549949545913219,0.5493827160493827,17.0,18.0,1.8295454545454544,14.0,17.0,3.3,3.6,9.5,26.0,18.0,8.5,25.0,0.6538461538461539,0.72,7.0,16.0,0.6306648033539629,0.6538761199844176,16.0,19.0,3159.0,3357.0,16.0,19.0,109.0,940.0,966.0,23.0,19.0,118.0,22.5,13.5,0.10752688172043012,0.0896551724137931,23.0,11.0,5.7,5.7,24.5,11.0,991.0,972.0,9.0,19.0,84.0,0.0,0.0,16.5,12.0,38.0,21.0,3592.0,3263.0,17.0,9.0,74.0,12.0,10.5,0.0,2.0,31.5,20.5,405.0,429.0,29.0,8.0,1.43,1.37,5.5,23.0,42.0,9.5,80.7,82.0,18.0,16.0,3315.0,21.0,0.546583850931677,19.0,0.450050454086781,0.4506172839506173,16.0,15.0,0.3461538461538461,0.28,26.0,17.0,0.3693351966460371,0.3461238800155824,17.0,14.0,446.0,438.0,14.0,15.0,9.0,7.0,3.5,27.0,1850.0,1777.0,11.0,16.0,19.181818181818183,24.0,28.1,26.4,9.0,22.0,2.0,0.0,32.0,5.9,6.9,16.5,10.0,156.0,217.0,24.0,5.0,37.0,18.5,9.5,31.0,28.0,19.0,6.5,24.0,21.0,15.5,10.5,22.0,11.8,16.1,14.0,8.0,28.0,18.5,6.0,11.5,7.5,17.382920110192835,18.0,29370.0,28536.0,11.0,JAX,5009.0,5134.0,11.0,21.0,100.0,96.4,1.0,12.0,21.0,28.0,6.5,32.0,21.0,27.0,5.0,32.0,6.5,7.2,21.5,24.5,4.1,4.1,15.0,17.5,10.9,11.7,16.0,26.5,19.1,19.9,6.5,31.5,9.6,11.3,27.5,10.0,5.1,5.3,19.0,20.5,42.8,44.1,30.0,11.0,27.9,29.4,23.0,15.5,-125.0,18.0,1.5853658536585369,1.75609756097561,13.0,23.0
2005.0,193.0,185.0,15.0,9.5,301.0,273.0,8.0,15.5,170.0,158.0,8.0,16.0,97.0,79.0,6.5,14.0,34.0,36.0,29.0,7.0,1.0,0.0,1.0,0.0,6.4,4.8,8.5,8.5,6923.0,21.0,7.2,5.8,11.5,9.0,42.0,158.0,149.0,12.5,7.699999999999997,1.0,34.3,26.6,1.0,1.5,283.0,58.1,59.1,17.0,21.0,285.0,7.0,22.0,12.0,21.0,9.5,5.0,-7.18,41.39,11.73,10.0,11.0,-32.89,51.33,13.0,12.0,75.61,8.0,13.0,76.7,74.1,6.0,22.0,0.0,9.0,8.0,10.0,3.0,0.0,9.0,7.0,5.0,2.0,11.0,9.0,28.0,12.5,11.75,6.0,11.3125,9.0,12.0,11.5,10.625,9.0,27.0,0.0,2.0,0.4074074074074074,8.0,9.464187327823687,4.0,6.0,2.0,6.0,1.2,3.9,6.5,1.0,2.0,0.0,19.0,7.5,1.0,DC,50.0,56.0,5.5,31.0,1.0,0.0,11.5,6.5,1197.0,1327.0,10.0,27.0,6.1,5.6,8.0,13.5,12.75,10.0,0.0,1.0,361.0,269.0,6.0,92.0,8.0,12.0,487.0,482.0,8.0,20.5,0.5083251714005876,0.54932502596054,20.0,24.0,1.7525773195876289,18.0,21.0,4.3,4.6,24.0,10.5,22.0,22.5,14.0,0.5384615384615384,0.8461538461538461,1.0,24.0,0.6195377743251117,0.6328678839957036,21.0,20.0,3190.0,2946.0,7.0,19.0,121.0,1006.0,1055.0,29.0,22.0,130.0,26.5,21.0,0.11295681063122925,0.13186813186813187,2.0,10.0,5.4,5.4,11.5,23.0,1021.0,963.0,7.0,15.5,83.0,1.0,0.0,16.5,28.0,29.0,4.0,3560.0,3766.0,28.0,9.0,88.0,26.0,9.0,0.0,1.0,28.0,20.5,415.0,236.0,7.0,9.0,1.77,1.31,3.0,11.0,53.0,1.5,88.4,78.0,15.0,9.0,3352.0,21.0,0.5705882352941176,15.0,0.4916748285994124,0.4506749740394601,13.0,9.0,0.4615384615384616,0.15384615384615385,32.0,9.0,0.3804622256748883,0.3671321160042964,12.0,13.0,502.0,434.0,14.0,8.0,18.0,4.0,1.0,6.5,1959.0,1709.0,14.0,10.0,17.737373737373733,23.0,32.1,24.9,2.0,13.0,0.0,0.0,32.0,6.2,8.9,1.0,15.0,162.0,277.0,7.0,5.0,47.0,3.5,16.0,30.0,27.0,8.5,15.0,23.0,20.0,5.0,19.0,17.0,8.3,14.1,15.0,3.0,28.0,16.0,11.0,6.0,2.5,12.928374655647385,8.0,30494.0,27565.0,5.0,JAX,5149.0,4655.0,6.0,15.5,97.4,96.7,7.0,25.0,39.0,30.0,9.5,12.0,38.0,29.0,8.5,12.0,6.9,6.7,14.5,14.0,3.9,3.9,13.0,17.5,11.8,11.3,13.5,13.0,23.9,23.7,26.0,7.0,7.8,8.1,16.5,17.0,5.0,4.8,8.5,17.5,42.9,42.8,20.0,18.0,26.7,25.1,10.0,17.5,494.0,10.0,1.7692307692307694,1.717948717948718,12.0,10.0
2006.0,188.0,187.0,17.5,16.5,293.0,259.0,3.0,17.0,147.0,143.0,2.0,26.0,127.0,94.0,9.0,3.0,19.0,22.0,13.5,27.5,0.0,0.0,0.0,0.0,5.4,4.3,3.5,14.0,7083.0,22.0,6.2,5.0,3.0,15.0,42.0,165.0,143.0,5.0,4.200000000000003,2.0,33.2,29.0,5.0,2.0,266.0,59.6,56.2,4.0,18.0,294.0,11.5,27.0,6.0,28.0,7.666666666666668,4.0,3.77,-20.16,65.43,3.0,20.0,32.23,19.35,19.0,3.0,87.75,4.0,11.0,81.3,70.8,4.0,16.0,0.0,6.0,7.0,18.0,1.0,0.0,5.0,7.0,14.0,0.0,9.0,4.0,32.0,7.5,16.333333333333332,16.0,10.95625,8.0,18.6,23.0,3.3125,2.0,16.0,0.0,1.0,0.5625,24.0,8.274242424242425,5.0,5.7,4.0,14.0,3.1,3.8,7.0,13.5,1.0,2.0,20.0,6.5,12.0,DC,49.0,60.0,13.0,31.0,1.0,0.0,13.0,5.0,1136.0,1262.0,7.0,30.0,6.1,5.5,7.5,13.5,9.833333333333334,7.0,0.0,1.0,371.0,274.0,4.0,97.0,5.0,9.0,446.0,523.0,22.0,29.0,0.4812942366026289,0.5705521472392638,7.0,31.0,1.1574803149606299,31.0,17.0,3.8,2.3,2.0,19.0,12.0,2.0,23.0,0.425,0.4615384615384616,31.0,32.0,0.5314401622718052,0.6782723666813574,7.0,31.0,2882.0,3078.0,10.0,24.0,97.0,810.0,684.0,7.0,18.0,80.0,2.0,19.0,0.06484641638225255,0.08494208494208494,15.0,27.0,5.4,5.4,11.0,22.0,989.0,978.0,9.0,21.0,73.0,1.0,0.0,16.5,26.5,29.0,6.5,2961.0,3726.0,24.0,27.0,90.0,28.0,24.0,0.0,2.0,31.5,22.0,361.0,343.0,20.5,13.0,1.9,1.25,4.0,9.0,45.0,8.0,80.0,66.8,4.0,16.0,3060.0,24.0,0.8639455782312925,2.0,0.5187057633973711,0.42944785276073616,26.0,2.0,0.575,0.5384615384615384,2.0,1.0,0.4685598377281948,0.3217276333186426,26.0,2.0,513.0,420.0,8.0,3.5,23.0,14.0,19.5,2.0,2541.0,1460.0,4.0,3.0,16.444444444444443,16.0,35.1,23.0,3.0,7.0,0.0,0.0,30.0,6.3,6.3,17.5,15.0,178.0,200.0,23.0,9.0,35.0,17.0,12.0,32.0,24.0,4.0,8.5,26.0,17.0,2.5,10.0,23.0,11.2,12.8,24.5,6.0,24.0,25.5,1.0,15.5,7.0,10.84848484848485,4.0,31020.0,26741.0,2.0,JAX,5423.0,4538.0,2.0,10.0,100.0,100.0,20.5,11.5,41.0,31.0,7.5,9.5,41.0,31.0,7.5,8.5,6.9,6.3,2.0,13.5,5.0,3.5,4.0,2.5,11.5,11.1,9.5,16.5,23.2,21.0,6.5,11.0,8.0,11.8,28.0,22.5,5.5,4.6,3.5,7.0,40.6,41.4,2.0,31.0,28.8,24.2,4.0,10.5,885.0,4.0,1.38,1.8,10.0,28.0
2007.0,169.0,171.0,3.0,30.0,328.0,286.0,9.0,4.0,180.0,181.0,16.0,16.0,127.0,92.0,15.0,2.0,21.0,13.0,3.5,16.0,1.0,0.0,1.0,3.0,7.1,5.0,9.5,3.0,7387.0,14.0,7.9,5.8,10.0,2.0,50.0,182.0,156.0,3.0,0.5999999999999979,15.5,30.2,29.6,11.5,20.0,288.0,61.4,58.7,7.0,14.0,319.0,14.0,24.5,18.0,12.5,12.166666666666664,9.5,120.14,107.68,-29.7,16.0,5.0,19.5,20.4,21.0,4.0,0.71,20.0,3.0,87.5,78.3,9.0,8.5,2.0,9.0,6.0,7.0,0.0,2.0,9.0,6.0,4.0,0.0,13.0,10.0,21.0,20.5,13.25,11.0,7.73125,2.0,10.4,8.0,5.0625,2.0,18.0,1.0,0.0,0.7222222222222222,31.0,9.151515151515152,6.0,8.0,7.0,8.0,1.7,3.7,5.0,3.0,2.0,1.0,20.0,4.5,1.5,DC,49.0,67.0,18.0,30.0,1.0,2.0,29.5,11.5,1110.0,1323.0,10.0,31.0,6.7,5.9,11.5,7.0,5.416666666666668,3.0,0.0,0.0,411.0,304.0,10.0,107.0,7.0,6.0,469.0,543.0,20.5,27.0,0.4892367906066536,0.5979381443298969,8.0,29.0,1.4173228346456692,29.0,28.0,6.0,3.7,11.5,4.0,20.0,12.0,9.5,0.6086956521739131,0.625,19.5,21.0,0.5819199160692429,0.6803425612427804,11.0,29.0,3328.0,3416.0,15.0,17.0,76.0,594.0,636.0,8.0,5.0,82.0,7.5,5.0,0.06402439024390244,0.045454545454545456,29.0,20.0,6.2,5.8,25.5,3.0,1022.0,970.0,6.0,11.0,54.0,0.0,0.0,16.5,11.5,28.0,5.5,2249.0,2871.0,9.0,30.0,66.0,8.5,30.0,0.0,0.0,9.0,22.5,324.0,218.0,7.0,13.0,2.28,1.63,15.5,4.0,32.0,19.0,97.1,76.1,7.0,3.5,3495.0,20.0,0.7055555555555556,4.0,0.5107632093933464,0.4020618556701031,25.0,4.0,0.3913043478260869,0.375,13.5,12.0,0.4180800839307571,0.31965743875721964,22.0,4.0,522.0,390.0,6.0,2.0,18.0,12.0,18.5,4.0,2391.0,1605.0,11.0,2.0,14.333333333333336,9.0,39.6,29.2,10.0,4.0,0.0,1.0,31.0,6.2,6.4,11.5,18.0,167.0,244.0,10.5,9.0,37.0,10.5,15.0,24.0,23.0,6.0,28.0,21.0,18.0,7.0,26.5,21.0,10.1,17.0,6.0,3.0,30.0,12.5,9.0,6.5,4.5,10.303030303030305,4.0,30758.0,26676.0,3.0,JAX,5719.0,5021.0,12.0,7.0,95.8,100.0,21.5,30.5,48.0,32.0,8.5,5.0,46.0,32.0,10.0,6.5,7.5,6.7,11.0,6.0,4.6,4.1,18.0,4.0,12.1,11.5,20.5,4.0,22.7,19.7,4.0,15.5,10.1,7.8,11.0,8.0,5.6,5.2,18.5,6.5,41.6,43.5,20.5,25.0,33.8,29.4,22.0,3.0,698.0,8.0,1.6304347826086958,1.6341463414634148,19.0,21.0
2008.0,174.0,178.0,13.0,25.0,313.0,309.0,21.0,9.0,157.0,189.0,27.0,21.0,131.0,108.0,21.0,3.0,25.0,12.0,1.0,6.0,1.0,0.0,1.0,3.0,7.0,6.0,21.0,4.5,7665.0,7.0,7.5,6.8,23.0,5.0,43.0,172.0,159.0,6.0,3.3000000000000007,5.0,30.6,27.3,1.0,15.5,265.0,61.1,59.2,11.0,15.0,325.0,22.0,26.5,20.0,15.5,21.08333333333333,24.0,88.17,100.79,-42.4,17.0,6.0,-11.66,-20.95,26.0,11.0,-46.95,22.0,8.0,93.5,80.0,9.0,2.0,0.0,11.0,8.0,10.0,2.0,0.0,11.0,7.0,10.0,1.0,10.0,8.0,22.5,15.0,17.5,18.5,9.55,4.0,14.35,14.0,4.75,3.0,18.0,1.0,1.0,0.5555555555555556,22.5,13.837190082644627,11.0,13.6,12.0,11.0,2.5,1.8,28.0,12.0,2.0,0.0,10.0,27.5,6.5,HC,59.0,71.0,20.0,26.0,0.0,0.0,11.0,22.5,1408.0,1536.0,16.0,20.0,7.4,6.0,13.0,3.0,7.583333333333332,2.0,0.0,0.0,391.0,325.0,11.0,66.0,11.0,10.0,434.0,549.0,25.0,29.0,0.4460929772502473,0.5841683366733467,11.0,31.0,1.1984732824427482,31.0,16.0,3.7,3.6,12.5,20.5,20.0,15.5,22.5,0.41025641025641024,0.5405405405405406,23.0,30.0,0.577262502163004,0.6334890406036651,21.0,26.0,3336.0,3526.0,21.0,14.0,71.0,591.0,854.0,29.0,4.5,109.0,28.5,2.5,0.07987220447284345,0.03883495145631068,32.0,7.0,6.0,5.7,20.0,7.0,1011.0,998.0,18.0,13.0,65.0,2.0,0.0,16.5,31.0,20.0,3.0,2647.0,3458.0,23.0,23.0,76.0,21.0,21.5,1.0,0.0,11.5,7.5,379.0,49.0,1.0,8.0,2.11,1.79,17.0,8.0,43.0,6.0,87.7,84.6,18.0,10.0,3440.0,17.0,0.8343949044585988,2.0,0.5539070227497527,0.4158316633266533,22.0,2.0,0.5897435897435898,0.4594594594594594,10.0,3.0,0.4227374978369961,0.3665109593963349,12.0,7.0,560.0,415.0,11.5,2.0,23.0,17.0,23.0,3.0,2443.0,2040.0,25.0,2.0,13.383838383838384,7.0,39.7,32.0,13.0,6.0,1.0,0.0,17.0,3.8,5.8,18.0,6.0,104.0,245.0,9.0,5.0,34.0,11.5,5.0,31.0,25.0,4.0,18.0,29.0,20.0,4.5,10.0,21.0,10.3,9.0,30.0,7.0,18.0,29.0,-3.0,21.0,9.5,14.074380165289256,10.0,29928.0,28302.0,12.0,ATL,5779.0,5566.0,24.0,6.0,100.0,100.0,19.0,13.5,42.0,35.0,15.0,8.5,42.0,35.0,15.5,8.5,7.9,6.9,16.0,4.5,4.4,4.9,28.5,8.0,13.0,11.6,19.5,2.0,23.9,21.6,8.0,10.0,8.8,2.5,1.0,17.0,5.7,5.6,24.0,7.5,40.7,45.5,27.5,30.0,33.1,31.1,21.5,6.0,213.0,19.0,1.7954545454545454,1.4081632653061225,32.0,10.0
2009.0,170.0,171.0,3.0,31.5,330.0,303.0,17.0,10.5,192.0,197.0,28.0,12.0,105.0,89.0,14.5,11.0,33.0,17.0,5.0,2.5,1.0,0.0,0.0,0.0,5.6,6.6,25.5,16.0,7249.0,20.0,6.1,7.2,23.5,18.0,44.0,169.0,170.0,6.5,2.700000000000003,6.0,30.6,27.9,7.0,8.5,332.0,58.2,62.5,22.0,22.0,335.0,20.0,17.0,18.0,14.0,16.75,18.0,64.33,79.8,-94.1,27.0,11.0,-11.06,42.48,8.0,11.0,-41.5,22.0,10.0,65.5,71.4,5.0,29.0,0.0,6.0,12.0,7.0,4.0,0.0,6.0,8.0,3.0,2.0,8.0,13.0,9.0,5.5,18.166666666666668,19.0,13.375,11.0,14.0,16.0,12.75,11.0,19.0,2.0,0.0,0.42105263157894735,11.0,14.465840220385676,13.0,13.4,12.0,17.0,3.0,2.8,18.0,17.0,1.0,2.0,15.0,17.5,18.0,HC,55.0,46.0,4.0,24.5,0.0,0.0,10.0,23.5,1336.0,945.0,2.0,19.0,6.0,6.9,25.5,17.0,14.333333333333336,13.0,0.0,0.0,363.0,325.0,14.5,38.0,15.0,13.0,570.0,536.0,19.0,7.0,0.5696564885496184,0.5656970912738215,16.0,17.0,1.8285714285714283,20.0,26.0,4.6,4.7,20.0,13.0,25.0,21.0,13.5,0.6341463414634146,0.7142857142857143,6.0,19.0,0.6555902331558656,0.6934790397706915,7.0,19.0,3571.0,3871.0,28.0,14.0,78.0,664.0,892.0,25.0,5.0,110.0,29.0,5.0,0.1,0.056105610561056105,29.0,6.0,6.3,6.0,29.0,1.0,1048.0,997.0,15.0,4.0,63.0,1.0,0.0,16.5,29.5,27.0,5.5,2676.0,2635.0,1.0,28.0,62.0,1.5,29.0,0.0,1.0,27.5,20.5,270.0,289.0,16.0,19.0,2.02,1.78,19.0,8.0,27.0,30.5,80.4,89.5,22.5,19.0,3697.0,16.0,0.546875,13.0,0.4303435114503816,0.4343029087261785,17.0,16.0,0.36585365853658536,0.2857142857142857,27.0,14.0,0.3444097668441344,0.3065209602293085,26.0,14.0,451.0,433.0,16.0,11.0,15.0,10.0,8.5,14.0,1876.0,1711.0,11.0,15.0,15.505050505050509,12.0,35.3,32.2,17.0,10.0,0.0,0.0,27.0,4.5,5.0,26.5,7.0,126.0,170.0,27.0,4.0,28.0,27.0,8.0,29.0,28.0,15.0,15.0,19.0,20.0,9.5,27.0,25.0,13.5,15.2,9.0,16.5,28.0,13.5,3.0,11.5,13.0,15.531680440771352,14.0,28730.0,29070.0,15.5,ATL,5447.0,5582.0,21.0,16.0,97.7,97.4,11.0,23.5,43.0,38.0,19.5,12.0,42.0,37.0,18.0,12.0,6.5,7.5,25.0,21.0,4.2,4.0,9.0,16.5,11.1,12.1,27.0,21.0,24.3,20.5,5.5,6.0,10.0,10.7,28.0,9.5,5.2,5.6,23.5,18.0,42.5,42.5,4.0,23.0,32.1,32.6,29.5,9.0,-135.0,19.0,1.5476190476190474,1.875,4.0,18.0
2010.0,178.0,180.0,8.0,27.0,353.0,284.0,10.5,4.0,200.0,183.0,15.5,9.0,111.0,87.0,9.5,9.0,42.0,14.0,5.5,1.0,3.0,0.0,2.0,1.0,6.2,5.2,6.5,12.0,7075.0,23.5,6.7,5.9,7.0,13.0,47.0,177.0,150.0,1.5,6.8000000000000025,1.0,31.1,24.3,1.0,8.0,361.0,62.6,65.0,28.5,10.0,364.0,29.0,7.0,18.0,15.0,13.583333333333336,11.0,87.95,118.37,-60.0,23.0,6.0,-27.41,23.63,19.0,12.0,-21.42,19.0,8.0,90.3,65.2,1.0,4.0,0.0,11.0,9.0,10.0,1.0,0.0,11.0,8.0,8.0,1.0,8.0,9.0,21.5,7.0,15.083333333333336,12.0,10.56875,5.0,9.7,10.0,11.4375,11.0,12.0,1.0,1.0,0.6666666666666666,31.5,9.029476584022039,3.0,4.8,1.5,9.0,1.6,3.9,4.0,3.0,2.0,0.0,22.0,4.0,4.5,HC,46.0,64.0,16.5,32.0,1.0,1.0,21.5,11.0,1221.0,1362.0,12.0,25.0,5.9,6.1,17.0,21.0,12.583333333333336,13.0,0.0,1.0,414.0,288.0,5.0,126.0,4.0,5.0,577.0,560.0,23.0,8.0,0.5469462169553327,0.6175548589341693,3.0,24.0,1.8018018018018016,19.0,28.0,4.9,4.1,14.0,14.0,23.0,15.5,8.5,0.6666666666666666,0.71875,11.0,14.5,0.6535360938072554,0.6815190825343109,10.0,17.0,3567.0,3625.0,22.0,15.0,58.0,598.0,1003.0,29.0,2.0,116.0,29.0,1.0,0.1189801699716714,0.04929577464788732,28.0,1.0,6.3,5.4,10.5,1.5,1097.0,957.0,4.5,1.0,75.0,1.0,0.0,16.5,27.0,28.0,7.0,3015.0,3322.0,17.0,25.0,73.0,12.5,19.0,1.0,0.0,10.5,6.0,230.0,241.0,8.5,28.0,2.12,1.49,6.5,6.5,19.0,32.0,90.8,82.2,14.0,10.5,3725.0,16.0,0.555,14.0,0.4530537830446673,0.3824451410658307,30.0,9.0,0.33333333333333337,0.28125,22.0,18.5,0.3464639061927446,0.3184809174656891,23.0,16.0,497.0,366.0,2.0,5.0,14.0,9.0,8.5,10.0,1891.0,1694.0,10.0,12.0,13.727272727272727,6.0,39.3,26.1,4.5,6.0,0.0,0.0,23.0,3.8,5.2,25.5,3.5,158.0,221.0,20.0,3.0,31.0,21.0,3.0,31.0,23.0,6.0,11.0,28.0,15.0,1.0,7.0,17.0,9.0,16.1,7.0,3.0,31.0,7.0,14.0,3.0,3.0,13.258953168044071,8.0,31506.0,27000.0,2.0,ATL,5458.0,5319.0,16.0,16.0,100.0,100.0,21.0,12.5,44.0,31.0,7.5,7.5,44.0,31.0,8.0,7.0,6.5,6.9,15.5,26.5,3.8,4.6,26.0,26.5,10.3,10.6,5.5,30.0,26.5,21.3,9.0,1.0,12.1,8.6,12.5,5.5,5.0,5.6,26.0,26.0,40.2,45.5,31.0,30.0,30.7,29.6,20.0,11.5,139.0,14.0,1.7105263157894737,1.5000000000000002,28.0,15.0
2011.0,187.0,180.0,5.5,21.0,349.0,292.0,11.0,6.5,215.0,186.0,15.5,9.0,100.0,87.0,10.0,11.5,34.0,19.0,4.0,3.0,1.0,0.0,0.0,1.0,6.8,5.8,15.0,8.0,7181.0,17.0,7.3,6.5,11.5,10.5,46.0,166.0,150.0,4.0,1.6000000000000014,11.0,28.5,26.9,11.0,16.0,365.0,61.4,60.7,17.5,11.5,340.0,21.5,7.5,18.0,14.0,14.333333333333336,14.0,66.87,113.03,-46.31,17.0,8.0,-38.04,24.21,16.0,24.0,-18.44,17.0,10.0,93.1,82.1,15.0,1.0,2.0,9.0,9.0,7.0,2.0,2.0,9.0,9.0,5.0,2.0,8.0,10.0,16.0,12.5,16.583333333333332,15.0,11.225,6.0,7.7,6.0,14.75,14.0,12.0,1.0,1.0,0.6666666666666666,30.0,10.602617079889807,4.0,7.5,5.0,13.0,2.2,3.4,10.5,8.5,2.0,2.0,19.0,10.5,9.5,HC,24.0,60.0,30.5,32.0,0.0,0.0,12.0,21.0,563.0,1487.0,32.0,32.0,6.8,6.4,20.0,13.0,11.166666666666664,10.0,0.0,1.0,402.0,350.0,18.0,52.0,10.0,7.0,594.0,560.0,21.0,4.0,0.5778191985088537,0.6145077720207254,6.0,16.0,2.15,14.0,29.0,4.9,4.5,20.5,6.5,25.0,20.5,6.5,0.6744186046511628,0.7142857142857143,7.0,11.0,0.6956521739130435,0.7092544023979018,7.0,11.0,4192.0,3786.0,20.0,8.0,93.0,769.0,843.0,13.0,7.0,101.0,17.5,10.0,0.09742120343839544,0.06506849315068493,28.0,12.5,5.9,5.5,14.5,5.5,1073.0,965.0,4.0,3.0,71.0,1.0,0.0,16.5,28.0,31.0,8.5,2990.0,0.0,16.5,24.0,75.0,13.5,22.5,0.0,0.0,9.5,24.0,315.0,150.0,2.0,18.0,2.04,1.74,17.5,7.0,33.0,19.0,91.1,83.3,14.0,9.0,4365.0,8.0,0.4651162790697674,19.0,0.4221808014911464,0.3854922279792746,27.0,17.0,0.32558139534883723,0.2857142857142857,26.0,22.0,0.3043478260869565,0.29074559760209817,26.0,22.0,453.0,372.0,3.0,11.0,14.0,10.0,10.0,13.0,1834.0,1552.0,6.0,17.0,16.252525252525253,16.0,37.4,32.2,14.0,9.0,0.0,1.0,26.0,4.2,5.6,25.5,4.0,173.0,231.0,19.0,6.5,33.0,20.5,6.0,29.0,28.0,9.5,19.0,27.0,23.0,11.0,14.0,21.0,10.7,15.0,6.0,7.5,29.0,10.0,8.0,5.5,7.5,13.705234159779616,8.0,31042.0,27000.0,4.0,ATL,6026.0,5338.0,12.0,10.0,100.0,100.0,20.0,13.0,45.0,37.0,16.0,7.0,45.0,37.0,17.0,6.0,7.3,7.2,17.0,13.5,4.0,4.2,15.0,23.0,12.0,11.8,9.5,14.5,23.5,24.8,22.0,18.5,9.5,4.8,1.0,20.0,5.6,5.5,17.5,14.0,42.1,0.0,16.5,30.0,32.2,29.6,17.0,9.5,688.0,7.0,1.825,1.7142857142857142,17.0,6.0
2012.0,175.0,180.0,7.0,30.5,343.0,298.0,9.0,6.0,247.0,189.0,16.0,4.0,70.0,99.0,17.5,29.5,26.0,10.0,1.0,18.0,2.0,0.0,0.0,0.0,7.0,5.6,11.0,8.0,7028.0,18.0,7.7,6.2,8.5,8.0,46.0,169.0,155.0,3.5,3.5,7.5,29.0,25.5,4.5,10.0,422.0,68.6,61.2,16.0,1.0,337.0,14.5,4.0,12.0,22.5,15.833333333333336,13.5,153.25,211.97,-49.35,13.0,2.0,-50.54,-2.57,28.0,28.0,-42.48,18.0,2.0,86.8,84.4,17.5,14.0,1.0,9.0,11.0,13.0,4.0,1.0,8.0,10.0,10.0,4.0,4.0,11.0,15.0,1.5,19.25,22.0,13.8,12.0,5.85,4.0,21.75,25.0,9.0,1.0,0.0,0.4444444444444444,11.0,11.375895316804408,7.0,8.8,7.0,14.0,2.3,3.6,4.0,8.0,1.0,1.0,20.0,5.5,13.0,HC,27.0,48.0,20.5,32.0,0.0,0.0,11.5,22.5,640.0,1065.0,19.0,31.0,7.0,6.7,22.0,5.0,10.333333333333334,8.0,0.0,0.0,419.0,299.0,5.0,120.0,5.0,7.0,615.0,551.0,14.0,8.0,0.6297747306562194,0.5852674066599395,16.0,7.0,3.5285714285714285,2.0,32.0,5.2,2.5,1.0,8.5,14.0,1.0,5.0,0.7272727272727273,0.4666666666666667,32.0,10.0,0.7634608872333221,0.663019319541802,19.0,2.0,4509.0,3878.0,23.0,6.0,55.0,415.0,641.0,1.0,1.0,83.0,4.0,1.0,0.07580174927113703,0.03355704697986577,32.0,25.0,6.1,5.7,15.5,3.5,1021.0,991.0,5.0,14.0,62.0,2.0,0.0,16.5,29.5,26.0,4.0,2847.0,0.0,16.5,30.0,64.0,3.0,30.0,0.0,0.0,9.5,24.0,205.0,241.0,6.0,29.0,2.33,1.62,10.0,2.0,26.0,28.5,99.1,77.1,5.0,6.0,4719.0,5.0,0.2834008097165992,31.0,0.37022526934378064,0.4147325933400605,17.0,26.0,0.2727272727272727,0.5333333333333333,1.0,23.0,0.23653911276667794,0.33698068045819796,14.0,31.0,378.0,411.0,10.0,26.5,12.0,16.0,24.5,15.0,1397.0,1971.0,21.0,29.0,16.267676767676765,14.0,44.0,31.7,13.0,2.0,0.0,1.0,28.0,4.4,5.0,27.0,7.5,210.0,182.0,29.0,10.0,29.0,28.0,7.5,38.0,32.0,18.5,4.0,33.0,27.0,17.5,2.5,18.0,10.3,17.2,3.0,8.5,31.0,6.0,13.0,5.5,7.5,13.951790633608812,9.0,29575.0,27900.0,12.0,ATL,5906.0,5849.0,24.0,8.0,100.0,100.0,19.0,14.0,44.0,30.0,5.5,10.0,44.0,30.0,6.0,9.5,7.7,7.4,21.5,7.5,3.7,4.8,29.0,28.5,11.2,12.0,20.0,25.0,23.7,22.2,8.0,14.0,7.9,9.3,14.5,25.0,5.8,5.9,27.5,7.0,45.9,0.0,16.5,17.0,33.7,32.5,27.0,4.0,57.0,14.0,2.081081081081081,1.5416666666666667,26.0,2.0
2013.0,179.0,175.0,2.0,30.0,330.0,326.0,16.0,9.5,227.0,196.0,17.0,4.0,64.0,102.0,22.5,31.0,39.0,28.0,15.5,4.5,1.0,0.0,1.0,0.0,5.7,7.4,31.5,17.5,6761.0,22.0,6.5,8.3,31.0,18.5,40.0,163.0,164.0,5.0,-1.5,22.0,26.2,27.7,15.0,29.0,445.0,67.5,66.1,28.0,4.0,341.0,14.0,3.0,18.0,18.5,26.25,29.0,44.8,81.36,-116.45,30.0,10.0,-27.53,-19.47,29.0,21.0,-123.26,31.0,13.0,88.9,97.1,32.0,15.0,0.0,9.0,8.0,5.0,5.0,0.0,9.0,7.0,5.0,3.0,11.0,11.0,12.5,25.5,25.33333333333333,32.0,18.49375,23.0,9.55,9.0,27.4375,32.0,17.0,1.0,0.0,0.6470588235294118,31.0,21.722314049586775,26.0,22.8,25.5,17.0,2.6,1.9,28.5,15.0,2.0,4.0,10.0,29.5,19.0,HC,27.0,23.0,2.0,29.5,0.0,0.0,12.5,19.0,659.0,571.0,5.0,28.0,6.0,7.1,31.0,17.0,17.583333333333332,19.0,0.0,0.0,353.0,443.0,27.0,-90.0,25.0,20.0,659.0,516.0,5.0,3.0,0.6865234375,0.5463609172482552,29.0,1.0,3.546875,1.0,26.0,3.9,6.0,31.0,22.0,31.0,29.0,11.5,0.7027027027027027,0.6888888888888889,15.0,12.0,0.7728597449908925,0.642009884678748,26.0,1.0,4243.0,3897.0,21.0,7.0,91.0,788.0,885.0,23.0,12.0,104.0,21.0,9.5,0.11818181818181818,0.08588957055214724,18.0,7.0,5.9,5.9,28.0,6.0,1024.0,1003.0,8.0,17.0,70.0,2.0,0.0,16.5,31.0,33.0,13.0,3166.0,0.0,16.5,25.0,62.0,3.0,26.5,0.0,0.0,12.0,22.5,250.0,251.0,11.0,21.0,1.85,2.38,32.0,17.0,30.0,23.5,89.5,102.4,31.0,11.0,4541.0,4.0,0.28193832599118945,32.0,0.3134765625,0.4536390827517448,4.0,32.0,0.2972972972972973,0.3111111111111111,18.0,21.0,0.2271402550091075,0.357990115321252,7.0,32.0,321.0,455.0,26.0,32.0,11.0,14.0,20.0,21.5,1247.0,2173.0,31.0,32.0,17.252525252525253,17.0,34.1,45.1,32.0,16.0,0.0,0.0,44.0,6.3,5.8,25.5,11.0,298.0,231.0,25.0,23.0,32.0,29.5,21.5,27.0,35.0,26.0,24.5,24.0,34.0,30.5,21.0,28.0,14.5,11.4,21.0,23.0,21.0,25.0,-7.0,24.0,21.0,20.644628099173552,30.0,29177.0,28700.0,17.0,ATL,5490.0,6070.0,27.5,14.0,100.0,100.0,19.0,14.0,39.0,47.0,25.0,17.5,39.0,47.0,25.5,17.5,6.9,8.0,30.0,17.5,3.9,4.8,31.0,24.0,10.2,12.1,22.0,32.0,24.4,24.8,25.0,10.0,8.3,7.6,8.5,20.0,5.4,6.1,30.0,12.0,45.2,0.0,16.5,16.0,30.7,34.7,29.0,8.0,-580.0,26.0,1.7692307692307694,1.6666666666666667,18.5,12.0
2014.0,175.0,169.0,1.0,26.5,330.0,358.0,32.0,13.0,233.0,224.0,31.0,4.0,75.0,108.0,26.5,26.0,22.0,26.0,6.0,29.5,2.0,0.0,1.0,0.0,6.7,7.1,28.5,9.5,7791.0,4.0,7.3,7.6,24.0,10.0,42.0,162.0,174.0,11.0,-1.3999999999999986,24.0,26.5,27.9,20.0,24.0,418.0,66.1,63.4,18.0,7.0,359.0,21.0,2.0,12.0,24.5,24.33333333333333,29.0,68.84,105.81,-131.54,29.0,10.0,-26.32,-7.5,30.0,15.0,-136.13,31.0,10.0,90.6,81.6,13.0,4.5,0.0,10.0,4.0,8.0,10.0,0.0,10.0,4.0,8.0,7.0,8.0,12.0,7.5,10.5,22.29166666666667,27.0,14.5375,15.0,7.95,7.0,21.125,23.0,16.0,1.0,0.0,0.5,23.0,18.768457300275482,23.0,21.3,24.0,15.0,2.4,2.8,12.0,15.5,1.0,5.0,16.0,12.5,17.0,HC,50.0,36.0,15.0,5.0,0.0,0.0,13.5,19.0,1174.0,820.0,12.0,5.0,6.9,7.6,32.0,6.5,12.583333333333336,12.0,0.0,0.0,381.0,417.0,27.0,-36.0,24.0,12.0,632.0,566.0,23.0,3.0,0.6405797101449275,0.5664739884393064,23.0,3.0,3.1066666666666665,2.0,28.0,4.4,3.5,5.0,14.5,20.0,5.0,11.0,0.7179487179487181,0.4878048780487805,32.0,13.0,0.7524376136175839,0.7027620841180163,9.0,1.0,4553.0,4478.0,32.0,5.0,97.0,840.0,744.0,3.0,13.0,91.0,2.5,9.0,0.06666666666666668,0.07262569832402235,28.0,32.0,6.1,6.4,32.0,5.5,1035.0,1038.0,23.0,13.0,67.0,0.0,0.0,16.5,6.5,26.0,7.0,3063.0,2413.0,2.0,23.0,56.0,2.0,24.5,1.0,0.0,10.0,7.0,239.0,250.0,14.5,21.5,2.06,2.25,30.0,10.0,18.0,32.0,93.4,88.9,15.0,9.5,4758.0,5.0,0.3218884120171674,31.0,0.3594202898550725,0.4335260115606936,10.0,30.0,0.28205128205128205,0.5121951219512195,1.0,20.0,0.2475623863824161,0.2972379158819837,24.0,32.0,372.0,450.0,24.5,27.0,11.0,21.0,32.0,18.5,1498.0,1894.0,21.0,24.0,10.313131313131317,1.0,38.9,42.6,30.0,10.0,0.0,1.0,31.0,4.7,3.7,31.0,9.0,205.0,140.0,31.0,14.0,22.0,30.5,13.5,32.0,38.0,28.5,16.0,29.0,31.0,27.0,10.5,23.0,13.1,14.2,6.0,23.5,28.0,6.5,5.0,11.5,15.5,16.236914600550964,17.0,28350.0,29406.0,24.0,ATL,6051.0,6372.0,32.0,8.0,100.0,95.2,1.0,13.5,40.0,42.0,22.0,14.0,40.0,40.0,19.0,14.0,7.5,8.2,31.5,9.0,4.0,4.2,16.5,20.5,11.4,12.9,31.0,19.0,23.5,22.8,12.5,14.5,13.3,9.6,20.5,1.0,5.8,6.1,32.0,8.0,45.7,43.1,4.0,12.5,34.6,37.6,32.0,4.0,-321.0,23.0,1.875,1.952380952380952,6.0,11.0
2016.0,183.0,184.0,13.0,20.0,340.0,326.0,17.0,10.5,220.0,203.0,19.5,6.5,80.0,102.0,26.5,25.0,40.0,21.0,2.0,2.0,7.0,0.0,4.0,2.0,6.0,6.4,21.5,18.5,6354.0,27.0,6.8,7.2,21.5,19.0,41.0,162.0,156.0,15.0,-0.09999999999999787,16.0,28.3,28.4,18.0,17.0,355.0,61.4,63.3,18.0,20.0,347.0,13.0,19.0,26.0,4.5,17.5,17.5,31.47,107.8,-41.26,9.0,11.0,-68.53,-7.71,29.0,31.0,-41.58,14.0,18.0,71.0,75.0,6.0,32.0,0.0,5.0,15.0,10.0,1.0,0.0,5.0,13.0,4.0,0.0,9.0,12.0,6.5,17.5,13.0,9.0,18.90625,23.0,14.5,16.0,23.3125,24.0,19.0,0.0,1.0,0.4736842105263158,20.5,18.760330578512395,24.0,19.0,22.0,18.0,3.1,3.1,2.0,26.5,4.0,1.0,17.0,6.0,27.0,DC,21.0,25.0,8.5,31.5,0.0,0.0,13.0,19.5,307.0,583.0,11.0,32.0,6.4,6.8,25.0,17.5,19.58333333333333,21.0,0.0,0.0,354.0,369.0,15.0,-15.0,23.0,18.5,578.0,548.0,10.5,16.0,0.575046904315197,0.5784797630799605,22.0,24.0,2.75,4.0,29.0,5.0,4.4,18.5,11.0,24.0,16.0,9.0,0.7837837837837838,0.6153846153846154,18.0,3.0,0.7084085167809455,0.6815016137251572,21.0,13.0,3926.0,4012.0,22.0,16.0,109.0,926.0,1061.0,29.0,19.0,121.0,28.0,18.5,0.1176470588235294,0.06441717791411042,30.0,2.0,5.9,5.6,11.0,11.5,1066.0,1013.0,14.0,6.0,70.0,0.0,0.0,13.0,13.5,24.0,6.0,3216.0,3108.0,14.0,17.0,70.0,12.5,21.0,0.0,0.0,12.0,20.0,266.0,128.0,1.0,13.0,1.78,1.92,16.0,20.0,29.0,19.0,87.0,88.8,18.0,18.0,4165.0,14.0,0.3636363636363637,29.0,0.424953095684803,0.4215202369200395,11.0,9.0,0.21621621621621626,0.3846153846153846,15.0,30.0,0.2915914832190545,0.31849838627484284,12.0,20.0,453.0,427.0,22.0,7.5,8.0,15.0,19.5,30.0,1616.0,1875.0,22.0,24.0,18.464646464646467,21.0,32.2,35.9,17.0,22.0,1.0,2.0,35.0,5.7,6.5,8.0,16.0,239.0,234.0,11.0,20.0,38.0,10.0,17.0,31.0,36.0,27.0,19.5,22.0,27.0,18.0,23.5,27.0,14.8,14.7,2.0,29.0,29.0,3.0,2.0,14.0,24.5,18.52066115702479,25.0,29646.0,28704.0,15.0,TB,5542.0,5887.0,23.0,18.0,94.1,97.1,26.0,15.0,34.0,35.0,11.5,20.0,32.0,34.0,13.0,17.5,7.2,7.7,28.0,16.0,3.6,4.4,22.0,28.5,11.7,12.2,27.5,12.0,14.6,23.3,26.0,32.0,9.2,5.3,4.0,12.0,5.2,5.8,24.5,22.5,45.9,44.4,10.0,12.0,30.2,31.9,20.5,17.0,-345.0,27.0,2.0,1.75,13.0,4.5
